	Query	Sequence	Length	Start_SPAligner	End_SPAligner	Length_SPAligner	Path_SPAligner	Sequence_SPAligner
0	gb|DQ241380.1|+|0-777|ARO:3002539|AAC(3)-IV	GTGCAATACGAATGGCGAAAAGCCGAGCTCATCGGTCAGCTTCTCAACCTTGGG...TGA	777.0	41	763	722	777	GTGCAATACGAATGGCGAAAAGCCGAGCTCATCGGTCAGCTTCTCAACCTTGGGGTTACCCCCGGCGGTGTGCTGCTGGTCCACAGCTCCTTCCGTAGCGTCCGGCCCCTCGAAGATGGGCCACTTGGACTGATCGAGGCCCTGCGTGCTGCGCTGGGTCCGGGAGGGACGCTCGTCATGCCCTCGTGGTCAGGTCTGGACGACGAGCCGTTCGATCCTGCCACGTCGCCCGTTACACCGGACCTTGGAGTTGTCTCTGACACATTCTGGCGCCTGCCAAATGTAAAGCGCAGCGCCCATCCATTTGCCTTTGCGGCAGCGGGGCCACAGGCAGAGCAGATCATCTCTGATCCATTGCCCCTGCCACCTCACTCGCCTGCAAGCCCGGTCGCCCGTGTCCATGAACTCGATGGGCAGGTACTTCTCCTCGGCGTGGGACACGATGCCAACACGACGCTGCATCTTGCCGAGTTGATGGCAAAGGTTCCCTATGGGGTGCCGAGACACTGCACCATTCTTCAGGATGGCAAGTTGGTACGCGTCGATTATCTCGAGAATGACCACTGCTGTGAGCGCTTTGCCTTGGCGGACAGGTGGCTCAAGGAGAAGAGCCTTCAGAAGGAAGGTCCAGTCGGTCATGCCTTTGCTCGGTTGATCCGCTCCCGCGACATTGTGGCGACAGCCCTGGGTCAACTGGGCCGAGATCCGTTGATCTTCCTGCA
1	gb|EU220744|+|0-786|ARO:3001441|OXA-116	TTACTTATAACAAGCGCTATTTTTATTTCAGCCTGCTCACCTTATATAGTGTCT...TTA	786.0	54167	54894	727	786	TTACTTATAACAAGCGCTATTTTTATTTCAGCCTGCTCACCTTATATAGTGACTGCTAATCCAAATCACAGCGCTTCAAAATCTGATGTAAAAGCAGAGAAAATTAAAAATTTATTTAACGAAGCACACACTACGGGTGTTTTAGTTATCCAACAAGGCCAAACTCAACAAAGCTATGGTAATGATCTTGCTCGTGCTTCGACCGAGTATGTACCTGCTTCGACCTTCAAAATGCTTAATGCTTTGATCGGCCTTGAGCACCATAAGGCAACCACCACAGAAGTATTTAAGTGGGATGGTAAAAAAAGGTTATTCCCAGAATGGGAAAAGGACATGACCCTAGGCGATGCCATGAAAGCTTCCGCTATTCCAGTTTATCAAGATTTAGCTCGTCGTATTGGACTTGAGCTCATGTCTAAGGAAGTGAAGCGTGTTGGTTATGGCAATGCAGATATCGGTACCCAAGTCGATAATTTTTGGCTGGTGGGTCCTTTAAAAATTACTCCTCAGCAAGAGGCACAGTTTGCTTACAAGCTAGCTAATAAAACGCTTCCATTTAGCCAAAAAGTCCAAGATGAAGTGCAATCCATGCTATTCATAGAAGAAAAGAATGGAAACAAAATATACGCAAAAAGTGGTTGGGGATGGGATGTAAACCCACAAGTAGGCTGGTTAACTGGATGGGTTGTTCAGCCTCAAGGGAATATTGTAGCGTTCTCCCTTAACT
2	gb|KM433672|+|0-822|ARO:3003161|OXA-423	ATGAATAAATATTTTACTTGCTATGTGGTTGCTTCTCTTTTTCTTTCTGGTTGT...TAA	822.0	80	847	767	822	ATGAATAAATATTTTACTTGCTATGTGGTTGCTTCTCTTTTTCTTTCTGGTTGTACGGTTCAGCATAATTTAATAAATGAAACCCCGAGTCAGATTGTTCAAGGACATAATCAGGTGATTCATCAATACTTTGATGAAAAAAACACCTCAGGTGTGCTGGTTATTCAAACAGATAAAAAAATTAATCTATATGGTAATGCTCTAAGCCGCGCAAATACAGAATATGTGCCAGCCTCTACATTTAAAATGTTGAATGCCCTGATCGGATTGGAGAACCAGAAAACGGATATTAATGAAATATTTAAATGGAAGGGCGAGAAAAGGTCATTTACCGCTTGGGAAAAAGACATGACACTAGGAGAAGCCATGAAGCTTTCTGCAGTCCCAGTCTATCAGGAACTTGCGCGACGTATCGGTCTTGATCTCATGCAAAAAGAAGTAAAACGTATTGGTTTCGGTAATGCTGAAATTGGACAGCAGGTTGATAATTTCTGGTTGGTAGGACCATTAAAGGTTACGCCTATTCAAGAGGTAGAGTTTGTTTCCCAATTAGCACATACACAGCTTCCATTTAGTGAAAAAGTGCAGGCTAATGTAAAAAATATGCTTCTTTTAGAAGAGAGTAATGGCTACAAAATTTTTGGAAAGACTGGTTGGGCAATGGATATAAAACCACAAGTGGGCTGGTTGACCGGCTGGGTTGAGCAGCCAGATGGAAAAATTGTCGCTTTTGCATTAAATATGGAAATGCGGTCAGAAATGCCGGC
3	gb|KF305666.1|+|0-825|ARO:3001715|OXA-259	ATGAACATTAAAGCACTCTTACTTATAACAAGCGCTATTTTTATTTCAGCCTGT...TAG	825.0	54149	54919	770	825	ATGAACATTAAAGCACTCTTACTTATAACAAGCGCTATTTTTATTTCAGCCTGCTCACCTTATATAGTGACTGCTAATCCAAATCACAGCGCTTCAAAATCTGATGTAAAAGCAGAGAAAATTAAAAATTTATTTAACGAAGCACACACTACGGGTGTTTTAGTTATCCAACAAGGCCAAACTCAACAAAGCTATGGTAATGATCTTGCTCGTGCTTCGACCGAGTATGTACCTGCTTCGACCTTCAAAATGCTTAATGCTTTGATCGGCCTTGAGCACCATAAGGCAACCACCACAGAAGTATTTAAGTGGGATGGTAAAAAAAGGTTATTCCCAGAATGGGAAAAGGACATGACCCTAGGCGATGCCATGAAAGCTTCCGCTATTCCAGTTTATCAAGATTTAGCTCGTCGTATTGGACTTGAGCTCATGTCTAAGGAAGTGAAGCGTGTTGGTTATGGCAATGCAGATATCGGTACCCAAGTCGATAATTTTTGGCTGGTGGGTCCTTTAAAAATTACTCCTCAGCAAGAGGCACAGTTTGCTTACAAGCTAGCTAATAAAACGCTTCCATTTAGCCAAAAAGTCCAAGATGAAGTGCAATCCATGCTATTCATAGAAGAAAAGAATGGAAACAAAATATACGCAAAAAGTGGTTGGGGATGGGATGTAAACCCACAAGTAGGCTGGTTAACTGGATGGGTTGTTCAGCCTCAAGGGAATATTGTAGCGTTCTCCCTTAACTTAGAAATGAAAAAAGGAATACCTAG
4	gb|Y11069|+|0-780|ARO:3001065|SHV-6	CTGTTAGCCACCCTGCCGCTGGCGGTACACGCCAGCCCGCAGCCGCTTGAGCAA...AAT	780.0	51	771	720	780	AGCCACCCTGCCGCTGGCGGTACACGCCAGCCCGCAGCCGCTTGAGCAAATTAAACAAAGCGAAAGCCAGCTGTCGGGCCGCGTAGGCATGATAGAAATGGATCTGGCCAGCGGCCGCACGCTGACCGCCTGGCGCGCCGATGAACGCTTTCCCATGATGAGCACCTTTAAAGTAGTGCTCTGCGGCGCAGTGCTGGCGCGGGTGGATGCCGGTGACGAACAGCTGGAGCGAAAGATCCACTATCGCCAGCAGGATCTGGTGGACTACTCGCCGGTCAGCGAAAAACACCTTGCCGACGGCATGACGGTCGGCGAACTCTGCGCCGCCGCCATTACCATGAGCGATAACAGCGCCGCCAATCTGCTGCTGGCCACCGTCGGCGGCCCCGCAGGATTGACTGCCTTTTTGCGCCAGATCGGCGACAACGTCACCCGCCTTGACCGCTGGGAAACGGAACTGAATGAGGCGCTTCCCGGCGACGCCCGCGACACCACTACCCCGGCCAGCATGGCCGCGACCCTGCGCAAGCTGCTGACCAGCCAGCGTCTGAGCGCCCGTTCGCAACGGCAGCTGCTGCAGTGGATGGTGGACGATCGGGTCGCCGGACCGTTGATCCGCTCCGTGCTGCCGGCGGGCTGGTTTATCGCCGATAAGACCGGAGCTAGCAAGCGGGGTGCGCGCGGGATTGTCGCCCTGCTTGGCCCGAATAACAAAGCAGA
5	gb|JF812965|+|0-861|ARO:3001167|SHV-120	ATGCGTTATATTCGCCTGTGTATTATCTCCCTGTTAGCCACCCTGCCGCTGGCG...TAA	861.0	16	822	806	861	ATGCGTTATATTCGCCTGTGTATTATCACCCTGTGAGCCACCCTGCCGCTGGCGGTACACGCCAGCCCGCAGCCGCTTGAGCAAATTAAACAAAGCGAAAGCCAGCTGTCGGGCCGCGTAGGCATGATAGAAATGGATCTGGCCAGCGGCCGCACGCTGACCGCCTGGCGCGCCGATGAACGCTTTCCCATGATGAGCACCTTTAAAGTAGTGCTCTGCGGCGCAGTGCTGGCGCGGGTGGATGCCGGTGACGAACAGCTGGAGCGAAAGATCCACTATCGCCAGCAGGATCTGGTGGACTACTCGCCGGTCAGCGAAAAACACCTTGCCGACGGCATGACGGTCGGCGAACTCTGCGCCGCCGCCATTACCATGAGCGATAACAGCGCCGCCAATCTGCTGCTGGCCACCGTCGGCGGCCCCGCAGGATTGACTGCCTTTTTGCGCCAGATCGGCGACAACGTCACCCGCCTTGACCGCTGGGAAACGGAACTGAATGAGGCGCTTCCCGGCGACGCCCGCGACACCACTACCCCGGCCAGCATGGCCGCGACCCTGCGCAAGCTGCTGACCAGCCAGCGTCTGAGCGCCCGTTCGCAACGGCAGCTGCTGCAGTGGATGGTGGACGATCGGGTCGCCGGACCGTTGATCCGCTCCGTGCTGCCGGCGGGCTGGTTTATCGCCGATAAGACCGGAGCTAGCAAGCGGGGTGCGCGCGGGATTGTCGCCCTGCTTGGCCCGAATAACAAAGCAGAGCGCATTGTGGTGATTTATCTGCGGGATACGCCGGCGAGCATGGCCGAGCG
6	gb|KP050487.1|+|0-861|ARO:3001350|SHV-180	ATGCGTTATATTCGCCTGTGTATTATCTCCCTGTTAGCCACCCTGCCGCTGGCG...TAA	861.0	16	822	806	861	ATGCGTTATATTCGCCTGTGTATTATCACCCTGTGAGCCACCCTGCCGCTGGCGGTACACGCCAGCCCGCAGCCGCTTGAGCAAATTAAACAAAGCGAAAGCCAGCTGTCGGGCCGCGTAGGCATGATAGAAATGGATCTGGCCAGCGGCCGCACGCTGACCGCCTGGCGCGCCGATGAACGCTTTCCCATGATGAGCACCTTTAAAGTAGTGCTCTGCGGCGCAGTGCTGGCGCGGGTGGATGCCGGTGACGAACAGCTGGAGCGAAAGATCCACTATCGCCAGCAGGATCTGGTGGACTACTCGCCGGTCAGCGAAAAACACCTTGCCGACGGCATGACGGTCGGCGAACTCTGCGCCGCCGCCATTACCATGAGCGATAACAGCGCCGCCAATCTGCTGCTGGCCACCGTCGGCGGCCCCGCAGGATTGACTGCCTTTTTGCGCCAGATCGGCGACAACGTCACCCGCCTTGACCGCTGGGAAACGGAACTGAATGAGGCGCTTCCCGGCGACGCCCGCGACACCACTACCCCGGCCAGCATGGCCGCGACCCTGCGCAAGCTGCTGACCAGCCAGCGTCTGAGCGCCCGTTCGCAACGGCAGCTGCTGCAGTGGATGGTGGACGATCGGGTCGCCGGACCGTTGATCCGCTCCGTGCTGCCGGCGGGCTGGTTTATCGCCGATAAGACCGGAGCTAGCAAGCGGGGTGCGCGCGGGATTGTCGCCCTGCTTGGCCCGAATAACAAAGCAGAGCGCATTGTGGTGATTTATCTGCGGGATACGCCGGCGAGCATGGCCGAGCG
7	gb|AE006468.2|+|1707351-1707789|ARO:3002571|AAC(6')-Iaa	ATGGACATCAGGCAAATGAACAGAACCCATCTGGATCACTGGCGCGGATTGCGA...TGA	438.0	0	254	254	438	GCATCATTTATTGCGATGGCAGACGGGGTGGCGATTGGCTTTGCGGATGCCTCAATCCGCCACGATTATGTCAATGGCTGTGACAGTTCGCCCGTGGTTTTCCTTGAAGGTATTTTTGTTCTCCCCTCGTTCCGTCAACGCGGCTTAGCGAAACAATTGATTGCAGCAGTGCAACGATGGGGAACGAATAAAGGGTGTCGGGAAATGGCTTCCGATACCTCGCCGGAAAATACAATTTCACAGAAAGTTCACCT
8	gb|APOR01000009.1|+|341736-342561|ARO:3001716|OXA-260	ATGAACATTAAAGCACACTTACTTATAACAAGCGCTATTTTTATTTCAGCCTGC...TAG	825.0	54149	54919	770	825	ATGAACATTAAAGCACTCTTACTTATAACAAGCGCTATTTTTATTTCAGCCTGCTCACCTTATATAGTGACTGCTAATCCAAATCACAGCGCTTCAAAATCTGATGTAAAAGCAGAGAAAATTAAAAATTTATTTAACGAAGCACACACTACGGGTGTTTTAGTTATCCAACAAGGCCAAACTCAACAAAGCTATGGTAATGATCTTGCTCGTGCTTCGACCGAGTATGTACCTGCTTCGACCTTCAAAATGCTTAATGCTTTGATCGGCCTTGAGCACCATAAGGCAACCACCACAGAAGTATTTAAGTGGGATGGTAAAAAAAGGTTATTCCCAGAATGGGAAAAGGACATGACCCTAGGCGATGCCATGAAAGCTTCCGCTATTCCAGTTTATCAAGATTTAGCTCGTCGTATTGGACTTGAGCTCATGTCTAAGGAAGTGAAGCGTGTTGGTTATGGCAATGCAGATATCGGTACCCAAGTCGATAATTTTTGGCTGGTGGGTCCTTTAAAAATTACTCCTCAGCAAGAGGCACAGTTTGCTTACAAGCTAGCTAATAAAACGCTTCCATTTAGCCAAAAAGTCCAAGATGAAGTGCAATCCATGCTATTCATAGAAGAAAAGAATGGAAACAAAATATACGCAAAAAGTGGTTGGGGATGGGATGTAAACCCACAAGTAGGCTGGTTAACTGGATGGGTTGTTCAGCCTCAAGGGAATATTGTAGCGTTCTCCCTTAACTTAGAAATGAAAAAAGGAATACCTAG
9	gb|GQ423625.1|+|0-825|ARO:3001442|OXA-117	ATGAACATTAAAGCACTCTTACTTATAACAAGCGCTATTTTTATTTCAGCCTGC...TAG	825.0	54149	54919	770	825	ATGAACATTAAAGCACTCTTACTTATAACAAGCGCTATTTTTATTTCAGCCTGCTCACCTTATATAGTGACTGCTAATCCAAATCACAGCGCTTCAAAATCTGATGTAAAAGCAGAGAAAATTAAAAATTTATTTAACGAAGCACACACTACGGGTGTTTTAGTTATCCAACAAGGCCAAACTCAACAAAGCTATGGTAATGATCTTGCTCGTGCTTCGACCGAGTATGTACCTGCTTCGACCTTCAAAATGCTTAATGCTTTGATCGGCCTTGAGCACCATAAGGCAACCACCACAGAAGTATTTAAGTGGGATGGTAAAAAAAGGTTATTCCCAGAATGGGAAAAGGACATGACCCTAGGCGATGCCATGAAAGCTTCCGCTATTCCAGTTTATCAAGATTTAGCTCGTCGTATTGGACTTGAGCTCATGTCTAAGGAAGTGAAGCGTGTTGGTTATGGCAATGCAGATATCGGTACCCAAGTCGATAATTTTTGGCTGGTGGGTCCTTTAAAAATTACTCCTCAGCAAGAGGCACAGTTTGCTTACAAGCTAGCTAATAAAACGCTTCCATTTAGCCAAAAAGTCCAAGATGAAGTGCAATCCATGCTATTCATAGAAGAAAAGAATGGAAACAAAATATACGCAAAAAGTGGTTGGGGATGGGATGTAAACCCACAAGTAGGCTGGTTAACTGGATGGGTTGTTCAGCCTCAAGGGAATATTGTAGCGTTCTCCCTTAACTTAGAAATGAAAAAAGGAATACCTAG
10	gb|KM588352|+|0-825|ARO:3003147|OXA-424	ATGAACATTAAAGCCCTCTTACTTATAACAAGCGCTATTTTTATTTCAGCCTGC...TAG	825.0	54149	54919	770	825	ATGAACATTAAAGCACTCTTACTTATAACAAGCGCTATTTTTATTTCAGCCTGCTCACCTTATATAGTGACTGCTAATCCAAATCACAGCGCTTCAAAATCTGATGTAAAAGCAGAGAAAATTAAAAATTTATTTAACGAAGCACACACTACGGGTGTTTTAGTTATCCAACAAGGCCAAACTCAACAAAGCTATGGTAATGATCTTGCTCGTGCTTCGACCGAGTATGTACCTGCTTCGACCTTCAAAATGCTTAATGCTTTGATCGGCCTTGAGCACCATAAGGCAACCACCACAGAAGTATTTAAGTGGGATGGTAAAAAAAGGTTATTCCCAGAATGGGAAAAGGACATGACCCTAGGCGATGCCATGAAAGCTTCCGCTATTCCAGTTTATCAAGATTTAGCTCGTCGTATTGGACTTGAGCTCATGTCTAAGGAAGTGAAGCGTGTTGGTTATGGCAATGCAGATATCGGTACCCAAGTCGATAATTTTTGGCTGGTGGGTCCTTTAAAAATTACTCCTCAGCAAGAGGCACAGTTTGCTTACAAGCTAGCTAATAAAACGCTTCCATTTAGCCAAAAAGTCCAAGATGAAGTGCAATCCATGCTATTCATAGAAGAAAAGAATGGAAACAAAATATACGCAAAAAGTGGTTGGGGATGGGATGTAAACCCACAAGTAGGCTGGTTAACTGGATGGGTTGTTCAGCCTCAAGGGAATATTGTAGCGTTCTCCCTTAACTTAGAAATGAAAAAAGGAATACCTAG
11	gb|AB302939|+|8-869|ARO:3001115|SHV-60	ATGCGTTATATTCGCCTGTGTATTATCTCCCTGTTAGCCACCCTGCCGCTGGCG...TAA	861.0	16	822	806	861	ATGCGTTATATTCGCCTGTGTATTATCACCCTGTGAGCCACCCTGCCGCTGGCGGTACACGCCAGCCCGCAGCCGCTTGAGCAAATTAAACAAAGCGAAAGCCAGCTGTCGGGCCGCGTAGGCATGATAGAAATGGATCTGGCCAGCGGCCGCACGCTGACCGCCTGGCGCGCCGATGAACGCTTTCCCATGATGAGCACCTTTAAAGTAGTGCTCTGCGGCGCAGTGCTGGCGCGGGTGGATGCCGGTGACGAACAGCTGGAGCGAAAGATCCACTATCGCCAGCAGGATCTGGTGGACTACTCGCCGGTCAGCGAAAAACACCTTGCCGACGGCATGACGGTCGGCGAACTCTGCGCCGCCGCCATTACCATGAGCGATAACAGCGCCGCCAATCTGCTGCTGGCCACCGTCGGCGGCCCCGCAGGATTGACTGCCTTTTTGCGCCAGATCGGCGACAACGTCACCCGCCTTGACCGCTGGGAAACGGAACTGAATGAGGCGCTTCCCGGCGACGCCCGCGACACCACTACCCCGGCCAGCATGGCCGCGACCCTGCGCAAGCTGCTGACCAGCCAGCGTCTGAGCGCCCGTTCGCAACGGCAGCTGCTGCAGTGGATGGTGGACGATCGGGTCGCCGGACCGTTGATCCGCTCCGTGCTGCCGGCGGGCTGGTTTATCGCCGATAAGACCGGAGCTAGCAAGCGGGGTGCGCGCGGGATTGTCGCCCTGCTTGGCCCGAATAACAAAGCAGAGCGCATTGTGGTGATTTATCTGCGGGATACGCCGGCGAGCATGGCCGAGCG
12	gb|AJ866284|+|0-861|ARO:3001116|SHV-61	ATGCGTTATATTCGCCGGTGTATTATCTCCCTGTTAGCCACCCTGCCGCTGGCG...TAA	861.0	16	822	806	861	ATGCGTTATATTCGCCTGTGTATTATCACCCTGTGAGCCACCCTGCCGCTGGCGGTACACGCCAGCCCGCAGCCGCTTGAGCAAATTAAACAAAGCGAAAGCCAGCTGTCGGGCCGCGTAGGCATGATAGAAATGGATCTGGCCAGCGGCCGCACGCTGACCGCCTGGCGCGCCGATGAACGCTTTCCCATGATGAGCACCTTTAAAGTAGTGCTCTGCGGCGCAGTGCTGGCGCGGGTGGATGCCGGTGACGAACAGCTGGAGCGAAAGATCCACTATCGCCAGCAGGATCTGGTGGACTACTCGCCGGTCAGCGAAAAACACCTTGCCGACGGCATGACGGTCGGCGAACTCTGCGCCGCCGCCATTACCATGAGCGATAACAGCGCCGCCAATCTGCTGCTGGCCACCGTCGGCGGCCCCGCAGGATTGACTGCCTTTTTGCGCCAGATCGGCGACAACGTCACCCGCCTTGACCGCTGGGAAACGGAACTGAATGAGGCGCTTCCCGGCGACGCCCGCGACACCACTACCCCGGCCAGCATGGCCGCGACCCTGCGCAAGCTGCTGACCAGCCAGCGTCTGAGCGCCCGTTCGCAACGGCAGCTGCTGCAGTGGATGGTGGACGATCGGGTCGCCGGACCGTTGATCCGCTCCGTGCTGCCGGCGGGCTGGTTTATCGCCGATAAGACCGGAGCTAGCAAGCGGGGTGCGCGCGGGATTGTCGCCCTGCTTGGCCCGAATAACAAAGCAGAGCGCATTGTGGTGATTTATCTGCGGGATACGCCGGCGAGCATGGCCGAGCG
13	gb|HQ661362|+|71-932|ARO:3001168|SHV-121	ATGCGTTATATTCGCCTGTGTATTATCTCCCTGTTAGCCGCCCTGCCGCTGGTG...TAA	861.0	16	822	806	861	ATGCGTTATATTCGCCTGTGTATTATCACCCTGTGAGCCACCCTGCCGCTGGCGGTACACGCCAGCCCGCAGCCGCTTGAGCAAATTAAACAAAGCGAAAGCCAGCTGTCGGGCCGCGTAGGCATGATAGAAATGGATCTGGCCAGCGGCCGCACGCTGACCGCCTGGCGCGCCGATGAACGCTTTCCCATGATGAGCACCTTTAAAGTAGTGCTCTGCGGCGCAGTGCTGGCGCGGGTGGATGCCGGTGACGAACAGCTGGAGCGAAAGATCCACTATCGCCAGCAGGATCTGGTGGACTACTCGCCGGTCAGCGAAAAACACCTTGCCGACGGCATGACGGTCGGCGAACTCTGCGCCGCCGCCATTACCATGAGCGATAACAGCGCCGCCAATCTGCTGCTGGCCACCGTCGGCGGCCCCGCAGGATTGACTGCCTTTTTGCGCCAGATCGGCGACAACGTCACCCGCCTTGACCGCTGGGAAACGGAACTGAATGAGGCGCTTCCCGGCGACGCCCGCGACACCACTACCCCGGCCAGCATGGCCGCGACCCTGCGCAAGCTGCTGACCAGCCAGCGTCTGAGCGCCCGTTCGCAACGGCAGCTGCTGCAGTGGATGGTGGACGATCGGGTCGCCGGACCGTTGATCCGCTCCGTGCTGCCGGCGGGCTGGTTTATCGCCGATAAGACCGGAGCTAGCAAGCGGGGTGCGCGCGGGATTGTCGCCCTGCTTGGCCCGAATAACAAAGCAGAGCGCATTGTGGTGATTTATCTGCGGGATACGCCGGCGAGCATGGCCGAGCG
14	gb|APQV01000009.1|+|266252-267077|ARO:3001717|OXA-261	ATGAACATTAAAGCACTCTTATTTATAACAAGCGCTATTTTTATTTCAGCCTGC...TAG	825.0	54149	54919	770	825	ATGAACATTAAAGCACTCTTACTTATAACAAGCGCTATTTTTATTTCAGCCTGCTCACCTTATATAGTGACTGCTAATCCAAATCACAGCGCTTCAAAATCTGATGTAAAAGCAGAGAAAATTAAAAATTTATTTAACGAAGCACACACTACGGGTGTTTTAGTTATCCAACAAGGCCAAACTCAACAAAGCTATGGTAATGATCTTGCTCGTGCTTCGACCGAGTATGTACCTGCTTCGACCTTCAAAATGCTTAATGCTTTGATCGGCCTTGAGCACCATAAGGCAACCACCACAGAAGTATTTAAGTGGGATGGTAAAAAAAGGTTATTCCCAGAATGGGAAAAGGACATGACCCTAGGCGATGCCATGAAAGCTTCCGCTATTCCAGTTTATCAAGATTTAGCTCGTCGTATTGGACTTGAGCTCATGTCTAAGGAAGTGAAGCGTGTTGGTTATGGCAATGCAGATATCGGTACCCAAGTCGATAATTTTTGGCTGGTGGGTCCTTTAAAAATTACTCCTCAGCAAGAGGCACAGTTTGCTTACAAGCTAGCTAATAAAACGCTTCCATTTAGCCAAAAAGTCCAAGATGAAGTGCAATCCATGCTATTCATAGAAGAAAAGAATGGAAACAAAATATACGCAAAAAGTGGTTGGGGATGGGATGTAAACCCACAAGTAGGCTGGTTAACTGGATGGGTTGTTCAGCCTCAAGGGAATATTGTAGCGTTCTCCCTTAACTTAGAAATGAAAAAAGGAATACCTAG
15	gb|KP050489|+|0-861|ARO:3001364|SHV-182	ATGCGTTATATTCGCCTGTGTATTATCTCCCTGTTAGCCACCCTGCCGCTGGCG...TAA	861.0	16	822	806	861	ATGCGTTATATTCGCCTGTGTATTATCACCCTGTGAGCCACCCTGCCGCTGGCGGTACACGCCAGCCCGCAGCCGCTTGAGCAAATTAAACAAAGCGAAAGCCAGCTGTCGGGCCGCGTAGGCATGATAGAAATGGATCTGGCCAGCGGCCGCACGCTGACCGCCTGGCGCGCCGATGAACGCTTTCCCATGATGAGCACCTTTAAAGTAGTGCTCTGCGGCGCAGTGCTGGCGCGGGTGGATGCCGGTGACGAACAGCTGGAGCGAAAGATCCACTATCGCCAGCAGGATCTGGTGGACTACTCGCCGGTCAGCGAAAAACACCTTGCCGACGGCATGACGGTCGGCGAACTCTGCGCCGCCGCCATTACCATGAGCGATAACAGCGCCGCCAATCTGCTGCTGGCCACCGTCGGCGGCCCCGCAGGATTGACTGCCTTTTTGCGCCAGATCGGCGACAACGTCACCCGCCTTGACCGCTGGGAAACGGAACTGAATGAGGCGCTTCCCGGCGACGCCCGCGACACCACTACCCCGGCCAGCATGGCCGCGACCCTGCGCAAGCTGCTGACCAGCCAGCGTCTGAGCGCCCGTTCGCAACGGCAGCTGCTGCAGTGGATGGTGGACGATCGGGTCGCCGGACCGTTGATCCGCTCCGTGCTGCCGGCGGGCTGGTTTATCGCCGATAAGACCGGAGCTAGCAAGCGGGGTGCGCGCGGGATTGTCGCCCTGCTTGGCCCGAATAACAAAGCAGAGCGCATTGTGGTGATTTATCTGCGGGATACGCCGGCGAGCATGGCCGAGCG
16	gb|KM588353|+|0-825|ARO:3003148|OXA-425	ATGAACATTAAAGCACTCTTACTTATAACAAGCGCTATTTTTATTTCAGCCTGC...TAG	825.0	54149	54919	770	825	ATGAACATTAAAGCACTCTTACTTATAACAAGCGCTATTTTTATTTCAGCCTGCTCACCTTATATAGTGACTGCTAATCCAAATCACAGCGCTTCAAAATCTGATGTAAAAGCAGAGAAAATTAAAAATTTATTTAACGAAGCACACACTACGGGTGTTTTAGTTATCCAACAAGGCCAAACTCAACAAAGCTATGGTAATGATCTTGCTCGTGCTTCGACCGAGTATGTACCTGCTTCGACCTTCAAAATGCTTAATGCTTTGATCGGCCTTGAGCACCATAAGGCAACCACCACAGAAGTATTTAAGTGGGATGGTAAAAAAAGGTTATTCCCAGAATGGGAAAAGGACATGACCCTAGGCGATGCCATGAAAGCTTCCGCTATTCCAGTTTATCAAGATTTAGCTCGTCGTATTGGACTTGAGCTCATGTCTAAGGAAGTGAAGCGTGTTGGTTATGGCAATGCAGATATCGGTACCCAAGTCGATAATTTTTGGCTGGTGGGTCCTTTAAAAATTACTCCTCAGCAAGAGGCACAGTTTGCTTACAAGCTAGCTAATAAAACGCTTCCATTTAGCCAAAAAGTCCAAGATGAAGTGCAATCCATGCTATTCATAGAAGAAAAGAATGGAAACAAAATATACGCAAAAAGTGGTTGGGGATGGGATGTAAACCCACAAGTAGGCTGGTTAACTGGATGGGTTGTTCAGCCTCAAGGGAATATTGTAGCGTTCTCCCTTAACTTAGAAATGAAAAAAGGAATACCTAG
17	gb|HE963768|+|0-825|ARO:3001672|OXA-120	ATGAACATTAAAGCACTCTTACTTATAACAAGCGCTATTTTTATTTCAGCCTGC...TAG	825.0	54149	54919	770	825	ATGAACATTAAAGCACTCTTACTTATAACAAGCGCTATTTTTATTTCAGCCTGCTCACCTTATATAGTGACTGCTAATCCAAATCACAGCGCTTCAAAATCTGATGTAAAAGCAGAGAAAATTAAAAATTTATTTAACGAAGCACACACTACGGGTGTTTTAGTTATCCAACAAGGCCAAACTCAACAAAGCTATGGTAATGATCTTGCTCGTGCTTCGACCGAGTATGTACCTGCTTCGACCTTCAAAATGCTTAATGCTTTGATCGGCCTTGAGCACCATAAGGCAACCACCACAGAAGTATTTAAGTGGGATGGTAAAAAAAGGTTATTCCCAGAATGGGAAAAGGACATGACCCTAGGCGATGCCATGAAAGCTTCCGCTATTCCAGTTTATCAAGATTTAGCTCGTCGTATTGGACTTGAGCTCATGTCTAAGGAAGTGAAGCGTGTTGGTTATGGCAATGCAGATATCGGTACCCAAGTCGATAATTTTTGGCTGGTGGGTCCTTTAAAAATTACTCCTCAGCAAGAGGCACAGTTTGCTTACAAGCTAGCTAATAAAACGCTTCCATTTAGCCAAAAAGTCCAAGATGAAGTGCAATCCATGCTATTCATAGAAGAAAAGAATGGAAACAAAATATACGCAAAAAGTGGTTGGGGATGGGATGTAAACCCACAAGTAGGCTGGTTAACTGGATGGGTTGTTCAGCCTCAAGGGAATATTGTAGCGTTCTCCCTTAACTTAGAAATGAAAAAAGGAATACCTAG
18	gb|AB462903|+|1199-1751|ARO:3002574|AAC(6')-Iaf	TTGGACTATTCAATATGCGATATAGCTGAATCAAATGAATTAATCCTTGAAGCA...TAG	552.0	106	599	493	552	ACTATTCAATATGCGATATAGCTGAATCAAATGAATTAATCCTTGAAGCAGCAAAGATGCTTAAGAAAAGCTTTCTTGATGCTGGAAATGAATCATGGGGAGATATTAAAAATGCTATTGAAGAAGTTGAAGAATGTATAGAACATCCAAATATATGCTTGGGAATATGTCTGGATGATAAACTGATTGGATGGACCGGATTAAGGCCGATGTACGATAAGACCTGGGAACTTCATCCCATGGTTATAAAAACTGAATATCAAGGCAAGGGTTTTGGGAAAGTACTACTAAGAGAACTAGAGACGAGAGCGAAGAGTAGGGGAATTATCGGAATAGCTCTTGGAACTGATGACGAATATCAGAAAACTAGTTTGTCTATGATTGATATAAACGAACGAAATATCTTCGATGAAATCGGGAATATAAAGAACGTTAATAATCATCCATATGAGTTTTATAAGAAATGTGGTTATATGATCGTTGGAATAATCCC
19	gb|HG934764|+|0-864|ARO:3001351|SHV-183	ATGCGTTATATTCGCCTGTGTATTATCTCCCTGTTAGCCACCCTGCCGCTGGCG...TAA	864.0	16	822	806	864	ATGCGTTATATTCGCCTGTGTATTATCACCCTGTGAGCCACCCTGCCGCTGGCGGTACACGCCAGCCCGCAGCCGCTTGAGCAAATTAAACAAAGCGAAAGCCAGCTGTCGGGCCGCGTAGGCATGATAGAAATGGATCTGGCCAGCGGCCGCACGCTGACCGCCTGGCGCGCCGATGAACGCTTTCCCATGATGAGCACCTTTAAAGTAGTGCTCTGCGGCGCAGTGCTGGCGCGGGTGGATGCCGGTGACGAACAGCTGGAGCGAAAGATCCACTATCGCCAGCAGGATCTGGTGGACTACTCGCCGGTCAGCGAAAAACACCTTGCCGACGGCATGACGGTCGGCGAACTCTGCGCCGCCGCCATTACCATGAGCGATAACAGCGCCGCCAATCTGCTGCTGGCCACCGTCGGCGGCCCCGCAGGATTGACTGCCTTTTTGCGCCAGATCGGCGACAACGTCACCCGCCTTGACCGCTGGGAAACGGAACTGAATGAGGCGCTTCCCGGCGACGCCCGCGACACCACTACCCCGGCCAGCATGGCCGCGACCCTGCGCAAGCTGCTGACCAGCCAGCGTCTGAGCGCCCGTTCGCAACGGCAGCTGCTGCAGTGGATGGTGGACGATCGGGTCGCCGGACCGTTGATCCGCTCCGTGCTGCCGGCGGGCTGGTTTATCGCCGATAAGACCGGAGCTAGCAAGCGGGGTGCGCGCGGGATTGTCGCCCTGCTTGGCCCGAATAACAAAGCAGAGCGCATTGTGGTGATTTATCTGCGGGATACGCCGGCGAGCATGGCCGAGCG
20	gb|KM588354|+|0-825|ARO:3003149|OXA-426	ATGAACATTAAAGCACTCTTACTTATAACAAGCGCTATTTTTATTTCAGCCTGC...TAG	825.0	54149	54919	770	825	ATGAACATTAAAGCACTCTTACTTATAACAAGCGCTATTTTTATTTCAGCCTGCTCACCTTATATAGTGACTGCTAATCCAAATCACAGCGCTTCAAAATCTGATGTAAAAGCAGAGAAAATTAAAAATTTATTTAACGAAGCACACACTACGGGTGTTTTAGTTATCCAACAAGGCCAAACTCAACAAAGCTATGGTAATGATCTTGCTCGTGCTTCGACCGAGTATGTACCTGCTTCGACCTTCAAAATGCTTAATGCTTTGATCGGCCTTGAGCACCATAAGGCAACCACCACAGAAGTATTTAAGTGGGATGGTAAAAAAAGGTTATTCCCAGAATGGGAAAAGGACATGACCCTAGGCGATGCCATGAAAGCTTCCGCTATTCCAGTTTATCAAGATTTAGCTCGTCGTATTGGACTTGAGCTCATGTCTAAGGAAGTGAAGCGTGTTGGTTATGGCAATGCAGATATCGGTACCCAAGTCGATAATTTTTGGCTGGTGGGTCCTTTAAAAATTACTCCTCAGCAAGAGGCACAGTTTGCTTACAAGCTAGCTAATAAAACGCTTCCATTTAGCCAAAAAGTCCAAGATGAAGTGCAATCCATGCTATTCATAGAAGAAAAGAATGGAAACAAAATATACGCAAAAAGTGGTTGGGGATGGGATGTAAACCCACAAGTAGGCTGGTTAACTGGATGGGTTGTTCAGCCTCAAGGGAATATTGTAGCGTTCTCCCTTAACTTAGAAATGAAAAAAGGAATACCTAG
21	gb|FJ666073|+|0-1194|ARO:3002509|PDC-10	ATGCGCGATACCAGATTCCCCTGCCTGTGCGGCATCGCCGCTTCCACACTGCTG...TGA	1194.0	35513	36652	1139	1194	ATGCGCGATACCAGATTCCCCTGCCTGTGCGGCATCGCCGCTTCCACACTGCTGTTCGCCACCACCCCGGCCATTGCCGATGAGGCCCCGGCGGATCGCCTGAAGGCACTGGTCGACGCCGCCGTACAACCGGTGATGAAGGCCAATGACATTCCGGGCCTGGCCGTAGCCATCAGCCTGAAAGGAGAACCGCATTACTTCAGCTATGGGCTGGCCTCGAAAGAGGACGGCCGCCGGGTGACGCCGGAGACCCTGTTCGAGATCGGCTCGGTGAGCAAGACCTTCACCGTCACCCTCGCCGGCTATGCCCTGGCCCAGGACAAGATGCGCCTCGACGACCGCGCCAGCCAGCACTGGCCGGCACTGCAGGGCAGCCGCTTCGACGGCATCAGCCTGCTCGACCTCGCGACCTATACCGCCGGCGGCTTGCCGCTGCAGTTCCCCGACTCGGTGCAGAAGGACCAGGCACAGATCCGCGACTACTACCGCCAGTGGCAGCCGACCTACGCGCCGGGCAGCCAGCGCCTCTATTCCAACCCGAGCATCGGCCTGTTCGGCTATCTCGCCGCGCGCAGCCTGGGCCAGCCGTTCGAACGGCTCATGGAGCAGCAATTGTTCCCGGCACTGGGCCTCGAACAGACCCACCTCGACGTGCCCGAGGCGGCGCTGGCGCAGTACGCCCAGGGCTACGGCAAGGACGACCGCCCGCTACGGGTCGGTCCCGGCCCGCTGGATGCCGAAGGCTACGGGGTGAAGACCAGCGCGGCCGACCTGCTGCGCTTCGTCGATGCCAACCTGCATCCGGAGCGCCTGGACAGGCCCTGGGCGCAGGCGCTCGATGCCACCCATCGCGGTTACTACAAGGTCGGCGACATGACCCAGGGCCTGGGCTGGGAAGCCTACGACTGGCCGATCTCCCTGAAGCGCCTGCAGGCCGGCAACTCGACGCCGATGGCGCTGCAACCACACAGGATCGCCAGGCTGCCCGCGCCACAGGCGCTGGAGGGCCAGCGCCTGCTGAACAAGACCGGCTCCACCAACGGCTTCGGCGCCTACGTGGCGTTCGTCCCGGGCCGCGACCTGGGCCTGGTGATCCTGGCCAACCGCAACTATCCCAATGCCGAGCGGGTGAAGATCGC
22	gb|KF057027|+|0-825|ARO:3001443|OXA-121	ATGAACATTAAAGCCCTCTTACTTATAACAAACGCTATTTTTATTTCAGCCTGC...TAG	825.0	54149	54919	770	825	ATGAACATTAAAGCACTCTTACTTATAACAAGCGCTATTTTTATTTCAGCCTGCTCACCTTATATAGTGACTGCTAATCCAAATCACAGCGCTTCAAAATCTGATGTAAAAGCAGAGAAAATTAAAAATTTATTTAACGAAGCACACACTACGGGTGTTTTAGTTATCCAACAAGGCCAAACTCAACAAAGCTATGGTAATGATCTTGCTCGTGCTTCGACCGAGTATGTACCTGCTTCGACCTTCAAAATGCTTAATGCTTTGATCGGCCTTGAGCACCATAAGGCAACCACCACAGAAGTATTTAAGTGGGATGGTAAAAAAAGGTTATTCCCAGAATGGGAAAAGGACATGACCCTAGGCGATGCCATGAAAGCTTCCGCTATTCCAGTTTATCAAGATTTAGCTCGTCGTATTGGACTTGAGCTCATGTCTAAGGAAGTGAAGCGTGTTGGTTATGGCAATGCAGATATCGGTACCCAAGTCGATAATTTTTGGCTGGTGGGTCCTTTAAAAATTACTCCTCAGCAAGAGGCACAGTTTGCTTACAAGCTAGCTAATAAAACGCTTCCATTTAGCCAAAAAGTCCAAGATGAAGTGCAATCCATGCTATTCATAGAAGAAAAGAATGGAAACAAAATATACGCAAAAAGTGGTTGGGGATGGGATGTAAACCCACAAGTAGGCTGGTTAACTGGATGGGTTGTTCAGCCTCAAGGGAATATTGTAGCGTTCTCCCTTAACTTAGAAATGAAAAAAGGAATACCTAG
23	gb|FJ503047|+|0-519|ARO:3002592|AAC(6')-Ib-Hangzhou	ATGACTGAGCATGACCTTGTGATGCTCTATGAGTGGCTAAATCGATCTCATATC...TAA	519.0	113	577	464	519	ATGACTGAGCATGACCTTGCGATGCTCTATGAGTGGCTAAATCGATCTCATATCGTCGAGTGGTGGGGCGGAGAAGAAGCACGCCCGACACTTGCTGACGTACAGGAACAGTACTTGCCAAGCGTTTTAGCGCAAGAGTCCGTCACTCCATACATTGCAATGCTGAATGGAGAGCCGATTGGGTATGCCCAGTCGTACGTTGCTCTTGGAAGCGGGGACGGATGGTGGGAAGAAGAAACCGATCCAGGAGTACGCGGAATAGACCAGTCACTGGCGAATGCATCACAACTGGGCAAAGGCTTGGGAACCAAGCTGGTTCGAGCTCTGGTTGAGTTGCTGTTCAATGATCCCGAGGTCACCAAGATCCAAACGGACCCGTCGCCGAGCAACTTGCGAGCGATCCGATGCTACGAGAAAGCGGGGTTTGAGAGGCAAGGTACCGTAACCACCCCAGATGGTCCAGC
24	gb|APRA01000005.1|+|465153-465978|ARO:3001718|OXA-262	ATGAACATTAAAACACTCTTACTTATAACAAGCGCTATTTTTATTTCAGCCTGC...TAG	825.0	54149	54919	770	825	ATGAACATTAAAGCACTCTTACTTATAACAAGCGCTATTTTTATTTCAGCCTGCTCACCTTATATAGTGACTGCTAATCCAAATCACAGCGCTTCAAAATCTGATGTAAAAGCAGAGAAAATTAAAAATTTATTTAACGAAGCACACACTACGGGTGTTTTAGTTATCCAACAAGGCCAAACTCAACAAAGCTATGGTAATGATCTTGCTCGTGCTTCGACCGAGTATGTACCTGCTTCGACCTTCAAAATGCTTAATGCTTTGATCGGCCTTGAGCACCATAAGGCAACCACCACAGAAGTATTTAAGTGGGATGGTAAAAAAAGGTTATTCCCAGAATGGGAAAAGGACATGACCCTAGGCGATGCCATGAAAGCTTCCGCTATTCCAGTTTATCAAGATTTAGCTCGTCGTATTGGACTTGAGCTCATGTCTAAGGAAGTGAAGCGTGTTGGTTATGGCAATGCAGATATCGGTACCCAAGTCGATAATTTTTGGCTGGTGGGTCCTTTAAAAATTACTCCTCAGCAAGAGGCACAGTTTGCTTACAAGCTAGCTAATAAAACGCTTCCATTTAGCCAAAAAGTCCAAGATGAAGTGCAATCCATGCTATTCATAGAAGAAAAGAATGGAAACAAAATATACGCAAAAAGTGGTTGGGGATGGGATGTAAACCCACAAGTAGGCTGGTTAACTGGATGGGTTGTTCAGCCTCAAGGGAATATTGTAGCGTTCTCCCTTAACTTAGAAATGAAAAAAGGAATACCTAG
25	gb|AJ866285|+|0-861|ARO:3001117|SHV-62	ATGCGTTATATTCGCCTGTGTATTATCTCCCTGTTAGCCACCCTGCCGCTGGCG...TAA	861.0	16	822	806	861	ATGCGTTATATTCGCCTGTGTATTATCACCCTGTGAGCCACCCTGCCGCTGGCGGTACACGCCAGCCCGCAGCCGCTTGAGCAAATTAAACAAAGCGAAAGCCAGCTGTCGGGCCGCGTAGGCATGATAGAAATGGATCTGGCCAGCGGCCGCACGCTGACCGCCTGGCGCGCCGATGAACGCTTTCCCATGATGAGCACCTTTAAAGTAGTGCTCTGCGGCGCAGTGCTGGCGCGGGTGGATGCCGGTGACGAACAGCTGGAGCGAAAGATCCACTATCGCCAGCAGGATCTGGTGGACTACTCGCCGGTCAGCGAAAAACACCTTGCCGACGGCATGACGGTCGGCGAACTCTGCGCCGCCGCCATTACCATGAGCGATAACAGCGCCGCCAATCTGCTGCTGGCCACCGTCGGCGGCCCCGCAGGATTGACTGCCTTTTTGCGCCAGATCGGCGACAACGTCACCCGCCTTGACCGCTGGGAAACGGAACTGAATGAGGCGCTTCCCGGCGACGCCCGCGACACCACTACCCCGGCCAGCATGGCCGCGACCCTGCGCAAGCTGCTGACCAGCCAGCGTCTGAGCGCCCGTTCGCAACGGCAGCTGCTGCAGTGGATGGTGGACGATCGGGTCGCCGGACCGTTGATCCGCTCCGTGCTGCCGGCGGGCTGGTTTATCGCCGATAAGACCGGAGCTAGCAAGCGGGGTGCGCGCGGGATTGTCGCCCTGCTTGGCCCGAATAACAAAGCAGAGCGCATTGTGGTGATTTATCTGCGGGATACGCCGGCGAGCATGGCCGAGCG
26	gb|KM233164|+|0-861|ARO:3003152|SHV-185	ATGCGTTATATTCGCCTGTGTATTATCTCCCTGTTAGCCACCCTGCCGCTGGCG...TAA	861.0	16	822	806	861	ATGCGTTATATTCGCCTGTGTATTATCACCCTGTGAGCCACCCTGCCGCTGGCGGTACACGCCAGCCCGCAGCCGCTTGAGCAAATTAAACAAAGCGAAAGCCAGCTGTCGGGCCGCGTAGGCATGATAGAAATGGATCTGGCCAGCGGCCGCACGCTGACCGCCTGGCGCGCCGATGAACGCTTTCCCATGATGAGCACCTTTAAAGTAGTGCTCTGCGGCGCAGTGCTGGCGCGGGTGGATGCCGGTGACGAACAGCTGGAGCGAAAGATCCACTATCGCCAGCAGGATCTGGTGGACTACTCGCCGGTCAGCGAAAAACACCTTGCCGACGGCATGACGGTCGGCGAACTCTGCGCCGCCGCCATTACCATGAGCGATAACAGCGCCGCCAATCTGCTGCTGGCCACCGTCGGCGGCCCCGCAGGATTGACTGCCTTTTTGCGCCAGATCGGCGACAACGTCACCCGCCTTGACCGCTGGGAAACGGAACTGAATGAGGCGCTTCCCGGCGACGCCCGCGACACCACTACCCCGGCCAGCATGGCCGCGACCCTGCGCAAGCTGCTGACCAGCCAGCGTCTGAGCGCCCGTTCGCAACGGCAGCTGCTGCAGTGGATGGTGGACGATCGGGTCGCCGGACCGTTGATCCGCTCCGTGCTGCCGGCGGGCTGGTTTATCGCCGATAAGACCGGAGCTAGCAAGCGGGGTGCGCGCGGGATTGTCGCCCTGCTTGGCCCGAATAACAAAGCAGAGCGCATTGTGGTGATTTATCTGCGGGATACGCCGGCGAGCATGGCCGAGCG
27	gb|EU085533|+|0-519|ARO:3002591|AAC(6')-Ib-Suzhou	ATGACTGAGCATGACCTTGCGATGCTCTATGAGTGGCTAAATCGATCTCATATC...TAA	519.0	113	577	464	519	ATGACTGAGCATGACCTTGCGATGCTCTATGAGTGGCTAAATCGATCTCATATCGTCGAGTGGTGGGGCGGAGAAGAAGCACGCCCGACACTTGCTGACGTACAGGAACAGTACTTGCCAAGCGTTTTAGCGCAAGAGTCCGTCACTCCATACATTGCAATGCTGAATGGAGAGCCGATTGGGTATGCCCAGTCGTACGTTGCTCTTGGAAGCGGGGACGGATGGTGGGAAGAAGAAACCGATCCAGGAGTACGCGGAATAGACCAGTCACTGGCGAATGCATCACAACTGGGCAAAGGCTTGGGAACCAAGCTGGTTCGAGCTCTGGTTGAGTTGCTGTTCAATGATCCCGAGGTCACCAAGATCCAAACGGACCCGTCGCCGAGCAACTTGCGAGCGATCCGATGCTACGAGAAAGCGGGGTTTGAGAGGCAAGGTACCGTAACCACCCCAGATGGTCCAGC
28	gb|HM751103.1|+|0-864|ARO:3001169|SHV-122	ATGCGTTATATTCGCCTGTGTATTATCTCCCTGTTAGCCACCCTGCCGCTGGCG...TAA	864.0	16	822	806	864	ATGCGTTATATTCGCCTGTGTATTATCACCCTGTGAGCCACCCTGCCGCTGGCGGTACACGCCAGCCCGCAGCCGCTTGAGCAAATTAAACAAAGCGAAAGCCAGCTGTCGGGCCGCGTAGGCATGATAGAAATGGATCTGGCCAGCGGCCGCACGCTGACCGCCTGGCGCGCCGATGAACGCTTTCCCATGATGAGCACCTTTAAAGTAGTGCTCTGCGGCGCAGTGCTGGCGCGGGTGGATGCCGGTGACGAACAGCTGGAGCGAAAGATCCACTATCGCCAGCAGGATCTGGTGGACTACTCGCCGGTCAGCGAAAAACACCTTGCCGACGGCATGACGGTCGGCGAACTCTGCGCCGCCGCCATTACCATGAGCGATAACAGCGCCGCCAATCTGCTGCTGGCCACCGTCGGCGGCCCCGCAGGATTGACTGCCTTTTTGCGCCAGATCGGCGACAACGTCACCCGCCTTGACCGCTGGGAAACGGAACTGAATGAGGCGCTTCCCGGCGACGCCCGCGACACCACTACCCCGGCCAGCATGGCCGCGACCCTGCGCAAGCTGCTGACCAGCCAGCGTCTGAGCGCCCGTTCGCAACGGCAGCTGCTGCAGTGGATGGTGGACGATCGGGTCGCCGGACCGTTGATCCGCTCCGTGCTGCCGGCGGGCTGGTTTATCGCCGATAAGACCGGAGCTAGCAAGCGGGGTGCGCGCGGGATTGTCGCCCTGCTTGGCCCGAATAACAAAGCAGAGCGCATTGTGGTGATTTATCTGCGGGATACGCCGGCGAGCATGGCCGAGCG
29	gb|EU255291.1|+|0-825|ARO:3001444|OXA-122	ATGAACATTAAAGCACTCTTACTTATAACAAGCGCTATTTTTATTTCAGCCTGC...TAG	825.0	54149	54919	770	825	ATGAACATTAAAGCACTCTTACTTATAACAAGCGCTATTTTTATTTCAGCCTGCTCACCTTATATAGTGACTGCTAATCCAAATCACAGCGCTTCAAAATCTGATGTAAAAGCAGAGAAAATTAAAAATTTATTTAACGAAGCACACACTACGGGTGTTTTAGTTATCCAACAAGGCCAAACTCAACAAAGCTATGGTAATGATCTTGCTCGTGCTTCGACCGAGTATGTACCTGCTTCGACCTTCAAAATGCTTAATGCTTTGATCGGCCTTGAGCACCATAAGGCAACCACCACAGAAGTATTTAAGTGGGATGGTAAAAAAAGGTTATTCCCAGAATGGGAAAAGGACATGACCCTAGGCGATGCCATGAAAGCTTCCGCTATTCCAGTTTATCAAGATTTAGCTCGTCGTATTGGACTTGAGCTCATGTCTAAGGAAGTGAAGCGTGTTGGTTATGGCAATGCAGATATCGGTACCCAAGTCGATAATTTTTGGCTGGTGGGTCCTTTAAAAATTACTCCTCAGCAAGAGGCACAGTTTGCTTACAAGCTAGCTAATAAAACGCTTCCATTTAGCCAAAAAGTCCAAGATGAAGTGCAATCCATGCTATTCATAGAAGAAAAGAATGGAAACAAAATATACGCAAAAAGTGGTTGGGGATGGGATGTAAACCCACAAGTAGGCTGGTTAACTGGATGGGTTGTTCAGCCTCAAGGGAATATTGTAGCGTTCTCCCTTAACTTAGAAATGAAAAAAGGAATACCTAG
30	gb|KM233165|+|0-861|ARO:3003153|SHV-186	ATGCGTTATATTCGCCTGTGTATTATCTCCCTGTTAGCCACCCTGCCGCTGGCG...TAA	861.0	16	822	806	861	ATGCGTTATATTCGCCTGTGTATTATCACCCTGTGAGCCACCCTGCCGCTGGCGGTACACGCCAGCCCGCAGCCGCTTGAGCAAATTAAACAAAGCGAAAGCCAGCTGTCGGGCCGCGTAGGCATGATAGAAATGGATCTGGCCAGCGGCCGCACGCTGACCGCCTGGCGCGCCGATGAACGCTTTCCCATGATGAGCACCTTTAAAGTAGTGCTCTGCGGCGCAGTGCTGGCGCGGGTGGATGCCGGTGACGAACAGCTGGAGCGAAAGATCCACTATCGCCAGCAGGATCTGGTGGACTACTCGCCGGTCAGCGAAAAACACCTTGCCGACGGCATGACGGTCGGCGAACTCTGCGCCGCCGCCATTACCATGAGCGATAACAGCGCCGCCAATCTGCTGCTGGCCACCGTCGGCGGCCCCGCAGGATTGACTGCCTTTTTGCGCCAGATCGGCGACAACGTCACCCGCCTTGACCGCTGGGAAACGGAACTGAATGAGGCGCTTCCCGGCGACGCCCGCGACACCACTACCCCGGCCAGCATGGCCGCGACCCTGCGCAAGCTGCTGACCAGCCAGCGTCTGAGCGCCCGTTCGCAACGGCAGCTGCTGCAGTGGATGGTGGACGATCGGGTCGCCGGACCGTTGATCCGCTCCGTGCTGCCGGCGGGCTGGTTTATCGCCGATAAGACCGGAGCTAGCAAGCGGGGTGCGCGCGGGATTGTCGCCCTGCTTGGCCCGAATAACAAAGCAGAGCGCATTGTGGTGATTTATCTGCGGGATACGCCGGCGAGCATGGCCGAGCG
31	gb|KM979376.1|+|20-845|ARO:3003120|OXA-429	ATGAATATTAAAGCACTCTTACTTATAACAAGCGCTATTTTTATTTCAGCCTGC...TAG	825.0	54149	54919	770	825	ATGAACATTAAAGCACTCTTACTTATAACAAGCGCTATTTTTATTTCAGCCTGCTCACCTTATATAGTGACTGCTAATCCAAATCACAGCGCTTCAAAATCTGATGTAAAAGCAGAGAAAATTAAAAATTTATTTAACGAAGCACACACTACGGGTGTTTTAGTTATCCAACAAGGCCAAACTCAACAAAGCTATGGTAATGATCTTGCTCGTGCTTCGACCGAGTATGTACCTGCTTCGACCTTCAAAATGCTTAATGCTTTGATCGGCCTTGAGCACCATAAGGCAACCACCACAGAAGTATTTAAGTGGGATGGTAAAAAAAGGTTATTCCCAGAATGGGAAAAGGACATGACCCTAGGCGATGCCATGAAAGCTTCCGCTATTCCAGTTTATCAAGATTTAGCTCGTCGTATTGGACTTGAGCTCATGTCTAAGGAAGTGAAGCGTGTTGGTTATGGCAATGCAGATATCGGTACCCAAGTCGATAATTTTTGGCTGGTGGGTCCTTTAAAAATTACTCCTCAGCAAGAGGCACAGTTTGCTTACAAGCTAGCTAATAAAACGCTTCCATTTAGCCAAAAAGTCCAAGATGAAGTGCAATCCATGCTATTCATAGAAGAAAAGAATGGAAACAAAATATACGCAAAAAGTGGTTGGGGATGGGATGTAAACCCACAAGTAGGCTGGTTAACTGGATGGGTTGTTCAGCCTCAAGGGAATATTGTAGCGTTCTCCCTTAACTTAGAAATGAAAAAAGGAATACCTAG
32	gb|EU342351|+|172-1033|ARO:3001118|SHV-63	ATGCGTTATATTCGCCTGTGTATTATCTCCCTGTTAGCCACCCTGCCGCTGGCG...TAA	861.0	16	822	806	861	ATGCGTTATATTCGCCTGTGTATTATCACCCTGTGAGCCACCCTGCCGCTGGCGGTACACGCCAGCCCGCAGCCGCTTGAGCAAATTAAACAAAGCGAAAGCCAGCTGTCGGGCCGCGTAGGCATGATAGAAATGGATCTGGCCAGCGGCCGCACGCTGACCGCCTGGCGCGCCGATGAACGCTTTCCCATGATGAGCACCTTTAAAGTAGTGCTCTGCGGCGCAGTGCTGGCGCGGGTGGATGCCGGTGACGAACAGCTGGAGCGAAAGATCCACTATCGCCAGCAGGATCTGGTGGACTACTCGCCGGTCAGCGAAAAACACCTTGCCGACGGCATGACGGTCGGCGAACTCTGCGCCGCCGCCATTACCATGAGCGATAACAGCGCCGCCAATCTGCTGCTGGCCACCGTCGGCGGCCCCGCAGGATTGACTGCCTTTTTGCGCCAGATCGGCGACAACGTCACCCGCCTTGACCGCTGGGAAACGGAACTGAATGAGGCGCTTCCCGGCGACGCCCGCGACACCACTACCCCGGCCAGCATGGCCGCGACCCTGCGCAAGCTGCTGACCAGCCAGCGTCTGAGCGCCCGTTCGCAACGGCAGCTGCTGCAGTGGATGGTGGACGATCGGGTCGCCGGACCGTTGATCCGCTCCGTGCTGCCGGCGGGCTGGTTTATCGCCGATAAGACCGGAGCTAGCAAGCGGGGTGCGCGCGGGATTGTCGCCCTGCTTGGCCCGAATAACAAAGCAGAGCGCATTGTGGTGATTTATCTGCGGGATACGCCGGCGAGCATGGCCGAGCG
33	gb|DQ303918|+|0-600|ARO:3002547|AAC(6')-Ib-cr	ATGAGCAACGCAAAAACAAAGTTAGGCATCACAAAGTACAGCATCGTGACCAAC...TAA	600.0	44	577	533	600	AAAACAAAGTTAGGCATCACAAAGTACAGCATCGTGACCAACAGCAACGATTCCGTCACACTGCGCCTCATGACTGAGCATGACCTTGCGATGCTCTATGAGTGGCTAAATCGATCTCATATCGTCGAGTGGTGGGGCGGAGAAGAAGCACGCCCGACACTTGCTGACGTACAGGAACAGTACTTGCCAAGCGTTTTAGCGCAAGAGTCCGTCACTCCATACATTGCAATGCTGAATGGAGAGCCGATTGGGTATGCCCAGTCGTACGTTGCTCTTGGAAGCGGGGACGGATGGTGGGAAGAAGAAACCGATCCAGGAGTACGCGGAATAGACCAGTCACTGGCGAATGCATCACAACTGGGCAAAGGCTTGGGAACCAAGCTGGTTCGAGCTCTGGTTGAGTTGCTGTTCAATGATCCCGAGGTCACCAAGATCCAAACGGACCCGTCGCCGAGCAACTTGCGAGCGATCCGATGCTACGAGAAAGCGGGGTTTGAGAGGCAAGGTACCGTAACCACCCCAGATGGTCCAGC
34	gb|EU255292.1|+|0-825|ARO:3001445|OXA-123	ATGAACATTAAAGCACTCTTACTTATAACAAGCGCTATTTTTATTTCAGCCTGC...TAG	825.0	54149	54919	770	825	ATGAACATTAAAGCACTCTTACTTATAACAAGCGCTATTTTTATTTCAGCCTGCTCACCTTATATAGTGACTGCTAATCCAAATCACAGCGCTTCAAAATCTGATGTAAAAGCAGAGAAAATTAAAAATTTATTTAACGAAGCACACACTACGGGTGTTTTAGTTATCCAACAAGGCCAAACTCAACAAAGCTATGGTAATGATCTTGCTCGTGCTTCGACCGAGTATGTACCTGCTTCGACCTTCAAAATGCTTAATGCTTTGATCGGCCTTGAGCACCATAAGGCAACCACCACAGAAGTATTTAAGTGGGATGGTAAAAAAAGGTTATTCCCAGAATGGGAAAAGGACATGACCCTAGGCGATGCCATGAAAGCTTCCGCTATTCCAGTTTATCAAGATTTAGCTCGTCGTATTGGACTTGAGCTCATGTCTAAGGAAGTGAAGCGTGTTGGTTATGGCAATGCAGATATCGGTACCCAAGTCGATAATTTTTGGCTGGTGGGTCCTTTAAAAATTACTCCTCAGCAAGAGGCACAGTTTGCTTACAAGCTAGCTAATAAAACGCTTCCATTTAGCCAAAAAGTCCAAGATGAAGTGCAATCCATGCTATTCATAGAAGAAAAGAATGGAAACAAAATATACGCAAAAAGTGGTTGGGGATGGGATGTAAACCCACAAGTAGGCTGGTTAACTGGATGGGTTGTTCAGCCTCAAGGGAATATTGTAGCGTTCTCCCTTAACTTAGAAATGAAAAAAGGAATACCTAG
35	gb|FJ666064|+|0-1194|ARO:3002498|PDC-2	ATGCGCGATACCAGATTCCCCTGCCTGTGCGGCATCGCCGCTTCCACACTGCTG...TGA	1194.0	35513	36652	1139	1194	ATGCGCGATACCAGATTCCCCTGCCTGTGCGGCATCGCCGCTTCCACACTGCTGTTCGCCACCACCCCGGCCATTGCCGATGAGGCCCCGGCGGATCGCCTGAAGGCACTGGTCGACGCCGCCGTACAACCGGTGATGAAGGCCAATGACATTCCGGGCCTGGCCGTAGCCATCAGCCTGAAAGGAGAACCGCATTACTTCAGCTATGGGCTGGCCTCGAAAGAGGACGGCCGCCGGGTGACGCCGGAGACCCTGTTCGAGATCGGCTCGGTGAGCAAGACCTTCACCGTCACCCTCGCCGGCTATGCCCTGGCCCAGGACAAGATGCGCCTCGACGACCGCGCCAGCCAGCACTGGCCGGCACTGCAGGGCAGCCGCTTCGACGGCATCAGCCTGCTCGACCTCGCGACCTATACCGCCGGCGGCTTGCCGCTGCAGTTCCCCGACTCGGTGCAGAAGGACCAGGCACAGATCCGCGACTACTACCGCCAGTGGCAGCCGACCTACGCGCCGGGCAGCCAGCGCCTCTATTCCAACCCGAGCATCGGCCTGTTCGGCTATCTCGCCGCGCGCAGCCTGGGCCAGCCGTTCGAACGGCTCATGGAGCAGCAATTGTTCCCGGCACTGGGCCTCGAACAGACCCACCTCGACGTGCCCGAGGCGGCGCTGGCGCAGTACGCCCAGGGCTACGGCAAGGACGACCGCCCGCTACGGGTCGGTCCCGGCCCGCTGGATGCCGAAGGCTACGGGGTGAAGACCAGCGCGGCCGACCTGCTGCGCTTCGTCGATGCCAACCTGCATCCGGAGCGCCTGGACAGGCCCTGGGCGCAGGCGCTCGATGCCACCCATCGCGGTTACTACAAGGTCGGCGACATGACCCAGGGCCTGGGCTGGGAAGCCTACGACTGGCCGATCTCCCTGAAGCGCCTGCAGGCCGGCAACTCGACGCCGATGGCGCTGCAACCACACAGGATCGCCAGGCTGCCCGCGCCACAGGCGCTGGAGGGCCAGCGCCTGCTGAACAAGACCGGCTCCACCAACGGCTTCGGCGCCTACGTGGCGTTCGTCCCGGGCCGCGACCTGGGCCTGGTGATCCTGGCCAACCGCAACTATCCCAATGCCGAGCGGGTGAAGATCGC
36	gb|EU255293.1|+|0-825|ARO:3001446|OXA-124	ATGAACATTAAAGCACTCTTACTTATAACAAGCGCTATTTTTATTTCAGCCTGC...TAG	825.0	54149	54919	770	825	ATGAACATTAAAGCACTCTTACTTATAACAAGCGCTATTTTTATTTCAGCCTGCTCACCTTATATAGTGACTGCTAATCCAAATCACAGCGCTTCAAAATCTGATGTAAAAGCAGAGAAAATTAAAAATTTATTTAACGAAGCACACACTACGGGTGTTTTAGTTATCCAACAAGGCCAAACTCAACAAAGCTATGGTAATGATCTTGCTCGTGCTTCGACCGAGTATGTACCTGCTTCGACCTTCAAAATGCTTAATGCTTTGATCGGCCTTGAGCACCATAAGGCAACCACCACAGAAGTATTTAAGTGGGATGGTAAAAAAAGGTTATTCCCAGAATGGGAAAAGGACATGACCCTAGGCGATGCCATGAAAGCTTCCGCTATTCCAGTTTATCAAGATTTAGCTCGTCGTATTGGACTTGAGCTCATGTCTAAGGAAGTGAAGCGTGTTGGTTATGGCAATGCAGATATCGGTACCCAAGTCGATAATTTTTGGCTGGTGGGTCCTTTAAAAATTACTCCTCAGCAAGAGGCACAGTTTGCTTACAAGCTAGCTAATAAAACGCTTCCATTTAGCCAAAAAGTCCAAGATGAAGTGCAATCCATGCTATTCATAGAAGAAAAGAATGGAAACAAAATATACGCAAAAAGTGGTTGGGGATGGGATGTAAACCCACAAGTAGGCTGGTTAACTGGATGGGTTGTTCAGCCTCAAGGGAATATTGTAGCGTTCTCCCTTAACTTAGAAATGAAAAAAGGAATACCTAG
37	gb|NG_049717.1|+|13-838|ARO:3003121|OXA-430	ATGAACATTAAAGCACTCTTACTTATAACAAGCGCTATTTTTATTTCAGCCTGC...TAG	825.0	54149	54919	770	825	ATGAACATTAAAGCACTCTTACTTATAACAAGCGCTATTTTTATTTCAGCCTGCTCACCTTATATAGTGACTGCTAATCCAAATCACAGCGCTTCAAAATCTGATGTAAAAGCAGAGAAAATTAAAAATTTATTTAACGAAGCACACACTACGGGTGTTTTAGTTATCCAACAAGGCCAAACTCAACAAAGCTATGGTAATGATCTTGCTCGTGCTTCGACCGAGTATGTACCTGCTTCGACCTTCAAAATGCTTAATGCTTTGATCGGCCTTGAGCACCATAAGGCAACCACCACAGAAGTATTTAAGTGGGATGGTAAAAAAAGGTTATTCCCAGAATGGGAAAAGGACATGACCCTAGGCGATGCCATGAAAGCTTCCGCTATTCCAGTTTATCAAGATTTAGCTCGTCGTATTGGACTTGAGCTCATGTCTAAGGAAGTGAAGCGTGTTGGTTATGGCAATGCAGATATCGGTACCCAAGTCGATAATTTTTGGCTGGTGGGTCCTTTAAAAATTACTCCTCAGCAAGAGGCACAGTTTGCTTACAAGCTAGCTAATAAAACGCTTCCATTTAGCCAAAAAGTCCAAGATGAAGTGCAATCCATGCTATTCATAGAAGAAAAGAATGGAAACAAAATATACGCAAAAAGTGGTTGGGGATGGGATGTAAACCCACAAGTAGGCTGGTTAACTGGATGGGTTGTTCAGCCTCAAGGGAATATTGTAGCGTTCTCCCTTAACTTAGAAATGAAAAAAGGAATACCTAG
38	gb|JQ808129|+|633-1188|ARO:3002546|AAC(6')-Ib	GTGACCAACAGCAACGATTCCGTAACACTGCGCCTCATGACTGAGCATGACCTT...TAA	555.0	77	577	500	555	GTGACCAACAGCAACGATTCCGTCACACTGCGCCTCATGACTGAGCATGACCTTGCGATGCTCTATGAGTGGCTAAATCGATCTCATATCGTCGAGTGGTGGGGCGGAGAAGAAGCACGCCCGACACTTGCTGACGTACAGGAACAGTACTTGCCAAGCGTTTTAGCGCAAGAGTCCGTCACTCCATACATTGCAATGCTGAATGGAGAGCCGATTGGGTATGCCCAGTCGTACGTTGCTCTTGGAAGCGGGGACGGATGGTGGGAAGAAGAAACCGATCCAGGAGTACGCGGAATAGACCAGTCACTGGCGAATGCATCACAACTGGGCAAAGGCTTGGGAACCAAGCTGGTTCGAGCTCTGGTTGAGTTGCTGTTCAATGATCCCGAGGTCACCAAGATCCAAACGGACCCGTCGCCGAGCAACTTGCGAGCGATCCGATGCTACGAGAAAGCGGGGTTTGAGAGGCAAGGTACCGTAACCACCCCAGATGGTCCAGC
39	gb|GQ390805|+|0-813|ARO:3001170|SHV-123	ATGCGTTATATTCGCCTGTGTATTATCTCCCTGTTAGCCACCCTGCCGCTGGCG...CAG	813.0	16	774	758	813	ATGCGTTATATTCGCCTGTGTATTATCACCCTGTGAGCCACCCTGCCGCTGGCGGTACACGCCAGCCCGCAGCCGCTTGAGCAAATTAAACAAAGCGAAAGCCAGCTGTCGGGCCGCGTAGGCATGATAGAAATGGATCTGGCCAGCGGCCGCACGCTGACCGCCTGGCGCGCCGATGAACGCTTTCCCATGATGAGCACCTTTAAAGTAGTGCTCTGCGGCGCAGTGCTGGCGCGGGTGGATGCCGGTGACGAACAGCTGGAGCGAAAGATCCACTATCGCCAGCAGGATCTGGTGGACTACTCGCCGGTCAGCGAAAAACACCTTGCCGACGGCATGACGGTCGGCGAACTCTGCGCCGCCGCCATTACCATGAGCGATAACAGCGCCGCCAATCTGCTGCTGGCCACCGTCGGCGGCCCCGCAGGATTGACTGCCTTTTTGCGCCAGATCGGCGACAACGTCACCCGCCTTGACCGCTGGGAAACGGAACTGAATGAGGCGCTTCCCGGCGACGCCCGCGACACCACTACCCCGGCCAGCATGGCCGCGACCCTGCGCAAGCTGCTGACCAGCCAGCGTCTGAGCGCCCGTTCGCAACGGCAGCTGCTGCAGTGGATGGTGGACGATCGGGTCGCCGGACCGTTGATCCGCTCCGTGCTGCCGGCGGGCTGGTTTATCGCCGATAAGACCGGAGCTAGCAAGCGGGGTGCGCGCGGGATTGTCGCCCTGCTTGGCCCGAATAACAAAGCAGAGCG
40	gb|DQ174304|+|4-865|ARO:3001119|SHV-64	ATGCGTTATATTCGCCTGTGTATTATCTCCCTGTTAGCCACCCTGCCGCTGGCG...TAA	861.0	16	822	806	861	ATGCGTTATATTCGCCTGTGTATTATCACCCTGTGAGCCACCCTGCCGCTGGCGGTACACGCCAGCCCGCAGCCGCTTGAGCAAATTAAACAAAGCGAAAGCCAGCTGTCGGGCCGCGTAGGCATGATAGAAATGGATCTGGCCAGCGGCCGCACGCTGACCGCCTGGCGCGCCGATGAACGCTTTCCCATGATGAGCACCTTTAAAGTAGTGCTCTGCGGCGCAGTGCTGGCGCGGGTGGATGCCGGTGACGAACAGCTGGAGCGAAAGATCCACTATCGCCAGCAGGATCTGGTGGACTACTCGCCGGTCAGCGAAAAACACCTTGCCGACGGCATGACGGTCGGCGAACTCTGCGCCGCCGCCATTACCATGAGCGATAACAGCGCCGCCAATCTGCTGCTGGCCACCGTCGGCGGCCCCGCAGGATTGACTGCCTTTTTGCGCCAGATCGGCGACAACGTCACCCGCCTTGACCGCTGGGAAACGGAACTGAATGAGGCGCTTCCCGGCGACGCCCGCGACACCACTACCCCGGCCAGCATGGCCGCGACCCTGCGCAAGCTGCTGACCAGCCAGCGTCTGAGCGCCCGTTCGCAACGGCAGCTGCTGCAGTGGATGGTGGACGATCGGGTCGCCGGACCGTTGATCCGCTCCGTGCTGCCGGCGGGCTGGTTTATCGCCGATAAGACCGGAGCTAGCAAGCGGGGTGCGCGCGGGATTGTCGCCCTGCTTGGCCCGAATAACAAAGCAGAGCGCATTGTGGTGATTTATCTGCGGGATACGCCGGCGAGCATGGCCGAGCG
41	gb|APQY01000006.1|+|416598-417423|ARO:3001719|OXA-263	ATGAATATTAAAGCACTCTTACTTATAACAAGCGCTATTTTTATTTCAGCCTGT...TAG	825.0	54149	54919	770	825	ATGAACATTAAAGCACTCTTACTTATAACAAGCGCTATTTTTATTTCAGCCTGCTCACCTTATATAGTGACTGCTAATCCAAATCACAGCGCTTCAAAATCTGATGTAAAAGCAGAGAAAATTAAAAATTTATTTAACGAAGCACACACTACGGGTGTTTTAGTTATCCAACAAGGCCAAACTCAACAAAGCTATGGTAATGATCTTGCTCGTGCTTCGACCGAGTATGTACCTGCTTCGACCTTCAAAATGCTTAATGCTTTGATCGGCCTTGAGCACCATAAGGCAACCACCACAGAAGTATTTAAGTGGGATGGTAAAAAAAGGTTATTCCCAGAATGGGAAAAGGACATGACCCTAGGCGATGCCATGAAAGCTTCCGCTATTCCAGTTTATCAAGATTTAGCTCGTCGTATTGGACTTGAGCTCATGTCTAAGGAAGTGAAGCGTGTTGGTTATGGCAATGCAGATATCGGTACCCAAGTCGATAATTTTTGGCTGGTGGGTCCTTTAAAAATTACTCCTCAGCAAGAGGCACAGTTTGCTTACAAGCTAGCTAATAAAACGCTTCCATTTAGCCAAAAAGTCCAAGATGAAGTGCAATCCATGCTATTCATAGAAGAAAAGAATGGAAACAAAATATACGCAAAAAGTGGTTGGGGATGGGATGTAAACCCACAAGTAGGCTGGTTAACTGGATGGGTTGTTCAGCCTCAAGGGAATATTGTAGCGTTCTCCCTTAACTTAGAAATGAAAAAAGGAATACCTAG
42	gb|EU255294.1|+|0-825|ARO:3001447|OXA-125	ATGAACATTAAAGCACTCTTACTTATAACAAGCGCTATTTTTATTTCAGCCTGC...TAG	825.0	54149	54919	770	825	ATGAACATTAAAGCACTCTTACTTATAACAAGCGCTATTTTTATTTCAGCCTGCTCACCTTATATAGTGACTGCTAATCCAAATCACAGCGCTTCAAAATCTGATGTAAAAGCAGAGAAAATTAAAAATTTATTTAACGAAGCACACACTACGGGTGTTTTAGTTATCCAACAAGGCCAAACTCAACAAAGCTATGGTAATGATCTTGCTCGTGCTTCGACCGAGTATGTACCTGCTTCGACCTTCAAAATGCTTAATGCTTTGATCGGCCTTGAGCACCATAAGGCAACCACCACAGAAGTATTTAAGTGGGATGGTAAAAAAAGGTTATTCCCAGAATGGGAAAAGGACATGACCCTAGGCGATGCCATGAAAGCTTCCGCTATTCCAGTTTATCAAGATTTAGCTCGTCGTATTGGACTTGAGCTCATGTCTAAGGAAGTGAAGCGTGTTGGTTATGGCAATGCAGATATCGGTACCCAAGTCGATAATTTTTGGCTGGTGGGTCCTTTAAAAATTACTCCTCAGCAAGAGGCACAGTTTGCTTACAAGCTAGCTAATAAAACGCTTCCATTTAGCCAAAAAGTCCAAGATGAAGTGCAATCCATGCTATTCATAGAAGAAAAGAATGGAAACAAAATATACGCAAAAAGTGGTTGGGGATGGGATGTAAACCCACAAGTAGGCTGGTTAACTGGATGGGTTGTTCAGCCTCAAGGGAATATTGTAGCGTTCTCCCTTAACTTAGAAATGAAAAAAGGAATACCTAG
43	gb|LN515533|+|0-867|ARO:3003154|SHV-187	GTGGTTAAGCGTTATATTCGCCTGTGTATTATCTCCCTGTTAGCCACCCTGCCG...TAA	867.0	10	822	812	867	GTGGTTATGCGTTATATTCGCCTGTGTATTATCACCCTGTGAGCCACCCTGCCGCTGGCGGTACACGCCAGCCCGCAGCCGCTTGAGCAAATTAAACAAAGCGAAAGCCAGCTGTCGGGCCGCGTAGGCATGATAGAAATGGATCTGGCCAGCGGCCGCACGCTGACCGCCTGGCGCGCCGATGAACGCTTTCCCATGATGAGCACCTTTAAAGTAGTGCTCTGCGGCGCAGTGCTGGCGCGGGTGGATGCCGGTGACGAACAGCTGGAGCGAAAGATCCACTATCGCCAGCAGGATCTGGTGGACTACTCGCCGGTCAGCGAAAAACACCTTGCCGACGGCATGACGGTCGGCGAACTCTGCGCCGCCGCCATTACCATGAGCGATAACAGCGCCGCCAATCTGCTGCTGGCCACCGTCGGCGGCCCCGCAGGATTGACTGCCTTTTTGCGCCAGATCGGCGACAACGTCACCCGCCTTGACCGCTGGGAAACGGAACTGAATGAGGCGCTTCCCGGCGACGCCCGCGACACCACTACCCCGGCCAGCATGGCCGCGACCCTGCGCAAGCTGCTGACCAGCCAGCGTCTGAGCGCCCGTTCGCAACGGCAGCTGCTGCAGTGGATGGTGGACGATCGGGTCGCCGGACCGTTGATCCGCTCCGTGCTGCCGGCGGGCTGGTTTATCGCCGATAAGACCGGAGCTAGCAAGCGGGGTGCGCGCGGGATTGTCGCCCTGCTTGGCCCGAATAACAAAGCAGAGCGCATTGTGGTGATTTATCTGCGGGATACGCCGGCGAGCATGGCCGAGCG
44	gb|KM979378.1|+|14-839|ARO:3003124|OXA-431	ATGAACATTAAAGCACTCTTACTTATAACAAGCGCTATTTTTATTTCAGCCTGC...TAG	825.0	54149	54919	770	825	ATGAACATTAAAGCACTCTTACTTATAACAAGCGCTATTTTTATTTCAGCCTGCTCACCTTATATAGTGACTGCTAATCCAAATCACAGCGCTTCAAAATCTGATGTAAAAGCAGAGAAAATTAAAAATTTATTTAACGAAGCACACACTACGGGTGTTTTAGTTATCCAACAAGGCCAAACTCAACAAAGCTATGGTAATGATCTTGCTCGTGCTTCGACCGAGTATGTACCTGCTTCGACCTTCAAAATGCTTAATGCTTTGATCGGCCTTGAGCACCATAAGGCAACCACCACAGAAGTATTTAAGTGGGATGGTAAAAAAAGGTTATTCCCAGAATGGGAAAAGGACATGACCCTAGGCGATGCCATGAAAGCTTCCGCTATTCCAGTTTATCAAGATTTAGCTCGTCGTATTGGACTTGAGCTCATGTCTAAGGAAGTGAAGCGTGTTGGTTATGGCAATGCAGATATCGGTACCCAAGTCGATAATTTTTGGCTGGTGGGTCCTTTAAAAATTACTCCTCAGCAAGAGGCACAGTTTGCTTACAAGCTAGCTAATAAAACGCTTCCATTTAGCCAAAAAGTCCAAGATGAAGTGCAATCCATGCTATTCATAGAAGAAAAGAATGGAAACAAAATATACGCAAAAAGTGGTTGGGGATGGGATGTAAACCCACAAGTAGGCTGGTTAACTGGATGGGTTGTTCAGCCTCAAGGGAATATTGTAGCGTTCTCCCTTAACTTAGAAATGAAAAAAGGAATACCTAG
45	gb|U59183|+|247-859|ARO:3002581|AAC(6')-Ib10	ATGTTACGCAGCAGCAGTCGCCCTAAAACAAAGTTAGGCATCACAAAGTACAGC...TAA	612.0	18	577	559	612	ATGTTACGCAGCAGGGCAGTCGCCCTAAAACAAAGTTAGGCATCACAAAGTACAGCATCGTGACCAACAGCAACGATTCCGTCACACTGCGCCTCATGACTGAGCATGACCTTGCGATGCTCTATGAGTGGCTAAATCGATCTCATATCGTCGAGTGGTGGGGCGGAGAAGAAGCACGCCCGACACTTGCTGACGTACAGGAACAGTACTTGCCAAGCGTTTTAGCGCAAGAGTCCGTCACTCCATACATTGCAATGCTGAATGGAGAGCCGATTGGGTATGCCCAGTCGTACGTTGCTCTTGGAAGCGGGGACGGATGGTGGGAAGAAGAAACCGATCCAGGAGTACGCGGAATAGACCAGTCACTGGCGAATGCATCACAACTGGGCAAAGGCTTGGGAACCAAGCTGGTTCGAGCTCTGGTTGAGTTGCTGTTCAATGATCCCGAGGTCACCAAGATCCAAACGGACCCGTCGCCGAGCAACTTGCGAGCGATCCGATGCTACGAGAAAGCGGGGTTTGAGAGGCAAGGTACCGTAACCACCCCAGATGGTCCAGC
46	gb|GQ390806|+|0-813|ARO:3001171|SHV-124	ATGCGTTATATTCGCCTGTGTATTATCTCCCTGTTAGCCACCCTGCCGCTGGCG...CAG	813.0	16	774	758	813	ATGCGTTATATTCGCCTGTGTATTATCACCCTGTGAGCCACCCTGCCGCTGGCGGTACACGCCAGCCCGCAGCCGCTTGAGCAAATTAAACAAAGCGAAAGCCAGCTGTCGGGCCGCGTAGGCATGATAGAAATGGATCTGGCCAGCGGCCGCACGCTGACCGCCTGGCGCGCCGATGAACGCTTTCCCATGATGAGCACCTTTAAAGTAGTGCTCTGCGGCGCAGTGCTGGCGCGGGTGGATGCCGGTGACGAACAGCTGGAGCGAAAGATCCACTATCGCCAGCAGGATCTGGTGGACTACTCGCCGGTCAGCGAAAAACACCTTGCCGACGGCATGACGGTCGGCGAACTCTGCGCCGCCGCCATTACCATGAGCGATAACAGCGCCGCCAATCTGCTGCTGGCCACCGTCGGCGGCCCCGCAGGATTGACTGCCTTTTTGCGCCAGATCGGCGACAACGTCACCCGCCTTGACCGCTGGGAAACGGAACTGAATGAGGCGCTTCCCGGCGACGCCCGCGACACCACTACCCCGGCCAGCATGGCCGCGACCCTGCGCAAGCTGCTGACCAGCCAGCGTCTGAGCGCCCGTTCGCAACGGCAGCTGCTGCAGTGGATGGTGGACGATCGGGTCGCCGGACCGTTGATCCGCTCCGTGCTGCCGGCGGGCTGGTTTATCGCCGATAAGACCGGAGCTAGCAAGCGGGGTGCGCGCGGGATTGTCGCCCTGCTTGGCCCGAATAACAAAGCAGAGCG
47	gb|EU255295.1|+|0-825|ARO:3001448|OXA-126	ATGAACATTAAAGCACTCTTACTTATAACAAGCGCTATTTTTATTTCAGCCTGC...TAG	825.0	54149	54919	770	825	ATGAACATTAAAGCACTCTTACTTATAACAAGCGCTATTTTTATTTCAGCCTGCTCACCTTATATAGTGACTGCTAATCCAAATCACAGCGCTTCAAAATCTGATGTAAAAGCAGAGAAAATTAAAAATTTATTTAACGAAGCACACACTACGGGTGTTTTAGTTATCCAACAAGGCCAAACTCAACAAAGCTATGGTAATGATCTTGCTCGTGCTTCGACCGAGTATGTACCTGCTTCGACCTTCAAAATGCTTAATGCTTTGATCGGCCTTGAGCACCATAAGGCAACCACCACAGAAGTATTTAAGTGGGATGGTAAAAAAAGGTTATTCCCAGAATGGGAAAAGGACATGACCCTAGGCGATGCCATGAAAGCTTCCGCTATTCCAGTTTATCAAGATTTAGCTCGTCGTATTGGACTTGAGCTCATGTCTAAGGAAGTGAAGCGTGTTGGTTATGGCAATGCAGATATCGGTACCCAAGTCGATAATTTTTGGCTGGTGGGTCCTTTAAAAATTACTCCTCAGCAAGAGGCACAGTTTGCTTACAAGCTAGCTAATAAAACGCTTCCATTTAGCCAAAAAGTCCAAGATGAAGTGCAATCCATGCTATTCATAGAAGAAAAGAATGGAAACAAAATATACGCAAAAAGTGGTTGGGGATGGGATGTAAACCCACAAGTAGGCTGGTTAACTGGATGGGTTGTTCAGCCTCAAGGGAATATTGTAGCGTTCTCCCTTAACTTAGAAATGAAAAAAGGAATACCTAG
48	gb|KM979379.1|+|14-839|ARO:3003125|OXA-432	ATGAACATTAAAGCACTCTTACTTATAACAAGCGCTATTTTTATTTCAGCCTGC...TAG	825.0	54149	54919	770	825	ATGAACATTAAAGCACTCTTACTTATAACAAGCGCTATTTTTATTTCAGCCTGCTCACCTTATATAGTGACTGCTAATCCAAATCACAGCGCTTCAAAATCTGATGTAAAAGCAGAGAAAATTAAAAATTTATTTAACGAAGCACACACTACGGGTGTTTTAGTTATCCAACAAGGCCAAACTCAACAAAGCTATGGTAATGATCTTGCTCGTGCTTCGACCGAGTATGTACCTGCTTCGACCTTCAAAATGCTTAATGCTTTGATCGGCCTTGAGCACCATAAGGCAACCACCACAGAAGTATTTAAGTGGGATGGTAAAAAAAGGTTATTCCCAGAATGGGAAAAGGACATGACCCTAGGCGATGCCATGAAAGCTTCCGCTATTCCAGTTTATCAAGATTTAGCTCGTCGTATTGGACTTGAGCTCATGTCTAAGGAAGTGAAGCGTGTTGGTTATGGCAATGCAGATATCGGTACCCAAGTCGATAATTTTTGGCTGGTGGGTCCTTTAAAAATTACTCCTCAGCAAGAGGCACAGTTTGCTTACAAGCTAGCTAATAAAACGCTTCCATTTAGCCAAAAAGTCCAAGATGAAGTGCAATCCATGCTATTCATAGAAGAAAAGAATGGAAACAAAATATACGCAAAAAGTGGTTGGGGATGGGATGTAAACCCACAAGTAGGCTGGTTAACTGGATGGGTTGTTCAGCCTCAAGGGAATATTGTAGCGTTCTCCCTTAACTTAGAAATGAAAAAAGGAATACCTAG
49	gb|EU255296.1|+|0-825|ARO:3001449|OXA-127	ATGAACATTAAAGCACTCTTACTTATAACAAGCGCTATTTTTATTTCAGCCTGC...TAG	825.0	54149	54919	770	825	ATGAACATTAAAGCACTCTTACTTATAACAAGCGCTATTTTTATTTCAGCCTGCTCACCTTATATAGTGACTGCTAATCCAAATCACAGCGCTTCAAAATCTGATGTAAAAGCAGAGAAAATTAAAAATTTATTTAACGAAGCACACACTACGGGTGTTTTAGTTATCCAACAAGGCCAAACTCAACAAAGCTATGGTAATGATCTTGCTCGTGCTTCGACCGAGTATGTACCTGCTTCGACCTTCAAAATGCTTAATGCTTTGATCGGCCTTGAGCACCATAAGGCAACCACCACAGAAGTATTTAAGTGGGATGGTAAAAAAAGGTTATTCCCAGAATGGGAAAAGGACATGACCCTAGGCGATGCCATGAAAGCTTCCGCTATTCCAGTTTATCAAGATTTAGCTCGTCGTATTGGACTTGAGCTCATGTCTAAGGAAGTGAAGCGTGTTGGTTATGGCAATGCAGATATCGGTACCCAAGTCGATAATTTTTGGCTGGTGGGTCCTTTAAAAATTACTCCTCAGCAAGAGGCACAGTTTGCTTACAAGCTAGCTAATAAAACGCTTCCATTTAGCCAAAAAGTCCAAGATGAAGTGCAATCCATGCTATTCATAGAAGAAAAGAATGGAAACAAAATATACGCAAAAAGTGGTTGGGGATGGGATGTAAACCCACAAGTAGGCTGGTTAACTGGATGGGTTGTTCAGCCTCAAGGGAATATTGTAGCGTTCTCCCTTAACTTAGAAATGAAAAAAGGAATACCTAG
50	gb|LN515534|+|0-873|ARO:3003155|SHV-188	GTGGTTAAGCGTTATATTCGCCTGTGTATTATCTCCCTGTTAGCCACCCTGCCG...TAA	873.0	10	822	812	873	GTGGTTATGCGTTATATTCGCCTGTGTATTATCACCCTGTGAGCCACCCTGCCGCTGGCGGTACACGCCAGCCCGCAGCCGCTTGAGCAAATTAAACAAAGCGAAAGCCAGCTGTCGGGCCGCGTAGGCATGATAGAAATGGATCTGGCCAGCGGCCGCACGCTGACCGCCTGGCGCGCCGATGAACGCTTTCCCATGATGAGCACCTTTAAAGTAGTGCTCTGCGGCGCAGTGCTGGCGCGGGTGGATGCCGGTGACGAACAGCTGGAGCGAAAGATCCACTATCGCCAGCAGGATCTGGTGGACTACTCGCCGGTCAGCGAAAAACACCTTGCCGACGGCATGACGGTCGGCGAACTCTGCGCCGCCGCCATTACCATGAGCGATAACAGCGCCGCCAATCTGCTGCTGGCCACCGTCGGCGGCCCCGCAGGATTGACTGCCTTTTTGCGCCAGATCGGCGACAACGTCACCCGCCTTGACCGCTGGGAAACGGAACTGAATGAGGCGCTTCCCGGCGACGCCCGCGACACCACTACCCCGGCCAGCATGGCCGCGACCCTGCGCAAGCTGCTGACCAGCCAGCGTCTGAGCGCCCGTTCGCAACGGCAGCTGCTGCAGTGGATGGTGGACGATCGGGTCGCCGGACCGTTGATCCGCTCCGTGCTGCCGGCGGGCTGGTTTATCGCCGATAAGACCGGAGCTAGCAAGCGGGGTGCGCGCGGGATTGTCGCCCTGCTTGGCCCGAATAACAAAGCAGAGCGCATTGTGGTGATTTATCTGCGGGATACGCCGGCGAGCATGGCCGAGCG
51	gb|GQ390807|+|0-813|ARO:3001172|SHV-125	ATGCGTTATATTCGCCTGAATATTATCTCCCTGTTAGCCACCCTGCCGCTGGCG...CAG	813.0	16	774	758	813	ATGCGTTATATTCGCCTGTGTATTATCACCCTGTGAGCCACCCTGCCGCTGGCGGTACACGCCAGCCCGCAGCCGCTTGAGCAAATTAAACAAAGCGAAAGCCAGCTGTCGGGCCGCGTAGGCATGATAGAAATGGATCTGGCCAGCGGCCGCACGCTGACCGCCTGGCGCGCCGATGAACGCTTTCCCATGATGAGCACCTTTAAAGTAGTGCTCTGCGGCGCAGTGCTGGCGCGGGTGGATGCCGGTGACGAACAGCTGGAGCGAAAGATCCACTATCGCCAGCAGGATCTGGTGGACTACTCGCCGGTCAGCGAAAAACACCTTGCCGACGGCATGACGGTCGGCGAACTCTGCGCCGCCGCCATTACCATGAGCGATAACAGCGCCGCCAATCTGCTGCTGGCCACCGTCGGCGGCCCCGCAGGATTGACTGCCTTTTTGCGCCAGATCGGCGACAACGTCACCCGCCTTGACCGCTGGGAAACGGAACTGAATGAGGCGCTTCCCGGCGACGCCCGCGACACCACTACCCCGGCCAGCATGGCCGCGACCCTGCGCAAGCTGCTGACCAGCCAGCGTCTGAGCGCCCGTTCGCAACGGCAGCTGCTGCAGTGGATGGTGGACGATCGGGTCGCCGGACCGTTGATCCGCTCCGTGCTGCCGGCGGGCTGGTTTATCGCCGATAAGACCGGAGCTAGCAAGCGGGGTGCGCGCGGGATTGTCGCCCTGCTTGGCCCGAATAACAAAGCAGAGCG
52	gb|KM979380.1|+|25-850|ARO:3003126|OXA-433	ATGAACATTAAAGCACTCTTACTTATAACAAGCGCTATTTTTATTTCAGCCTGC...TAG	825.0	54149	54919	770	825	ATGAACATTAAAGCACTCTTACTTATAACAAGCGCTATTTTTATTTCAGCCTGCTCACCTTATATAGTGACTGCTAATCCAAATCACAGCGCTTCAAAATCTGATGTAAAAGCAGAGAAAATTAAAAATTTATTTAACGAAGCACACACTACGGGTGTTTTAGTTATCCAACAAGGCCAAACTCAACAAAGCTATGGTAATGATCTTGCTCGTGCTTCGACCGAGTATGTACCTGCTTCGACCTTCAAAATGCTTAATGCTTTGATCGGCCTTGAGCACCATAAGGCAACCACCACAGAAGTATTTAAGTGGGATGGTAAAAAAAGGTTATTCCCAGAATGGGAAAAGGACATGACCCTAGGCGATGCCATGAAAGCTTCCGCTATTCCAGTTTATCAAGATTTAGCTCGTCGTATTGGACTTGAGCTCATGTCTAAGGAAGTGAAGCGTGTTGGTTATGGCAATGCAGATATCGGTACCCAAGTCGATAATTTTTGGCTGGTGGGTCCTTTAAAAATTACTCCTCAGCAAGAGGCACAGTTTGCTTACAAGCTAGCTAATAAAACGCTTCCATTTAGCCAAAAAGTCCAAGATGAAGTGCAATCCATGCTATTCATAGAAGAAAAGAATGGAAACAAAATATACGCAAAAAGTGGTTGGGGATGGGATGTAAACCCACAAGTAGGCTGGTTAACTGGATGGGTTGTTCAGCCTCAAGGGAATATTGTAGCGTTCTCCCTTAACTTAGAAATGAAAAAAGGAATACCTAG
53	gb|DQ174305|+|4-865|ARO:3001120|SHV-65	ATGCGTTATATTCGCCTGTGTATTATCTCCCTGTTAGCCACCCTGCCGCTGGCG...TAA	861.0	16	822	806	861	ATGCGTTATATTCGCCTGTGTATTATCACCCTGTGAGCCACCCTGCCGCTGGCGGTACACGCCAGCCCGCAGCCGCTTGAGCAAATTAAACAAAGCGAAAGCCAGCTGTCGGGCCGCGTAGGCATGATAGAAATGGATCTGGCCAGCGGCCGCACGCTGACCGCCTGGCGCGCCGATGAACGCTTTCCCATGATGAGCACCTTTAAAGTAGTGCTCTGCGGCGCAGTGCTGGCGCGGGTGGATGCCGGTGACGAACAGCTGGAGCGAAAGATCCACTATCGCCAGCAGGATCTGGTGGACTACTCGCCGGTCAGCGAAAAACACCTTGCCGACGGCATGACGGTCGGCGAACTCTGCGCCGCCGCCATTACCATGAGCGATAACAGCGCCGCCAATCTGCTGCTGGCCACCGTCGGCGGCCCCGCAGGATTGACTGCCTTTTTGCGCCAGATCGGCGACAACGTCACCCGCCTTGACCGCTGGGAAACGGAACTGAATGAGGCGCTTCCCGGCGACGCCCGCGACACCACTACCCCGGCCAGCATGGCCGCGACCCTGCGCAAGCTGCTGACCAGCCAGCGTCTGAGCGCCCGTTCGCAACGGCAGCTGCTGCAGTGGATGGTGGACGATCGGGTCGCCGGACCGTTGATCCGCTCCGTGCTGCCGGCGGGCTGGTTTATCGCCGATAAGACCGGAGCTAGCAAGCGGGGTGCGCGCGGGATTGTCGCCCTGCTTGGCCCGAATAACAAAGCAGAGCGCATTGTGGTGATTTATCTGCGGGATACGCCGGCGAGCATGGCCGAGCG
54	gb|AF201828.2|+|115-937|ARO:3001422|OXA-27	ATGAATAAATATTTTACTTGCTATGTGGTTGCTTCTCTTTTTCTTTCTGGTTGT...TAA	822.0	80	847	767	822	ATGAATAAATATTTTACTTGCTATGTGGTTGCTTCTCTTTTTCTTTCTGGTTGTACGGTTCAGCATAATTTAATAAATGAAACCCCGAGTCAGATTGTTCAAGGACATAATCAGGTGATTCATCAATACTTTGATGAAAAAAACACCTCAGGTGTGCTGGTTATTCAAACAGATAAAAAAATTAATCTATATGGTAATGCTCTAAGCCGCGCAAATACAGAATATGTGCCAGCCTCTACATTTAAAATGTTGAATGCCCTGATCGGATTGGAGAACCAGAAAACGGATATTAATGAAATATTTAAATGGAAGGGCGAGAAAAGGTCATTTACCGCTTGGGAAAAAGACATGACACTAGGAGAAGCCATGAAGCTTTCTGCAGTCCCAGTCTATCAGGAACTTGCGCGACGTATCGGTCTTGATCTCATGCAAAAAGAAGTAAAACGTATTGGTTTCGGTAATGCTGAAATTGGACAGCAGGTTGATAATTTCTGGTTGGTAGGACCATTAAAGGTTACGCCTATTCAAGAGGTAGAGTTTGTTTCCCAATTAGCACATACACAGCTTCCATTTAGTGAAAAAGTGCAGGCTAATGTAAAAAATATGCTTCTTTTAGAAGAGAGTAATGGCTACAAAATTTTTGGAAAGACTGGTTGGGCAATGGATATAAAACCACAAGTGGGCTGGTTGACCGGCTGGGTTGAGCAGCCAGATGGAAAAATTGTCGCTTTTGCATTAAATATGGAAATGCGGTCAGAAATGCCGGC
55	gb|AY136758|+|377-947|ARO:3002582|AAC(6')-Ib11	ATGAAAAACACAATACATATCAACAGCAACGATTCCGTCACACTGCGCCTCATG...TAA	570.0	82	577	495	570	CAACAGCAACGATTCCGTCACACTGCGCCTCATGACTGAGCATGACCTTGCGATGCTCTATGAGTGGCTAAATCGATCTCATATCGTCGAGTGGTGGGGCGGAGAAGAAGCACGCCCGACACTTGCTGACGTACAGGAACAGTACTTGCCAAGCGTTTTAGCGCAAGAGTCCGTCACTCCATACATTGCAATGCTGAATGGAGAGCCGATTGGGTATGCCCAGTCGTACGTTGCTCTTGGAAGCGGGGACGGATGGTGGGAAGAAGAAACCGATCCAGGAGTACGCGGAATAGACCAGTCACTGGCGAATGCATCACAACTGGGCAAAGGCTTGGGAACCAAGCTGGTTCGAGCTCTGGTTGAGTTGCTGTTCAATGATCCCGAGGTCACCAAGATCCAAACGGACCCGTCGCCGAGCAACTTGCGAGCGATCCGATGCTACGAGAAAGCGGGGTTTGAGAGGCAAGGTACCGTAACCACCCCAGATGGTCCAGC
56	gb|KP144324|+|0-822|ARO:3003162|OXA-435	ATGAATAAATATTTTACTTGCTATGTGGTTGCTTCTCTTTTTCTTTCTGGTTGT...TAA	822.0	80	847	767	822	ATGAATAAATATTTTACTTGCTATGTGGTTGCTTCTCTTTTTCTTTCTGGTTGTACGGTTCAGCATAATTTAATAAATGAAACCCCGAGTCAGATTGTTCAAGGACATAATCAGGTGATTCATCAATACTTTGATGAAAAAAACACCTCAGGTGTGCTGGTTATTCAAACAGATAAAAAAATTAATCTATATGGTAATGCTCTAAGCCGCGCAAATACAGAATATGTGCCAGCCTCTACATTTAAAATGTTGAATGCCCTGATCGGATTGGAGAACCAGAAAACGGATATTAATGAAATATTTAAATGGAAGGGCGAGAAAAGGTCATTTACCGCTTGGGAAAAAGACATGACACTAGGAGAAGCCATGAAGCTTTCTGCAGTCCCAGTCTATCAGGAACTTGCGCGACGTATCGGTCTTGATCTCATGCAAAAAGAAGTAAAACGTATTGGTTTCGGTAATGCTGAAATTGGACAGCAGGTTGATAATTTCTGGTTGGTAGGACCATTAAAGGTTACGCCTATTCAAGAGGTAGAGTTTGTTTCCCAATTAGCACATACACAGCTTCCATTTAGTGAAAAAGTGCAGGCTAATGTAAAAAATATGCTTCTTTTAGAAGAGAGTAATGGCTACAAAATTTTTGGAAAGACTGGTTGGGCAATGGATATAAAACCACAAGTGGGCTGGTTGACCGGCTGGGTTGAGCAGCCAGATGGAAAAATTGTCGCTTTTGCATTAAATATGGAAATGCGGTCAGAAATGCCGGC
57	gb|EU375515|+|0-825|ARO:3001648|OXA-128	ATGAACATTAAAGCACTCTTACTTATAACAAGCGCTATTTTTATTTCAGCCTGC...TAG	825.0	54149	54919	770	825	ATGAACATTAAAGCACTCTTACTTATAACAAGCGCTATTTTTATTTCAGCCTGCTCACCTTATATAGTGACTGCTAATCCAAATCACAGCGCTTCAAAATCTGATGTAAAAGCAGAGAAAATTAAAAATTTATTTAACGAAGCACACACTACGGGTGTTTTAGTTATCCAACAAGGCCAAACTCAACAAAGCTATGGTAATGATCTTGCTCGTGCTTCGACCGAGTATGTACCTGCTTCGACCTTCAAAATGCTTAATGCTTTGATCGGCCTTGAGCACCATAAGGCAACCACCACAGAAGTATTTAAGTGGGATGGTAAAAAAAGGTTATTCCCAGAATGGGAAAAGGACATGACCCTAGGCGATGCCATGAAAGCTTCCGCTATTCCAGTTTATCAAGATTTAGCTCGTCGTATTGGACTTGAGCTCATGTCTAAGGAAGTGAAGCGTGTTGGTTATGGCAATGCAGATATCGGTACCCAAGTCGATAATTTTTGGCTGGTGGGTCCTTTAAAAATTACTCCTCAGCAAGAGGCACAGTTTGCTTACAAGCTAGCTAATAAAACGCTTCCATTTAGCCAAAAAGTCCAAGATGAAGTGCAATCCATGCTATTCATAGAAGAAAAGAATGGAAACAAAATATACGCAAAAAGTGGTTGGGGATGGGATGTAAACCCACAAGTAGGCTGGTTAACTGGATGGGTTGTTCAGCCTCAAGGGAATATTGTAGCGTTCTCCCTTAACTTAGAAATGAAAAAAGGAATACCTAG
58	gb|FJ666066|+|0-1194|ARO:3002500|PDC-3	ATGCGCGATACCAGATTCCCCTGCCTGTGCGGCATCGCCGCTTCCACACTGCTG...TGA	1194.0	35513	36652	1139	1194	ATGCGCGATACCAGATTCCCCTGCCTGTGCGGCATCGCCGCTTCCACACTGCTGTTCGCCACCACCCCGGCCATTGCCGATGAGGCCCCGGCGGATCGCCTGAAGGCACTGGTCGACGCCGCCGTACAACCGGTGATGAAGGCCAATGACATTCCGGGCCTGGCCGTAGCCATCAGCCTGAAAGGAGAACCGCATTACTTCAGCTATGGGCTGGCCTCGAAAGAGGACGGCCGCCGGGTGACGCCGGAGACCCTGTTCGAGATCGGCTCGGTGAGCAAGACCTTCACCGTCACCCTCGCCGGCTATGCCCTGGCCCAGGACAAGATGCGCCTCGACGACCGCGCCAGCCAGCACTGGCCGGCACTGCAGGGCAGCCGCTTCGACGGCATCAGCCTGCTCGACCTCGCGACCTATACCGCCGGCGGCTTGCCGCTGCAGTTCCCCGACTCGGTGCAGAAGGACCAGGCACAGATCCGCGACTACTACCGCCAGTGGCAGCCGACCTACGCGCCGGGCAGCCAGCGCCTCTATTCCAACCCGAGCATCGGCCTGTTCGGCTATCTCGCCGCGCGCAGCCTGGGCCAGCCGTTCGAACGGCTCATGGAGCAGCAATTGTTCCCGGCACTGGGCCTCGAACAGACCCACCTCGACGTGCCCGAGGCGGCGCTGGCGCAGTACGCCCAGGGCTACGGCAAGGACGACCGCCCGCTACGGGTCGGTCCCGGCCCGCTGGATGCCGAAGGCTACGGGGTGAAGACCAGCGCGGCCGACCTGCTGCGCTTCGTCGATGCCAACCTGCATCCGGAGCGCCTGGACAGGCCCTGGGCGCAGGCGCTCGATGCCACCCATCGCGGTTACTACAAGGTCGGCGACATGACCCAGGGCCTGGGCTGGGAAGCCTACGACTGGCCGATCTCCCTGAAGCGCCTGCAGGCCGGCAACTCGACGCCGATGGCGCTGCAACCACACAGGATCGCCAGGCTGCCCGCGCCACAGGCGCTGGAGGGCCAGCGCCTGCTGAACAAGACCGGCTCCACCAACGGCTTCGGCGCCTACGTGGCGTTCGTCCCGGGCCGCGACCTGGGCCTGGTGATCCTGGCCAACCGCAACTATCCCAATGCCGAGCGGGTGAAGATCGC
59	gb|KP050494|+|0-861|ARO:3003156|SHV-189	ATGCGTTATTTTCGCCTGTGTATTATCTCCCTGTTAGCCACCCTGCCGCTGGCG...TAA	861.0	16	822	806	861	ATGCGTTATATTCGCCTGTGTATTATCACCCTGTGAGCCACCCTGCCGCTGGCGGTACACGCCAGCCCGCAGCCGCTTGAGCAAATTAAACAAAGCGAAAGCCAGCTGTCGGGCCGCGTAGGCATGATAGAAATGGATCTGGCCAGCGGCCGCACGCTGACCGCCTGGCGCGCCGATGAACGCTTTCCCATGATGAGCACCTTTAAAGTAGTGCTCTGCGGCGCAGTGCTGGCGCGGGTGGATGCCGGTGACGAACAGCTGGAGCGAAAGATCCACTATCGCCAGCAGGATCTGGTGGACTACTCGCCGGTCAGCGAAAAACACCTTGCCGACGGCATGACGGTCGGCGAACTCTGCGCCGCCGCCATTACCATGAGCGATAACAGCGCCGCCAATCTGCTGCTGGCCACCGTCGGCGGCCCCGCAGGATTGACTGCCTTTTTGCGCCAGATCGGCGACAACGTCACCCGCCTTGACCGCTGGGAAACGGAACTGAATGAGGCGCTTCCCGGCGACGCCCGCGACACCACTACCCCGGCCAGCATGGCCGCGACCCTGCGCAAGCTGCTGACCAGCCAGCGTCTGAGCGCCCGTTCGCAACGGCAGCTGCTGCAGTGGATGGTGGACGATCGGGTCGCCGGACCGTTGATCCGCTCCGTGCTGCCGGCGGGCTGGTTTATCGCCGATAAGACCGGAGCTAGCAAGCGGGGTGCGCGCGGGATTGTCGCCCTGCTTGGCCCGAATAACAAAGCAGAGCGCATTGTGGTGATTTATCTGCGGGATACGCCGGCGAGCATGGCCGAGCG
60	gb|GQ390808|+|0-813|ARO:3001173|SHV-126	ATGCGTTATATTCGCCTGTGTATTATCTCCCTGTTAGCCACCCTGCCGCTGGCG...CAG	813.0	16	774	758	813	ATGCGTTATATTCGCCTGTGTATTATCACCCTGTGAGCCACCCTGCCGCTGGCGGTACACGCCAGCCCGCAGCCGCTTGAGCAAATTAAACAAAGCGAAAGCCAGCTGTCGGGCCGCGTAGGCATGATAGAAATGGATCTGGCCAGCGGCCGCACGCTGACCGCCTGGCGCGCCGATGAACGCTTTCCCATGATGAGCACCTTTAAAGTAGTGCTCTGCGGCGCAGTGCTGGCGCGGGTGGATGCCGGTGACGAACAGCTGGAGCGAAAGATCCACTATCGCCAGCAGGATCTGGTGGACTACTCGCCGGTCAGCGAAAAACACCTTGCCGACGGCATGACGGTCGGCGAACTCTGCGCCGCCGCCATTACCATGAGCGATAACAGCGCCGCCAATCTGCTGCTGGCCACCGTCGGCGGCCCCGCAGGATTGACTGCCTTTTTGCGCCAGATCGGCGACAACGTCACCCGCCTTGACCGCTGGGAAACGGAACTGAATGAGGCGCTTCCCGGCGACGCCCGCGACACCACTACCCCGGCCAGCATGGCCGCGACCCTGCGCAAGCTGCTGACCAGCCAGCGTCTGAGCGCCCGTTCGCAACGGCAGCTGCTGCAGTGGATGGTGGACGATCGGGTCGCCGGACCGTTGATCCGCTCCGTGCTGCCGGCGGGCTGGTTTATCGCCGATAAGACCGGAGCTAGCAAGCGGGGTGCGCGCGGGATTGTCGCCCTGCTTGGCCCGAATAACAAAGCAGAGCG
61	gb|KP727574.1|+|0-822|ARO:3003596|OXA-440	ATGAATAAATATTTTACTTGCTATGTGGTTGCTTCTCTTTTTCTTTCTGGTTGT...TAA	822.0	80	847	767	822	ATGAATAAATATTTTACTTGCTATGTGGTTGCTTCTCTTTTTCTTTCTGGTTGTACGGTTCAGCATAATTTAATAAATGAAACCCCGAGTCAGATTGTTCAAGGACATAATCAGGTGATTCATCAATACTTTGATGAAAAAAACACCTCAGGTGTGCTGGTTATTCAAACAGATAAAAAAATTAATCTATATGGTAATGCTCTAAGCCGCGCAAATACAGAATATGTGCCAGCCTCTACATTTAAAATGTTGAATGCCCTGATCGGATTGGAGAACCAGAAAACGGATATTAATGAAATATTTAAATGGAAGGGCGAGAAAAGGTCATTTACCGCTTGGGAAAAAGACATGACACTAGGAGAAGCCATGAAGCTTTCTGCAGTCCCAGTCTATCAGGAACTTGCGCGACGTATCGGTCTTGATCTCATGCAAAAAGAAGTAAAACGTATTGGTTTCGGTAATGCTGAAATTGGACAGCAGGTTGATAATTTCTGGTTGGTAGGACCATTAAAGGTTACGCCTATTCAAGAGGTAGAGTTTGTTTCCCAATTAGCACATACACAGCTTCCATTTAGTGAAAAAGTGCAGGCTAATGTAAAAAATATGCTTCTTTTAGAAGAGAGTAATGGCTACAAAATTTTTGGAAAGACTGGTTGGGCAATGGATATAAAACCACAAGTGGGCTGGTTGACCGGCTGGGTTGAGCAGCCAGATGGAAAAATTGTCGCTTTTGCATTAAATATGGAAATGCGGTCAGAAATGCCGGC
62	gb|FJ854362|+|1702-2257|ARO:3002576|AAC(6')-Ib3	GTGACCAACAGCAACGATTCCGTCACACTGCGCCTCATGACTGAGCATGACCTT...TAA	555.0	77	577	500	555	GTGACCAACAGCAACGATTCCGTCACACTGCGCCTCATGACTGAGCATGACCTTGCGATGCTCTATGAGTGGCTAAATCGATCTCATATCGTCGAGTGGTGGGGCGGAGAAGAAGCACGCCCGACACTTGCTGACGTACAGGAACAGTACTTGCCAAGCGTTTTAGCGCAAGAGTCCGTCACTCCATACATTGCAATGCTGAATGGAGAGCCGATTGGGTATGCCCAGTCGTACGTTGCTCTTGGAAGCGGGGACGGATGGTGGGAAGAAGAAACCGATCCAGGAGTACGCGGAATAGACCAGTCACTGGCGAATGCATCACAACTGGGCAAAGGCTTGGGAACCAAGCTGGTTCGAGCTCTGGTTGAGTTGCTGTTCAATGATCCCGAGGTCACCAAGATCCAAACGGACCCGTCGCCGAGCAACTTGCGAGCGATCCGATGCTACGAGAAAGCGGGGTTTGAGAGGCAAGGTACCGTAACCACCCCAGATGGTCCAGC
63	gb|DQ174306|+|4-865|ARO:3001121|SHV-66	ATGCGTTATATTCGCCTGTGTATTATCTCCCTGTTAGCCACCCTGCCGCTGGCG...TAA	861.0	16	822	806	861	ATGCGTTATATTCGCCTGTGTATTATCACCCTGTGAGCCACCCTGCCGCTGGCGGTACACGCCAGCCCGCAGCCGCTTGAGCAAATTAAACAAAGCGAAAGCCAGCTGTCGGGCCGCGTAGGCATGATAGAAATGGATCTGGCCAGCGGCCGCACGCTGACCGCCTGGCGCGCCGATGAACGCTTTCCCATGATGAGCACCTTTAAAGTAGTGCTCTGCGGCGCAGTGCTGGCGCGGGTGGATGCCGGTGACGAACAGCTGGAGCGAAAGATCCACTATCGCCAGCAGGATCTGGTGGACTACTCGCCGGTCAGCGAAAAACACCTTGCCGACGGCATGACGGTCGGCGAACTCTGCGCCGCCGCCATTACCATGAGCGATAACAGCGCCGCCAATCTGCTGCTGGCCACCGTCGGCGGCCCCGCAGGATTGACTGCCTTTTTGCGCCAGATCGGCGACAACGTCACCCGCCTTGACCGCTGGGAAACGGAACTGAATGAGGCGCTTCCCGGCGACGCCCGCGACACCACTACCCCGGCCAGCATGGCCGCGACCCTGCGCAAGCTGCTGACCAGCCAGCGTCTGAGCGCCCGTTCGCAACGGCAGCTGCTGCAGTGGATGGTGGACGATCGGGTCGCCGGACCGTTGATCCGCTCCGTGCTGCCGGCGGGCTGGTTTATCGCCGATAAGACCGGAGCTAGCAAGCGGGGTGCGCGCGGGATTGTCGCCCTGCTTGGCCCGAATAACAAAGCAGAGCGCATTGTGGTGATTTATCTGCGGGATACGCCGGCGAGCATGGCCGAGCG
64	gb|AF445082|+|2788-3343|ARO:3002577|AAC(6')-Ib4	GTGACCAACAGCAACGATTCCGTCACACTGCGCCTCATGACTGAGCATGACCTT...TAA	555.0	77	577	500	555	GTGACCAACAGCAACGATTCCGTCACACTGCGCCTCATGACTGAGCATGACCTTGCGATGCTCTATGAGTGGCTAAATCGATCTCATATCGTCGAGTGGTGGGGCGGAGAAGAAGCACGCCCGACACTTGCTGACGTACAGGAACAGTACTTGCCAAGCGTTTTAGCGCAAGAGTCCGTCACTCCATACATTGCAATGCTGAATGGAGAGCCGATTGGGTATGCCCAGTCGTACGTTGCTCTTGGAAGCGGGGACGGATGGTGGGAAGAAGAAACCGATCCAGGAGTACGCGGAATAGACCAGTCACTGGCGAATGCATCACAACTGGGCAAAGGCTTGGGAACCAAGCTGGTTCGAGCTCTGGTTGAGTTGCTGTTCAATGATCCCGAGGTCACCAAGATCCAAACGGACCCGTCGCCGAGCAACTTGCGAGCGATCCGATGCTACGAGAAAGCGGGGTTTGAGAGGCAAGGTACCGTAACCACCCCAGATGGTCCAGC
65	gb|AF117743|+|0-780|ARO:3001077|SHV-19	CTGTTAGCCACCCTGCCGCTGGCGGTACACGCCAGCCCGCAGCCGCTTGAGCAA...AAT	780.0	51	771	720	780	AGCCACCCTGCCGCTGGCGGTACACGCCAGCCCGCAGCCGCTTGAGCAAATTAAACAAAGCGAAAGCCAGCTGTCGGGCCGCGTAGGCATGATAGAAATGGATCTGGCCAGCGGCCGCACGCTGACCGCCTGGCGCGCCGATGAACGCTTTCCCATGATGAGCACCTTTAAAGTAGTGCTCTGCGGCGCAGTGCTGGCGCGGGTGGATGCCGGTGACGAACAGCTGGAGCGAAAGATCCACTATCGCCAGCAGGATCTGGTGGACTACTCGCCGGTCAGCGAAAAACACCTTGCCGACGGCATGACGGTCGGCGAACTCTGCGCCGCCGCCATTACCATGAGCGATAACAGCGCCGCCAATCTGCTGCTGGCCACCGTCGGCGGCCCCGCAGGATTGACTGCCTTTTTGCGCCAGATCGGCGACAACGTCACCCGCCTTGACCGCTGGGAAACGGAACTGAATGAGGCGCTTCCCGGCGACGCCCGCGACACCACTACCCCGGCCAGCATGGCCGCGACCCTGCGCAAGCTGCTGACCAGCCAGCGTCTGAGCGCCCGTTCGCAACGGCAGCTGCTGCAGTGGATGGTGGACGATCGGGTCGCCGGACCGTTGATCCGCTCCGTGCTGCCGGCGGGCTGGTTTATCGCCGATAAGACCGGAGCTAGCAAGCGGGGTGCGCGCGGGATTGTCGCCCTGCTTGGCCCGAATAACAAAGCAGA
66	gb|GQ390809|+|0-813|ARO:3001174|SHV-127	ATGCGTTTTATTCGCCTGTGTATTATCTCCCTGTTAGCCACCCTGCCGCTGGCG...CAG	813.0	16	774	758	813	ATGCGTTATATTCGCCTGTGTATTATCACCCTGTGAGCCACCCTGCCGCTGGCGGTACACGCCAGCCCGCAGCCGCTTGAGCAAATTAAACAAAGCGAAAGCCAGCTGTCGGGCCGCGTAGGCATGATAGAAATGGATCTGGCCAGCGGCCGCACGCTGACCGCCTGGCGCGCCGATGAACGCTTTCCCATGATGAGCACCTTTAAAGTAGTGCTCTGCGGCGCAGTGCTGGCGCGGGTGGATGCCGGTGACGAACAGCTGGAGCGAAAGATCCACTATCGCCAGCAGGATCTGGTGGACTACTCGCCGGTCAGCGAAAAACACCTTGCCGACGGCATGACGGTCGGCGAACTCTGCGCCGCCGCCATTACCATGAGCGATAACAGCGCCGCCAATCTGCTGCTGGCCACCGTCGGCGGCCCCGCAGGATTGACTGCCTTTTTGCGCCAGATCGGCGACAACGTCACCCGCCTTGACCGCTGGGAAACGGAACTGAATGAGGCGCTTCCCGGCGACGCCCGCGACACCACTACCCCGGCCAGCATGGCCGCGACCCTGCGCAAGCTGCTGACCAGCCAGCGTCTGAGCGCCCGTTCGCAACGGCAGCTGCTGCAGTGGATGGTGGACGATCGGGTCGCCGGACCGTTGATCCGCTCCGTGCTGCCGGCGGGCTGGTTTATCGCCGATAAGACCGGAGCTAGCAAGCGGGGTGCGCGCGGGATTGTCGCCCTGCTTGGCCCGAATAACAAAGCAGAGCG
67	gb|JX865394.1|+|0-825|ARO:3003597|OXA-441	ATGAACATTAAAGCACTCTTACTTATAACAAGCGCTATTTTTATTTCAGCCTGC...TAG	825.0	54149	54919	770	825	ATGAACATTAAAGCACTCTTACTTATAACAAGCGCTATTTTTATTTCAGCCTGCTCACCTTATATAGTGACTGCTAATCCAAATCACAGCGCTTCAAAATCTGATGTAAAAGCAGAGAAAATTAAAAATTTATTTAACGAAGCACACACTACGGGTGTTTTAGTTATCCAACAAGGCCAAACTCAACAAAGCTATGGTAATGATCTTGCTCGTGCTTCGACCGAGTATGTACCTGCTTCGACCTTCAAAATGCTTAATGCTTTGATCGGCCTTGAGCACCATAAGGCAACCACCACAGAAGTATTTAAGTGGGATGGTAAAAAAAGGTTATTCCCAGAATGGGAAAAGGACATGACCCTAGGCGATGCCATGAAAGCTTCCGCTATTCCAGTTTATCAAGATTTAGCTCGTCGTATTGGACTTGAGCTCATGTCTAAGGAAGTGAAGCGTGTTGGTTATGGCAATGCAGATATCGGTACCCAAGTCGATAATTTTTGGCTGGTGGGTCCTTTAAAAATTACTCCTCAGCAAGAGGCACAGTTTGCTTACAAGCTAGCTAATAAAACGCTTCCATTTAGCCAAAAAGTCCAAGATGAAGTGCAATCCATGCTATTCATAGAAGAAAAGAATGGAAACAAAATATACGCAAAAAGTGGTTGGGGATGGGATGTAAACCCACAAGTAGGCTGGTTAACTGGATGGGTTGTTCAGCCTCAAGGGAATATTGTAGCGTTCTCCCTTAACTTAGAAATGAAAAAAGGAATACCTAG
68	gb|U59183|+|939-1740|ARO:3001408|OXA-13	ATGAAAACATTTGCCGCATATGTAATTACTGCGTGTCTTTCAAGTACGGCATTA...TAA	801.0	659	1405	746	801	ATGAAAACATTTGCCGCATATGTAATTATCGCGTGTCTTTCGAGTACGGCATTAGCTGGTTCAATTACAGAAAATACGTCTTGGAACAAAGAGTTCTCTGCCGAAGCCGTCAATGGTGTCTTCGTGCTTTGTAAAAGTAGCAGTAAATCCTGCGCTACCAATGACTTAGCTCGTGCATCAAAGGAATATCTTCCAGCATCAACATTTAAGATCCCCAACGCAATTATCGGCCTAGAAACTGGTGTCATAAAGAATGAGCATCAGGTTTTCAAATGGGACGGAAAGCCAAGAGCCATGAAGCAATGGGAAAGAGACTTGACCTTAAGAGGGGCAATACAAGTTTCAGCTGTTCCCGTATTTCAACAAATCGCCAGAGAAGTTGGCGAAGTAAGAATGCAGAAATACCTTAAAAAATTTTCCTATGGCAACCAGAATATCAGTGGTGGCATTGACAAATTCTGGTTGGAAGGCCAGCTTAGAATTTCCGCAGTTAATCAAGTGGAGTTTCTAGAGTCTCTATATTTAAATAAATTGTCAGCATCTAAAGAAAACCAGCTAATAGTAAAAGAGGCTTTGGTAACGGAGGCGGCACCTGAATATCTAGTGCATTCAAAAACTGGTTTTTCTGGTGTGGGAACTGAGTCAAATCCTGGTGTCGCATGGTGGGTTGGGTGGGTTGAGAAGGAGACAGAGGTTTACTTTTTCGCCTTTAACATGGATATAGACAACGAAAGTAAGTTGCCGCT
69	gb|DQ174307|+|4-865|ARO:3001122|SHV-67	ATGCGTTATATTCGCCTGTGTATTATCTCCCTGTTAGCCACCCTGCCGCTGGCG...TAA	861.0	16	822	806	861	ATGCGTTATATTCGCCTGTGTATTATCACCCTGTGAGCCACCCTGCCGCTGGCGGTACACGCCAGCCCGCAGCCGCTTGAGCAAATTAAACAAAGCGAAAGCCAGCTGTCGGGCCGCGTAGGCATGATAGAAATGGATCTGGCCAGCGGCCGCACGCTGACCGCCTGGCGCGCCGATGAACGCTTTCCCATGATGAGCACCTTTAAAGTAGTGCTCTGCGGCGCAGTGCTGGCGCGGGTGGATGCCGGTGACGAACAGCTGGAGCGAAAGATCCACTATCGCCAGCAGGATCTGGTGGACTACTCGCCGGTCAGCGAAAAACACCTTGCCGACGGCATGACGGTCGGCGAACTCTGCGCCGCCGCCATTACCATGAGCGATAACAGCGCCGCCAATCTGCTGCTGGCCACCGTCGGCGGCCCCGCAGGATTGACTGCCTTTTTGCGCCAGATCGGCGACAACGTCACCCGCCTTGACCGCTGGGAAACGGAACTGAATGAGGCGCTTCCCGGCGACGCCCGCGACACCACTACCCCGGCCAGCATGGCCGCGACCCTGCGCAAGCTGCTGACCAGCCAGCGTCTGAGCGCCCGTTCGCAACGGCAGCTGCTGCAGTGGATGGTGGACGATCGGGTCGCCGGACCGTTGATCCGCTCCGTGCTGCCGGCGGGCTGGTTTATCGCCGATAAGACCGGAGCTAGCAAGCGGGGTGCGCGCGGGATTGTCGCCCTGCTTGGCCCGAATAACAAAGCAGAGCGCATTGTGGTGATTTATCTGCGGGATACGCCGGCGAGCATGGCCGAGCG
70	gb|AF148851|+|5-866|ARO:3001060|SHV-2	ATGCGTTATATTCGCCTGTGTATTATCTCCCTGTTAGCCACCCTGCCGCTGGCG...TAA	861.0	16	822	806	861	ATGCGTTATATTCGCCTGTGTATTATCACCCTGTGAGCCACCCTGCCGCTGGCGGTACACGCCAGCCCGCAGCCGCTTGAGCAAATTAAACAAAGCGAAAGCCAGCTGTCGGGCCGCGTAGGCATGATAGAAATGGATCTGGCCAGCGGCCGCACGCTGACCGCCTGGCGCGCCGATGAACGCTTTCCCATGATGAGCACCTTTAAAGTAGTGCTCTGCGGCGCAGTGCTGGCGCGGGTGGATGCCGGTGACGAACAGCTGGAGCGAAAGATCCACTATCGCCAGCAGGATCTGGTGGACTACTCGCCGGTCAGCGAAAAACACCTTGCCGACGGCATGACGGTCGGCGAACTCTGCGCCGCCGCCATTACCATGAGCGATAACAGCGCCGCCAATCTGCTGCTGGCCACCGTCGGCGGCCCCGCAGGATTGACTGCCTTTTTGCGCCAGATCGGCGACAACGTCACCCGCCTTGACCGCTGGGAAACGGAACTGAATGAGGCGCTTCCCGGCGACGCCCGCGACACCACTACCCCGGCCAGCATGGCCGCGACCCTGCGCAAGCTGCTGACCAGCCAGCGTCTGAGCGCCCGTTCGCAACGGCAGCTGCTGCAGTGGATGGTGGACGATCGGGTCGCCGGACCGTTGATCCGCTCCGTGCTGCCGGCGGGCTGGTTTATCGCCGATAAGACCGGAGCTAGCAAGCGGGGTGCGCGCGGGATTGTCGCCCTGCTTGGCCCGAATAACAAAGCAGAGCGCATTGTGGTGATTTATCTGCGGGATACGCCGGCGAGCATGGCCGAGCG
71	gb|GU932590|+|0-861|ARO:3001175|SHV-128	ATGCGTTATATTCGCCTGTGTATTATCTCCCTGTTAGCCACCCTGCCGCTGGCG...TAA	861.0	16	822	806	861	ATGCGTTATATTCGCCTGTGTATTATCACCCTGTGAGCCACCCTGCCGCTGGCGGTACACGCCAGCCCGCAGCCGCTTGAGCAAATTAAACAAAGCGAAAGCCAGCTGTCGGGCCGCGTAGGCATGATAGAAATGGATCTGGCCAGCGGCCGCACGCTGACCGCCTGGCGCGCCGATGAACGCTTTCCCATGATGAGCACCTTTAAAGTAGTGCTCTGCGGCGCAGTGCTGGCGCGGGTGGATGCCGGTGACGAACAGCTGGAGCGAAAGATCCACTATCGCCAGCAGGATCTGGTGGACTACTCGCCGGTCAGCGAAAAACACCTTGCCGACGGCATGACGGTCGGCGAACTCTGCGCCGCCGCCATTACCATGAGCGATAACAGCGCCGCCAATCTGCTGCTGGCCACCGTCGGCGGCCCCGCAGGATTGACTGCCTTTTTGCGCCAGATCGGCGACAACGTCACCCGCCTTGACCGCTGGGAAACGGAACTGAATGAGGCGCTTCCCGGCGACGCCCGCGACACCACTACCCCGGCCAGCATGGCCGCGACCCTGCGCAAGCTGCTGACCAGCCAGCGTCTGAGCGCCCGTTCGCAACGGCAGCTGCTGCAGTGGATGGTGGACGATCGGGTCGCCGGACCGTTGATCCGCTCCGTGCTGCCGGCGGGCTGGTTTATCGCCGATAAGACCGGAGCTAGCAAGCGGGGTGCGCGCGGGATTGTCGCCCTGCTTGGCCCGAATAACAAAGCAGAGCGCATTGTGGTGATTTATCTGCGGGATACGCCGGCGAGCATGGCCGAGCG
72	gb|AF231133|+|1345-2146|ARO:3001423|OXA-28	ATGAAAACATTTGCCGCATATGTAATTACTGCGTGTCTTTCAAGTACGGCATTA...TAA	801.0	659	1405	746	801	ATGAAAACATTTGCCGCATATGTAATTATCGCGTGTCTTTCGAGTACGGCATTAGCTGGTTCAATTACAGAAAATACGTCTTGGAACAAAGAGTTCTCTGCCGAAGCCGTCAATGGTGTCTTCGTGCTTTGTAAAAGTAGCAGTAAATCCTGCGCTACCAATGACTTAGCTCGTGCATCAAAGGAATATCTTCCAGCATCAACATTTAAGATCCCCAACGCAATTATCGGCCTAGAAACTGGTGTCATAAAGAATGAGCATCAGGTTTTCAAATGGGACGGAAAGCCAAGAGCCATGAAGCAATGGGAAAGAGACTTGACCTTAAGAGGGGCAATACAAGTTTCAGCTGTTCCCGTATTTCAACAAATCGCCAGAGAAGTTGGCGAAGTAAGAATGCAGAAATACCTTAAAAAATTTTCCTATGGCAACCAGAATATCAGTGGTGGCATTGACAAATTCTGGTTGGAAGGCCAGCTTAGAATTTCCGCAGTTAATCAAGTGGAGTTTCTAGAGTCTCTATATTTAAATAAATTGTCAGCATCTAAAGAAAACCAGCTAATAGTAAAAGAGGCTTTGGTAACGGAGGCGGCACCTGAATATCTAGTGCATTCAAAAACTGGTTTTTCTGGTGTGGGAACTGAGTCAAATCCTGGTGTCGCATGGTGGGTTGGGTGGGTTGAGAAGGAGACAGAGGTTTACTTTTTCGCCTTTAACATGGATATAGACAACGAAAGTAAGTTGCCGCT
73	gb|KR091911.1|-|74564-75350|ARO:3002578|AAC(6')-Ib7	ATGCGCTCACGCAACTGGTCCAGAACCTTGACCGAACGCAGCGGTGGTAACGGC...TAA	786.0	8	577	569	786	AGCAGCAACGATGTTACGCAGCAGGGCAGTCGCCCTAAAACAAAGTTAGGCATCACAAAGTACAGCATCGTGACCAACAGCAACGATTCCGTCACACTGCGCCTCATGACTGAGCATGACCTTGCGATGCTCTATGAGTGGCTAAATCGATCTCATATCGTCGAGTGGTGGGGCGGAGAAGAAGCACGCCCGACACTTGCTGACGTACAGGAACAGTACTTGCCAAGCGTTTTAGCGCAAGAGTCCGTCACTCCATACATTGCAATGCTGAATGGAGAGCCGATTGGGTATGCCCAGTCGTACGTTGCTCTTGGAAGCGGGGACGGATGGTGGGAAGAAGAAACCGATCCAGGAGTACGCGGAATAGACCAGTCACTGGCGAATGCATCACAACTGGGCAAAGGCTTGGGAACCAAGCTGGTTCGAGCTCTGGTTGAGTTGCTGTTCAATGATCCCGAGGTCACCAAGATCCAAACGGACCCGTCGCCGAGCAACTTGCGAGCGATCCGATGCTACGAGAAAGCGGGGTTTGAGAGGCAAGGTACCGTAACCACCCCAGATGGTCCAGC
74	gb|FJ666067|+|0-1194|ARO:3002501|PDC-4	ATGCGCGATACCAGATTCCCCTGCCTGTGCGGCATCGCCGCTTCCACACTGCTG...TGA	1194.0	35513	36652	1139	1194	ATGCGCGATACCAGATTCCCCTGCCTGTGCGGCATCGCCGCTTCCACACTGCTGTTCGCCACCACCCCGGCCATTGCCGATGAGGCCCCGGCGGATCGCCTGAAGGCACTGGTCGACGCCGCCGTACAACCGGTGATGAAGGCCAATGACATTCCGGGCCTGGCCGTAGCCATCAGCCTGAAAGGAGAACCGCATTACTTCAGCTATGGGCTGGCCTCGAAAGAGGACGGCCGCCGGGTGACGCCGGAGACCCTGTTCGAGATCGGCTCGGTGAGCAAGACCTTCACCGTCACCCTCGCCGGCTATGCCCTGGCCCAGGACAAGATGCGCCTCGACGACCGCGCCAGCCAGCACTGGCCGGCACTGCAGGGCAGCCGCTTCGACGGCATCAGCCTGCTCGACCTCGCGACCTATACCGCCGGCGGCTTGCCGCTGCAGTTCCCCGACTCGGTGCAGAAGGACCAGGCACAGATCCGCGACTACTACCGCCAGTGGCAGCCGACCTACGCGCCGGGCAGCCAGCGCCTCTATTCCAACCCGAGCATCGGCCTGTTCGGCTATCTCGCCGCGCGCAGCCTGGGCCAGCCGTTCGAACGGCTCATGGAGCAGCAATTGTTCCCGGCACTGGGCCTCGAACAGACCCACCTCGACGTGCCCGAGGCGGCGCTGGCGCAGTACGCCCAGGGCTACGGCAAGGACGACCGCCCGCTACGGGTCGGTCCCGGCCCGCTGGATGCCGAAGGCTACGGGGTGAAGACCAGCGCGGCCGACCTGCTGCGCTTCGTCGATGCCAACCTGCATCCGGAGCGCCTGGACAGGCCCTGGGCGCAGGCGCTCGATGCCACCCATCGCGGTTACTACAAGGTCGGCGACATGACCCAGGGCCTGGGCTGGGAAGCCTACGACTGGCCGATCTCCCTGAAGCGCCTGCAGGCCGGCAACTCGACGCCGATGGCGCTGCAACCACACAGGATCGCCAGGCTGCCCGCGCCACAGGCGCTGGAGGGCCAGCGCCTGCTGAACAAGACCGGCTCCACCAACGGCTTCGGCGCCTACGTGGCGTTCGTCCCGGGCCGCGACCTGGGCCTGGTGATCCTGGCCAACCGCAACTATCCCAATGCCGAGCGGGTGAAGATCGC
75	gb|KP844571.1|+|0-825|ARO:3003598|OXA-442	ATGAACATTAAAGCACTCTTACTTATAACAAGCGCTATTTTTATTTCAGCCTGC...TAG	825.0	54149	54919	770	825	ATGAACATTAAAGCACTCTTACTTATAACAAGCGCTATTTTTATTTCAGCCTGCTCACCTTATATAGTGACTGCTAATCCAAATCACAGCGCTTCAAAATCTGATGTAAAAGCAGAGAAAATTAAAAATTTATTTAACGAAGCACACACTACGGGTGTTTTAGTTATCCAACAAGGCCAAACTCAACAAAGCTATGGTAATGATCTTGCTCGTGCTTCGACCGAGTATGTACCTGCTTCGACCTTCAAAATGCTTAATGCTTTGATCGGCCTTGAGCACCATAAGGCAACCACCACAGAAGTATTTAAGTGGGATGGTAAAAAAAGGTTATTCCCAGAATGGGAAAAGGACATGACCCTAGGCGATGCCATGAAAGCTTCCGCTATTCCAGTTTATCAAGATTTAGCTCGTCGTATTGGACTTGAGCTCATGTCTAAGGAAGTGAAGCGTGTTGGTTATGGCAATGCAGATATCGGTACCCAAGTCGATAATTTTTGGCTGGTGGGTCCTTTAAAAATTACTCCTCAGCAAGAGGCACAGTTTGCTTACAAGCTAGCTAATAAAACGCTTCCATTTAGCCAAAAAGTCCAAGATGAAGTGCAATCCATGCTATTCATAGAAGAAAAGAATGGAAACAAAATATACGCAAAAAGTGGTTGGGGATGGGATGTAAACCCACAAGTAGGCTGGTTAACTGGATGGGTTGTTCAGCCTCAAGGGAATATTGTAGCGTTCTCCCTTAACTTAGAAATGAAAAAAGGAATACCTAG
76	gb|AF043381|+|251-863|ARO:3002580|AAC(6')-Ib9	ATGTTACGCAGCAGCAGTCGCCCTAAAACAAAGTTAGGCATCACAAAGTACAGC...TAA	612.0	18	577	559	612	ATGTTACGCAGCAGGGCAGTCGCCCTAAAACAAAGTTAGGCATCACAAAGTACAGCATCGTGACCAACAGCAACGATTCCGTCACACTGCGCCTCATGACTGAGCATGACCTTGCGATGCTCTATGAGTGGCTAAATCGATCTCATATCGTCGAGTGGTGGGGCGGAGAAGAAGCACGCCCGACACTTGCTGACGTACAGGAACAGTACTTGCCAAGCGTTTTAGCGCAAGAGTCCGTCACTCCATACATTGCAATGCTGAATGGAGAGCCGATTGGGTATGCCCAGTCGTACGTTGCTCTTGGAAGCGGGGACGGATGGTGGGAAGAAGAAACCGATCCAGGAGTACGCGGAATAGACCAGTCACTGGCGAATGCATCACAACTGGGCAAAGGCTTGGGAACCAAGCTGGTTCGAGCTCTGGTTGAGTTGCTGTTCAATGATCCCGAGGTCACCAAGATCCAAACGGACCCGTCGCCGAGCAACTTGCGAGCGATCCGATGCTACGAGAAAGCGGGGTTTGAGAGGCAAGGTACCGTAACCACCCCAGATGGTCCAGC
77	gb|EU547445|+|0-825|ARO:3001651|OXA-130	ATGAACATTAAAGCACTCTTACTTATAACAAGCGCTATTTTTATTTCAGCCTGC...TAG	825.0	54149	54919	770	825	ATGAACATTAAAGCACTCTTACTTATAACAAGCGCTATTTTTATTTCAGCCTGCTCACCTTATATAGTGACTGCTAATCCAAATCACAGCGCTTCAAAATCTGATGTAAAAGCAGAGAAAATTAAAAATTTATTTAACGAAGCACACACTACGGGTGTTTTAGTTATCCAACAAGGCCAAACTCAACAAAGCTATGGTAATGATCTTGCTCGTGCTTCGACCGAGTATGTACCTGCTTCGACCTTCAAAATGCTTAATGCTTTGATCGGCCTTGAGCACCATAAGGCAACCACCACAGAAGTATTTAAGTGGGATGGTAAAAAAAGGTTATTCCCAGAATGGGAAAAGGACATGACCCTAGGCGATGCCATGAAAGCTTCCGCTATTCCAGTTTATCAAGATTTAGCTCGTCGTATTGGACTTGAGCTCATGTCTAAGGAAGTGAAGCGTGTTGGTTATGGCAATGCAGATATCGGTACCCAAGTCGATAATTTTTGGCTGGTGGGTCCTTTAAAAATTACTCCTCAGCAAGAGGCACAGTTTGCTTACAAGCTAGCTAATAAAACGCTTCCATTTAGCCAAAAAGTCCAAGATGAAGTGCAATCCATGCTATTCATAGAAGAAAAGAATGGAAACAAAATATACGCAAAAAGTGGTTGGGGATGGGATGTAAACCCACAAGTAGGCTGGTTAACTGGATGGGTTGTTCAGCCTCAAGGGAATATTGTAGCGTTCTCCCTTAACTTAGAAATGAAAAAAGGAATACCTAG
78	gb|AY660529.1|+|121-676|ARO:3003676|AAC(6')-Ib'	GTGACCAACAGCAACGATTCCGTCACACTGCGCCTCATGACTGAGCATGACCTT...TAA	555.0	77	577	500	555	GTGACCAACAGCAACGATTCCGTCACACTGCGCCTCATGACTGAGCATGACCTTGCGATGCTCTATGAGTGGCTAAATCGATCTCATATCGTCGAGTGGTGGGGCGGAGAAGAAGCACGCCCGACACTTGCTGACGTACAGGAACAGTACTTGCCAAGCGTTTTAGCGCAAGAGTCCGTCACTCCATACATTGCAATGCTGAATGGAGAGCCGATTGGGTATGCCCAGTCGTACGTTGCTCTTGGAAGCGGGGACGGATGGTGGGAAGAAGAAACCGATCCAGGAGTACGCGGAATAGACCAGTCACTGGCGAATGCATCACAACTGGGCAAAGGCTTGGGAACCAAGCTGGTTCGAGCTCTGGTTGAGTTGCTGTTCAATGATCCCGAGGTCACCAAGATCCAAACGGACCCGTCGCCGAGCAACTTGCGAGCGATCCGATGCTACGAGAAAGCGGGGTTTGAGAGGCAAGGTACCGTAACCACCCCAGATGGTCCAGC
79	gb|Z54241.1|+|529-1051|ARO:3002559|AAC(6')-Ip	ATGCTTAAGAAAAGCTTTCTTGATGCTGGAAATGAATCATGGGGAGATATTAAA...TGA	522.0	162	630	468	522	ATGCTTAAGAAAAGCTTTCTTGATGCTGGAAATGAATCATGGGGAGATATTAAAAATGCTATTGAAGAAGTTGAAGAATGTATAGAACATCCAAATATATGCTTGGGAATATGTCTGGATGATAAACTGATTGGATGGACCGGATTAAGGCCGATGTACGATAAGACCTGGGAACTTCATCCCATGGTTATAAAAACTGAATATCAAGGCAAGGGTTTTGGGAAAGTACTACTAAGAGAACTAGAGACGAGAGCGAAGAGTAGGGGAATTATCGGAATAGCTCTTGGAACTGATGACGAATATCAGAAAACTAGTTTGTCTATGATTGATATAAACGAACGAAATATCTTCGATGAAATCGGGAATATAAAGAACGTTAATAATCATCCATATGAGTTTTATAAGAAATGTGGTTATATGATCGTTGGAATAATCCCTAATGCTAATGGAAAAAGAAAACCAGATATA
80	gb|LC037981|+|0-801|ARO:3003610|OXA-454	ATGAAAACATTTGCCGCATATGTAATTATCGCGTGTCTTTCGAGTACGGCATTA...TAA	801.0	659	1405	746	801	ATGAAAACATTTGCCGCATATGTAATTATCGCGTGTCTTTCGAGTACGGCATTAGCTGGTTCAATTACAGAAAATACGTCTTGGAACAAAGAGTTCTCTGCCGAAGCCGTCAATGGTGTCTTCGTGCTTTGTAAAAGTAGCAGTAAATCCTGCGCTACCAATGACTTAGCTCGTGCATCAAAGGAATATCTTCCAGCATCAACATTTAAGATCCCCAACGCAATTATCGGCCTAGAAACTGGTGTCATAAAGAATGAGCATCAGGTTTTCAAATGGGACGGAAAGCCAAGAGCCATGAAGCAATGGGAAAGAGACTTGACCTTAAGAGGGGCAATACAAGTTTCAGCTGTTCCCGTATTTCAACAAATCGCCAGAGAAGTTGGCGAAGTAAGAATGCAGAAATACCTTAAAAAATTTTCCTATGGCAACCAGAATATCAGTGGTGGCATTGACAAATTCTGGTTGGAAGGCCAGCTTAGAATTTCCGCAGTTAATCAAGTGGAGTTTCTAGAGTCTCTATATTTAAATAAATTGTCAGCATCTAAAGAAAACCAGCTAATAGTAAAAGAGGCTTTGGTAACGGAGGCGGCACCTGAATATCTAGTGCATTCAAAAACTGGTTTTTCTGGTGTGGGAACTGAGTCAAATCCTGGTGTCGCATGGTGGGTTGGGTGGGTTGAGAAGGAGACAGAGGTTTACTTTTTCGCCTTTAACATGGATATAGACAACGAAAGTAAGTTGCCGCT
81	gb|DQ174308|+|4-865|ARO:3001123|SHV-69	ATGCGTTATATTCGCCTGTGTATTATCTCCCTGTTAGCCACCCTGCCGCTGGCG...TAA	861.0	16	822	806	861	ATGCGTTATATTCGCCTGTGTATTATCACCCTGTGAGCCACCCTGCCGCTGGCGGTACACGCCAGCCCGCAGCCGCTTGAGCAAATTAAACAAAGCGAAAGCCAGCTGTCGGGCCGCGTAGGCATGATAGAAATGGATCTGGCCAGCGGCCGCACGCTGACCGCCTGGCGCGCCGATGAACGCTTTCCCATGATGAGCACCTTTAAAGTAGTGCTCTGCGGCGCAGTGCTGGCGCGGGTGGATGCCGGTGACGAACAGCTGGAGCGAAAGATCCACTATCGCCAGCAGGATCTGGTGGACTACTCGCCGGTCAGCGAAAAACACCTTGCCGACGGCATGACGGTCGGCGAACTCTGCGCCGCCGCCATTACCATGAGCGATAACAGCGCCGCCAATCTGCTGCTGGCCACCGTCGGCGGCCCCGCAGGATTGACTGCCTTTTTGCGCCAGATCGGCGACAACGTCACCCGCCTTGACCGCTGGGAAACGGAACTGAATGAGGCGCTTCCCGGCGACGCCCGCGACACCACTACCCCGGCCAGCATGGCCGCGACCCTGCGCAAGCTGCTGACCAGCCAGCGTCTGAGCGCCCGTTCGCAACGGCAGCTGCTGCAGTGGATGGTGGACGATCGGGTCGCCGGACCGTTGATCCGCTCCGTGCTGCCGGCGGGCTGGTTTATCGCCGATAAGACCGGAGCTAGCAAGCGGGGTGCGCGCGGGATTGTCGCCCTGCTTGGCCCGAATAACAAAGCAGAGCGCATTGTGGTGATTTATCTGCGGGATACGCCGGCGAGCATGGCCGAGCG
82	gb|GU827715|+|0-861|ARO:3001176|SHV-129	ATGCGTTATATTCGCCTGTGTATTATCTCCCTGTTAGCCACCCTGCCGCTGGCG...TAA	861.0	16	822	806	861	ATGCGTTATATTCGCCTGTGTATTATCACCCTGTGAGCCACCCTGCCGCTGGCGGTACACGCCAGCCCGCAGCCGCTTGAGCAAATTAAACAAAGCGAAAGCCAGCTGTCGGGCCGCGTAGGCATGATAGAAATGGATCTGGCCAGCGGCCGCACGCTGACCGCCTGGCGCGCCGATGAACGCTTTCCCATGATGAGCACCTTTAAAGTAGTGCTCTGCGGCGCAGTGCTGGCGCGGGTGGATGCCGGTGACGAACAGCTGGAGCGAAAGATCCACTATCGCCAGCAGGATCTGGTGGACTACTCGCCGGTCAGCGAAAAACACCTTGCCGACGGCATGACGGTCGGCGAACTCTGCGCCGCCGCCATTACCATGAGCGATAACAGCGCCGCCAATCTGCTGCTGGCCACCGTCGGCGGCCCCGCAGGATTGACTGCCTTTTTGCGCCAGATCGGCGACAACGTCACCCGCCTTGACCGCTGGGAAACGGAACTGAATGAGGCGCTTCCCGGCGACGCCCGCGACACCACTACCCCGGCCAGCATGGCCGCGACCCTGCGCAAGCTGCTGACCAGCCAGCGTCTGAGCGCCCGTTCGCAACGGCAGCTGCTGCAGTGGATGGTGGACGATCGGGTCGCCGGACCGTTGATCCGCTCCGTGCTGCCGGCGGGCTGGTTTATCGCCGATAAGACCGGAGCTAGCAAGCGGGGTGCGCGCGGGATTGTCGCCCTGCTTGGCCCGAATAACAAAGCAGAGCGCATTGTGGTGATTTATCTGCGGGATACGCCGGCGAGCATGGCCGAGCG
83	gb|APPZ01000001.1|+|7525-8353|ARO:3001735|OXA-280	ATGAAAACTTTACAGTTGGGCCTCATCGTCCTCATTACTACCTTCGGTTCTGCA...TAA	828.0	156	929	773	828	ATGAAAACTTTACAGTTGGGCCTCATCGTCCTCATTACTACCTTCGGTTCTGCATGTACCATAATAAGAAGCCCCTCCATAGAAACAGCTAAAAACCATGAGCAACAAAGTGCGCAGCAGCAGATCCAACAGGCCTTCGATCAACTCCAAACCACGGGGGTGATTGTCATAAAGGATAAGCATGGCTTACACAGCTACGGCAATGACTTGAGCCGTGCTCAGACACCCTATGTACCCGCCTCTACCTTTAAAATGCTGAATGCCTTAATCGGACTAGAACATGGTAAAGCAACCAGCACCGAGGTGTTTAAATGGGATGGTCAAAAGAACAGCTTCCCTGCTTGGGAAAAAGACATGACTTTAGGGCAAGCCATGCAAGCATCTGCCGTTCCTGTTTATCAGGAGCTAGCACGGCGCATTGGCCTAGATCTAATGCAAAAAGAAGTACAGCGCATTGGATATGGCAATCAACAGATTGGCACCGTTGTCGATAATTTTTGGTTAGTCGGTCCACTGCAAATTACGCCTGTTCAAGAAGTCCTTTTTGTAGAGAAGCTGGCCAATACGCAACTCGCTTTTAAGCCAGATGTGCAACATACCGTACAAGACATGCTGCTGATTGAACAAAAACCGAATTATAAACTCTACGCCAAATCTGGTTGGGGCATGGACCTAGAACCGCAAGTGGGCTGGTGGACAGGCTGGGTCGAAACAGCAACAGGTGAAAAAGTGTATTTTGCTTTGAATATGCATATGAAAACAGGAATTTCAGC
84	gb|KR872296.1|+|0-825|ARO:3003637|OXA-480	ATGAACATTAAAGCACTCTTATTTATAACAAGCGCTATTTTTATTTCAGCCTGC...TAG	825.0	54149	54919	770	825	ATGAACATTAAAGCACTCTTACTTATAACAAGCGCTATTTTTATTTCAGCCTGCTCACCTTATATAGTGACTGCTAATCCAAATCACAGCGCTTCAAAATCTGATGTAAAAGCAGAGAAAATTAAAAATTTATTTAACGAAGCACACACTACGGGTGTTTTAGTTATCCAACAAGGCCAAACTCAACAAAGCTATGGTAATGATCTTGCTCGTGCTTCGACCGAGTATGTACCTGCTTCGACCTTCAAAATGCTTAATGCTTTGATCGGCCTTGAGCACCATAAGGCAACCACCACAGAAGTATTTAAGTGGGATGGTAAAAAAAGGTTATTCCCAGAATGGGAAAAGGACATGACCCTAGGCGATGCCATGAAAGCTTCCGCTATTCCAGTTTATCAAGATTTAGCTCGTCGTATTGGACTTGAGCTCATGTCTAAGGAAGTGAAGCGTGTTGGTTATGGCAATGCAGATATCGGTACCCAAGTCGATAATTTTTGGCTGGTGGGTCCTTTAAAAATTACTCCTCAGCAAGAGGCACAGTTTGCTTACAAGCTAGCTAATAAAACGCTTCCATTTAGCCAAAAAGTCCAAGATGAAGTGCAATCCATGCTATTCATAGAAGAAAAGAATGGAAACAAAATATACGCAAAAAGTGGTTGGGGATGGGATGTAAACCCACAAGTAGGCTGGTTAACTGGATGGGTTGTTCAGCCTCAAGGGAATATTGTAGCGTTCTCCCTTAACTTAGAAATGAAAAAAGGAATACCTAG
85	gb|EU547446|+|0-825|ARO:3001652|OXA-131	ATGAACATTAAAGCACTCTTACTTATAACAAGCGCTATTTTTATTTCAGCCTGC...TAG	825.0	54149	54919	770	825	ATGAACATTAAAGCACTCTTACTTATAACAAGCGCTATTTTTATTTCAGCCTGCTCACCTTATATAGTGACTGCTAATCCAAATCACAGCGCTTCAAAATCTGATGTAAAAGCAGAGAAAATTAAAAATTTATTTAACGAAGCACACACTACGGGTGTTTTAGTTATCCAACAAGGCCAAACTCAACAAAGCTATGGTAATGATCTTGCTCGTGCTTCGACCGAGTATGTACCTGCTTCGACCTTCAAAATGCTTAATGCTTTGATCGGCCTTGAGCACCATAAGGCAACCACCACAGAAGTATTTAAGTGGGATGGTAAAAAAAGGTTATTCCCAGAATGGGAAAAGGACATGACCCTAGGCGATGCCATGAAAGCTTCCGCTATTCCAGTTTATCAAGATTTAGCTCGTCGTATTGGACTTGAGCTCATGTCTAAGGAAGTGAAGCGTGTTGGTTATGGCAATGCAGATATCGGTACCCAAGTCGATAATTTTTGGCTGGTGGGTCCTTTAAAAATTACTCCTCAGCAAGAGGCACAGTTTGCTTACAAGCTAGCTAATAAAACGCTTCCATTTAGCCAAAAAGTCCAAGATGAAGTGCAATCCATGCTATTCATAGAAGAAAAGAATGGAAACAAAATATACGCAAAAAGTGGTTGGGGATGGGATGTAAACCCACAAGTAGGCTGGTTAACTGGATGGGTTGTTCAGCCTCAAGGGAATATTGTAGCGTTCTCCCTTAACTTAGAAATGAAAAAAGGAATACCTAG
86	gb|AF144880|+|3541-3979|ARO:3002569|AAC(6')-Iy	ATGGACATCAGGCAAATGAACAAAACCCATCTGGAGCACTGGCGCGGATTGCGA...TGA	438.0	0	254	254	438	GCATCATTTATTGCGATGGCAGACGGGGTGGCGATTGGCTTTGCGGATGCCTCAATCCGCCACGATTATGTCAATGGCTGTGACAGTTCGCCCGTGGTTTTCCTTGAAGGTATTTTTGTTCTCCCCTCGTTCCGTCAACGCGGCTTAGCGAAACAATTGATTGCAGCAGTGCAACGATGGGGAACGAATAAAGGGTGTCGGGAAATGGCTTCCGATACCTCGCCGGAAAATACAATTTCACAGAAAGTTCACCT
87	gb|AF117744|+|0-780|ARO:3001078|SHV-20	CTGTTAGCCACCCTGCCGCTGGCGGTACACGCCAGCCCGCAGCCGCTTGAGCAA...AAT	780.0	51	771	720	780	AGCCACCCTGCCGCTGGCGGTACACGCCAGCCCGCAGCCGCTTGAGCAAATTAAACAAAGCGAAAGCCAGCTGTCGGGCCGCGTAGGCATGATAGAAATGGATCTGGCCAGCGGCCGCACGCTGACCGCCTGGCGCGCCGATGAACGCTTTCCCATGATGAGCACCTTTAAAGTAGTGCTCTGCGGCGCAGTGCTGGCGCGGGTGGATGCCGGTGACGAACAGCTGGAGCGAAAGATCCACTATCGCCAGCAGGATCTGGTGGACTACTCGCCGGTCAGCGAAAAACACCTTGCCGACGGCATGACGGTCGGCGAACTCTGCGCCGCCGCCATTACCATGAGCGATAACAGCGCCGCCAATCTGCTGCTGGCCACCGTCGGCGGCCCCGCAGGATTGACTGCCTTTTTGCGCCAGATCGGCGACAACGTCACCCGCCTTGACCGCTGGGAAACGGAACTGAATGAGGCGCTTCCCGGCGACGCCCGCGACACCACTACCCCGGCCAGCATGGCCGCGACCCTGCGCAAGCTGCTGACCAGCCAGCGTCTGAGCGCCCGTTCGCAACGGCAGCTGCTGCAGTGGATGGTGGACGATCGGGTCGCCGGACCGTTGATCCGCTCCGTGCTGCCGGCGGGCTGGTTTATCGCCGATAAGACCGGAGCTAGCAAGCGGGGTGCGCGCGGGATTGTCGCCCTGCTTGGCCCGAATAACAAAGCAGA
88	gb|AF164577|+|0-861|ARO:3001072|SHV-13	ATGCGTTATATTCGCCTGTGTATTATCTCCCTGTTAGCCACCCTGCCGCTGGCG...TAA	861.0	16	822	806	861	ATGCGTTATATTCGCCTGTGTATTATCACCCTGTGAGCCACCCTGCCGCTGGCGGTACACGCCAGCCCGCAGCCGCTTGAGCAAATTAAACAAAGCGAAAGCCAGCTGTCGGGCCGCGTAGGCATGATAGAAATGGATCTGGCCAGCGGCCGCACGCTGACCGCCTGGCGCGCCGATGAACGCTTTCCCATGATGAGCACCTTTAAAGTAGTGCTCTGCGGCGCAGTGCTGGCGCGGGTGGATGCCGGTGACGAACAGCTGGAGCGAAAGATCCACTATCGCCAGCAGGATCTGGTGGACTACTCGCCGGTCAGCGAAAAACACCTTGCCGACGGCATGACGGTCGGCGAACTCTGCGCCGCCGCCATTACCATGAGCGATAACAGCGCCGCCAATCTGCTGCTGGCCACCGTCGGCGGCCCCGCAGGATTGACTGCCTTTTTGCGCCAGATCGGCGACAACGTCACCCGCCTTGACCGCTGGGAAACGGAACTGAATGAGGCGCTTCCCGGCGACGCCCGCGACACCACTACCCCGGCCAGCATGGCCGCGACCCTGCGCAAGCTGCTGACCAGCCAGCGTCTGAGCGCCCGTTCGCAACGGCAGCTGCTGCAGTGGATGGTGGACGATCGGGTCGCCGGACCGTTGATCCGCTCCGTGCTGCCGGCGGGCTGGTTTATCGCCGATAAGACCGGAGCTAGCAAGCGGGGTGCGCGCGGGATTGTCGCCCTGCTTGGCCCGAATAACAAAGCAGAGCGCATTGTGGTGATTTATCTGCGGGATACGCCGGCGAGCATGGCCGAGCG
89	gb|KP264124.1|+|76-898|ARO:3003639|OXA-482	ATGAATAAATATTTTACTTGCTATGTGGTTGCTTCTCTTTTTCTTTCTGGTTGT...TAA	822.0	80	847	767	822	ATGAATAAATATTTTACTTGCTATGTGGTTGCTTCTCTTTTTCTTTCTGGTTGTACGGTTCAGCATAATTTAATAAATGAAACCCCGAGTCAGATTGTTCAAGGACATAATCAGGTGATTCATCAATACTTTGATGAAAAAAACACCTCAGGTGTGCTGGTTATTCAAACAGATAAAAAAATTAATCTATATGGTAATGCTCTAAGCCGCGCAAATACAGAATATGTGCCAGCCTCTACATTTAAAATGTTGAATGCCCTGATCGGATTGGAGAACCAGAAAACGGATATTAATGAAATATTTAAATGGAAGGGCGAGAAAAGGTCATTTACCGCTTGGGAAAAAGACATGACACTAGGAGAAGCCATGAAGCTTTCTGCAGTCCCAGTCTATCAGGAACTTGCGCGACGTATCGGTCTTGATCTCATGCAAAAAGAAGTAAAACGTATTGGTTTCGGTAATGCTGAAATTGGACAGCAGGTTGATAATTTCTGGTTGGTAGGACCATTAAAGGTTACGCCTATTCAAGAGGTAGAGTTTGTTTCCCAATTAGCACATACACAGCTTCCATTTAGTGAAAAAGTGCAGGCTAATGTAAAAAATATGCTTCTTTTAGAAGAGAGTAATGGCTACAAAATTTTTGGAAAGACTGGTTGGGCAATGGATATAAAACCACAAGTGGGCTGGTTGACCGGCTGGGTTGAGCAGCCAGATGGAAAAATTGTCGCTTTTGCATTAAATATGGAAATGCGGTCAGAAATGCCGGC
90	gb|EU547447|+|0-825|ARO:3001653|OXA-132	ATGAACATTAAAACACTCTTACTTATAACAAGCGCTATTTTTATTTCAGCCTGC...TAG	825.0	54149	54919	770	825	ATGAACATTAAAGCACTCTTACTTATAACAAGCGCTATTTTTATTTCAGCCTGCTCACCTTATATAGTGACTGCTAATCCAAATCACAGCGCTTCAAAATCTGATGTAAAAGCAGAGAAAATTAAAAATTTATTTAACGAAGCACACACTACGGGTGTTTTAGTTATCCAACAAGGCCAAACTCAACAAAGCTATGGTAATGATCTTGCTCGTGCTTCGACCGAGTATGTACCTGCTTCGACCTTCAAAATGCTTAATGCTTTGATCGGCCTTGAGCACCATAAGGCAACCACCACAGAAGTATTTAAGTGGGATGGTAAAAAAAGGTTATTCCCAGAATGGGAAAAGGACATGACCCTAGGCGATGCCATGAAAGCTTCCGCTATTCCAGTTTATCAAGATTTAGCTCGTCGTATTGGACTTGAGCTCATGTCTAAGGAAGTGAAGCGTGTTGGTTATGGCAATGCAGATATCGGTACCCAAGTCGATAATTTTTGGCTGGTGGGTCCTTTAAAAATTACTCCTCAGCAAGAGGCACAGTTTGCTTACAAGCTAGCTAATAAAACGCTTCCATTTAGCCAAAAAGTCCAAGATGAAGTGCAATCCATGCTATTCATAGAAGAAAAGAATGGAAACAAAATATACGCAAAAAGTGGTTGGGGATGGGATGTAAACCCACAAGTAGGCTGGTTAACTGGATGGGTTGTTCAGCCTCAAGGGAATATTGTAGCGTTCTCCCTTAACTTAGAAATGAAAAAAGGAATACCTAG
91	gb|U20270|+|124-985|ARO:3001066|SHV-7	ATGCGTTATTTTCGCCTGTGTATTATCTCCCTGTTAGCCACCCTGCCGCTGGCG...TAA	861.0	16	822	806	861	ATGCGTTATATTCGCCTGTGTATTATCACCCTGTGAGCCACCCTGCCGCTGGCGGTACACGCCAGCCCGCAGCCGCTTGAGCAAATTAAACAAAGCGAAAGCCAGCTGTCGGGCCGCGTAGGCATGATAGAAATGGATCTGGCCAGCGGCCGCACGCTGACCGCCTGGCGCGCCGATGAACGCTTTCCCATGATGAGCACCTTTAAAGTAGTGCTCTGCGGCGCAGTGCTGGCGCGGGTGGATGCCGGTGACGAACAGCTGGAGCGAAAGATCCACTATCGCCAGCAGGATCTGGTGGACTACTCGCCGGTCAGCGAAAAACACCTTGCCGACGGCATGACGGTCGGCGAACTCTGCGCCGCCGCCATTACCATGAGCGATAACAGCGCCGCCAATCTGCTGCTGGCCACCGTCGGCGGCCCCGCAGGATTGACTGCCTTTTTGCGCCAGATCGGCGACAACGTCACCCGCCTTGACCGCTGGGAAACGGAACTGAATGAGGCGCTTCCCGGCGACGCCCGCGACACCACTACCCCGGCCAGCATGGCCGCGACCCTGCGCAAGCTGCTGACCAGCCAGCGTCTGAGCGCCCGTTCGCAACGGCAGCTGCTGCAGTGGATGGTGGACGATCGGGTCGCCGGACCGTTGATCCGCTCCGTGCTGCCGGCGGGCTGGTTTATCGCCGATAAGACCGGAGCTAGCAAGCGGGGTGCGCGCGGGATTGTCGCCCTGCTTGGCCCGAATAACAAAGCAGAGCGCATTGTGGTGATTTATCTGCGGGATACGCCGGCGAGCATGGCCGAGCG
92	gb|AB551737|+|14-875|ARO:3001177|SHV-133	ATGCGTTATATTCGCCTGTGTATTATCTCCCTGTTAGCCACCCTGCCGCTGGCG...TAA	861.0	16	822	806	861	ATGCGTTATATTCGCCTGTGTATTATCACCCTGTGAGCCACCCTGCCGCTGGCGGTACACGCCAGCCCGCAGCCGCTTGAGCAAATTAAACAAAGCGAAAGCCAGCTGTCGGGCCGCGTAGGCATGATAGAAATGGATCTGGCCAGCGGCCGCACGCTGACCGCCTGGCGCGCCGATGAACGCTTTCCCATGATGAGCACCTTTAAAGTAGTGCTCTGCGGCGCAGTGCTGGCGCGGGTGGATGCCGGTGACGAACAGCTGGAGCGAAAGATCCACTATCGCCAGCAGGATCTGGTGGACTACTCGCCGGTCAGCGAAAAACACCTTGCCGACGGCATGACGGTCGGCGAACTCTGCGCCGCCGCCATTACCATGAGCGATAACAGCGCCGCCAATCTGCTGCTGGCCACCGTCGGCGGCCCCGCAGGATTGACTGCCTTTTTGCGCCAGATCGGCGACAACGTCACCCGCCTTGACCGCTGGGAAACGGAACTGAATGAGGCGCTTCCCGGCGACGCCCGCGACACCACTACCCCGGCCAGCATGGCCGCGACCCTGCGCAAGCTGCTGACCAGCCAGCGTCTGAGCGCCCGTTCGCAACGGCAGCTGCTGCAGTGGATGGTGGACGATCGGGTCGCCGGACCGTTGATCCGCTCCGTGCTGCCGGCGGGCTGGTTTATCGCCGATAAGACCGGAGCTAGCAAGCGGGGTGCGCGCGGGATTGTCGCCCTGCTTGGCCCGAATAACAAAGCAGAGCGCATTGTGGTGATTTATCTGCGGGATACGCCGGCGAGCATGGCCGAGCG
93	gb|FJ666068|+|0-1194|ARO:3002502|PDC-5	ATGCGCGATACCAGATTCCCCTGCCTGTGCGGCATCGCCGCTTCCACACTGCTG...TGA	1194.0	35513	36652	1139	1194	ATGCGCGATACCAGATTCCCCTGCCTGTGCGGCATCGCCGCTTCCACACTGCTGTTCGCCACCACCCCGGCCATTGCCGATGAGGCCCCGGCGGATCGCCTGAAGGCACTGGTCGACGCCGCCGTACAACCGGTGATGAAGGCCAATGACATTCCGGGCCTGGCCGTAGCCATCAGCCTGAAAGGAGAACCGCATTACTTCAGCTATGGGCTGGCCTCGAAAGAGGACGGCCGCCGGGTGACGCCGGAGACCCTGTTCGAGATCGGCTCGGTGAGCAAGACCTTCACCGTCACCCTCGCCGGCTATGCCCTGGCCCAGGACAAGATGCGCCTCGACGACCGCGCCAGCCAGCACTGGCCGGCACTGCAGGGCAGCCGCTTCGACGGCATCAGCCTGCTCGACCTCGCGACCTATACCGCCGGCGGCTTGCCGCTGCAGTTCCCCGACTCGGTGCAGAAGGACCAGGCACAGATCCGCGACTACTACCGCCAGTGGCAGCCGACCTACGCGCCGGGCAGCCAGCGCCTCTATTCCAACCCGAGCATCGGCCTGTTCGGCTATCTCGCCGCGCGCAGCCTGGGCCAGCCGTTCGAACGGCTCATGGAGCAGCAATTGTTCCCGGCACTGGGCCTCGAACAGACCCACCTCGACGTGCCCGAGGCGGCGCTGGCGCAGTACGCCCAGGGCTACGGCAAGGACGACCGCCCGCTACGGGTCGGTCCCGGCCCGCTGGATGCCGAAGGCTACGGGGTGAAGACCAGCGCGGCCGACCTGCTGCGCTTCGTCGATGCCAACCTGCATCCGGAGCGCCTGGACAGGCCCTGGGCGCAGGCGCTCGATGCCACCCATCGCGGTTACTACAAGGTCGGCGACATGACCCAGGGCCTGGGCTGGGAAGCCTACGACTGGCCGATCTCCCTGAAGCGCCTGCAGGCCGGCAACTCGACGCCGATGGCGCTGCAACCACACAGGATCGCCAGGCTGCCCGCGCCACAGGCGCTGGAGGGCCAGCGCCTGCTGAACAAGACCGGCTCCACCAACGGCTTCGGCGCCTACGTGGCGTTCGTCCCGGGCCGCGACCTGGGCCTGGTGATCCTGGCCAACCGCAACTATCCCAATGCCGAGCGGGTGAAGATCGC
94	gb|APON01000041.1|+|10443-11268|ARO:3001736|OXA-281	ATGAAAACTTTACAATTTGGACTCATCGCCCTCATTACAACCTTCGGTTCTGCA...TAA	825.0	156	929	773	825	ATGAAAACTTTACAGTTGGGCCTCATCGTCCTCATTACTACCTTCGGTTCTGCATGTACCATAATAAGAAGCCCCTCCATAGAAACAGCTAAAAACCATGAGCAACAAAGTGCGCAGCAGCAGATCCAACAGGCCTTCGATCAACTCCAAACCACGGGGGTGATTGTCATAAAGGATAAGCATGGCTTACACAGCTACGGCAATGACTTGAGCCGTGCTCAGACACCCTATGTACCCGCCTCTACCTTTAAAATGCTGAATGCCTTAATCGGACTAGAACATGGTAAAGCAACCAGCACCGAGGTGTTTAAATGGGATGGTCAAAAGAACAGCTTCCCTGCTTGGGAAAAAGACATGACTTTAGGGCAAGCCATGCAAGCATCTGCCGTTCCTGTTTATCAGGAGCTAGCACGGCGCATTGGCCTAGATCTAATGCAAAAAGAAGTACAGCGCATTGGATATGGCAATCAACAGATTGGCACCGTTGTCGATAATTTTTGGTTAGTCGGTCCACTGCAAATTACGCCTGTTCAAGAAGTCCTTTTTGTAGAGAAGCTGGCCAATACGCAACTCGCTTTTAAGCCAGATGTGCAACATACCGTACAAGACATGCTGCTGATTGAACAAAAACCGAATTATAAACTCTACGCCAAATCTGGTTGGGGCATGGACCTAGAACCGCAAGTGGGCTGGTGGACAGGCTGGGTCGAAACAGCAACAGGTGAAAAAGTGTATTTTGCTTTGAATATGCATATGAAAACAGGAATTTCAGC
95	gb|AJ009979.1|+|0-1152|ARO:3003847|ADC-1	ATGCGATTTAAAAAAATTTCTTGTCTACTTTTATCCCCGCTTTTTATTTTTAGT...TAA	1152.0	63	1160	1097	1152	ATGCGATTTAAAAAAATTTCTTGTCTACTTTTATCCCCGCTTTTTATTTTTAGTACCTCAATTTATGCGGGCAATACACCAAAAGACCAAGAAATTAAAAAACTGGTAGATCAAAACTTTAAACCGTTATTAGAAAAATATGATGTGCCAGGTATGGCTGTGGGTGTTATTCAAAATAATAAAAAGTATGAAATGTATTATGGTCTTCAATCTGTTCAAGATAAAAAAGCCGTAAATAGCAGTACTATTTTTGAGCTAGGTTCTGTCAGTAAATTATTTACCGCGACAGCAGGTGGATATGCAAAAAATAAAGGAAAAATCTCTTTTGACGATACGCCTGGTAAGTATTGGAAAGAACTAAAAAATACACCGATTGACCAAGTTAACTTACTTCAACTCGCGACGTATACAAGTGGTAACCTTGCCTTGCAATTTCCAGATGAAGTAAAAACAGATCAGCAAGTTTTAACATTTTTTAAAGACTGGAAACCTAAAAACTCAATCGGTGAATATCGACAATATTCAAACCCAAGCATTGGTTTATTTGGAAAAGTTGTAGCTTTGTCTATGAATAAACCTTTCGACCAAGTCTTAGAAAAAACAATTTTTCCGGCCCTTGGCTTAAAACATAGCTATGTAAATGTACCTAAGACCCAGATGCAAAACTATGCTTTTGGCTATAACCAAGAAAATCAGCCGATTCGAGTTAACCCCGGCCCACTCGATGCCCCAGCATATGGCGTCAAATCGACACTACCCGACATGTTGAGTTTTATTCATGCCAACCTAAATCCACAAAAATATCCAGCAGATATTCAACGGGCAATTAATGAAACACATCAGGGTCGCTATCAAGTAAATACCATGTATCAGGCACTCGGTTGGGAAGAGTTTTCTTATCCGGCAACGTTACAAACTTTATTAGACAGTAATTCAGAACAGATTGTGATGAAACCTAATAAAGTGACTGCTATTTCAAAGGAACCTTCAGTTAAGATGTACCATAAAACTGGCTCAACTACCGGTTTCGGAACATATGTGGTGTTTATTCCTAAAGAAAATATTGGTTTAGTCATGTTAACCAATAAACGTATTCC
96	gb|AF117745|+|0-780|ARO:3001079|SHV-21	CTGTTAGCCACCCTGCCGCTGGCGGTACACGCCAGCCCGCAGCCGCTTGAGCAA...AAT	780.0	51	771	720	780	AGCCACCCTGCCGCTGGCGGTACACGCCAGCCCGCAGCCGCTTGAGCAAATTAAACAAAGCGAAAGCCAGCTGTCGGGCCGCGTAGGCATGATAGAAATGGATCTGGCCAGCGGCCGCACGCTGACCGCCTGGCGCGCCGATGAACGCTTTCCCATGATGAGCACCTTTAAAGTAGTGCTCTGCGGCGCAGTGCTGGCGCGGGTGGATGCCGGTGACGAACAGCTGGAGCGAAAGATCCACTATCGCCAGCAGGATCTGGTGGACTACTCGCCGGTCAGCGAAAAACACCTTGCCGACGGCATGACGGTCGGCGAACTCTGCGCCGCCGCCATTACCATGAGCGATAACAGCGCCGCCAATCTGCTGCTGGCCACCGTCGGCGGCCCCGCAGGATTGACTGCCTTTTTGCGCCAGATCGGCGACAACGTCACCCGCCTTGACCGCTGGGAAACGGAACTGAATGAGGCGCTTCCCGGCGACGCCCGCGACACCACTACCCCGGCCAGCATGGCCGCGACCCTGCGCAAGCTGCTGACCAGCCAGCGTCTGAGCGCCCGTTCGCAACGGCAGCTGCTGCAGTGGATGGTGGACGATCGGGTCGCCGGACCGTTGATCCGCTCCGTGCTGCCGGCGGGCTGGTTTATCGCCGATAAGACCGGAGCTAGCAAGCGGGGTGCGCGCGGGATTGTCGCCCTGCTTGGCCCGAATAACAAAGCAGA
97	gb|KP264125.1|+|83-905|ARO:3003640|OXA-483	ATGAATAAATATTTTACTTGCTATGTGGTTGCTTCTCTTTTTCTTTCTGGTTGT...TAA	822.0	80	847	767	822	ATGAATAAATATTTTACTTGCTATGTGGTTGCTTCTCTTTTTCTTTCTGGTTGTACGGTTCAGCATAATTTAATAAATGAAACCCCGAGTCAGATTGTTCAAGGACATAATCAGGTGATTCATCAATACTTTGATGAAAAAAACACCTCAGGTGTGCTGGTTATTCAAACAGATAAAAAAATTAATCTATATGGTAATGCTCTAAGCCGCGCAAATACAGAATATGTGCCAGCCTCTACATTTAAAATGTTGAATGCCCTGATCGGATTGGAGAACCAGAAAACGGATATTAATGAAATATTTAAATGGAAGGGCGAGAAAAGGTCATTTACCGCTTGGGAAAAAGACATGACACTAGGAGAAGCCATGAAGCTTTCTGCAGTCCCAGTCTATCAGGAACTTGCGCGACGTATCGGTCTTGATCTCATGCAAAAAGAAGTAAAACGTATTGGTTTCGGTAATGCTGAAATTGGACAGCAGGTTGATAATTTCTGGTTGGTAGGACCATTAAAGGTTACGCCTATTCAAGAGGTAGAGTTTGTTTCCCAATTAGCACATACACAGCTTCCATTTAGTGAAAAAGTGCAGGCTAATGTAAAAAATATGCTTCTTTTAGAAGAGAGTAATGGCTACAAAATTTTTGGAAAGACTGGTTGGGCAATGGATATAAAACCACAAGTGGGCTGGTTGACCGGCTGGGTTGAGCAGCCAGATGGAAAAATTGTCGCTTTTGCATTAAATATGGAAATGCGGTCAGAAATGCCGGC
98	gb|HM559945|+|0-861|ARO:3001178|SHV-134	ATGCGTTATATTCGCCTGTGTATTATCTCCCTGTTAGCCACCCTGCCGCTGGCG...TAA	861.0	16	822	806	861	ATGCGTTATATTCGCCTGTGTATTATCACCCTGTGAGCCACCCTGCCGCTGGCGGTACACGCCAGCCCGCAGCCGCTTGAGCAAATTAAACAAAGCGAAAGCCAGCTGTCGGGCCGCGTAGGCATGATAGAAATGGATCTGGCCAGCGGCCGCACGCTGACCGCCTGGCGCGCCGATGAACGCTTTCCCATGATGAGCACCTTTAAAGTAGTGCTCTGCGGCGCAGTGCTGGCGCGGGTGGATGCCGGTGACGAACAGCTGGAGCGAAAGATCCACTATCGCCAGCAGGATCTGGTGGACTACTCGCCGGTCAGCGAAAAACACCTTGCCGACGGCATGACGGTCGGCGAACTCTGCGCCGCCGCCATTACCATGAGCGATAACAGCGCCGCCAATCTGCTGCTGGCCACCGTCGGCGGCCCCGCAGGATTGACTGCCTTTTTGCGCCAGATCGGCGACAACGTCACCCGCCTTGACCGCTGGGAAACGGAACTGAATGAGGCGCTTCCCGGCGACGCCCGCGACACCACTACCCCGGCCAGCATGGCCGCGACCCTGCGCAAGCTGCTGACCAGCCAGCGTCTGAGCGCCCGTTCGCAACGGCAGCTGCTGCAGTGGATGGTGGACGATCGGGTCGCCGGACCGTTGATCCGCTCCGTGCTGCCGGCGGGCTGGTTTATCGCCGATAAGACCGGAGCTAGCAAGCGGGGTGCGCGCGGGATTGTCGCCCTGCTTGGCCCGAATAACAAAGCAGAGCGCATTGTGGTGATTTATCTGCGGGATACGCCGGCGAGCATGGCCGAGCG
99	gb|EU571228|+|822-1644|ARO:3001702|OXA-133	ATGAATAAATATTTTACTTGCTATGTGGTTGCTTCTCTTTTTTTTTCTGGTTGT...TAA	822.0	80	847	767	822	ATGAATAAATATTTTACTTGCTATGTGGTTGCTTCTCTTTTTCTTTCTGGTTGTACGGTTCAGCATAATTTAATAAATGAAACCCCGAGTCAGATTGTTCAAGGACATAATCAGGTGATTCATCAATACTTTGATGAAAAAAACACCTCAGGTGTGCTGGTTATTCAAACAGATAAAAAAATTAATCTATATGGTAATGCTCTAAGCCGCGCAAATACAGAATATGTGCCAGCCTCTACATTTAAAATGTTGAATGCCCTGATCGGATTGGAGAACCAGAAAACGGATATTAATGAAATATTTAAATGGAAGGGCGAGAAAAGGTCATTTACCGCTTGGGAAAAAGACATGACACTAGGAGAAGCCATGAAGCTTTCTGCAGTCCCAGTCTATCAGGAACTTGCGCGACGTATCGGTCTTGATCTCATGCAAAAAGAAGTAAAACGTATTGGTTTCGGTAATGCTGAAATTGGACAGCAGGTTGATAATTTCTGGTTGGTAGGACCATTAAAGGTTACGCCTATTCAAGAGGTAGAGTTTGTTTCCCAATTAGCACATACACAGCTTCCATTTAGTGAAAAAGTGCAGGCTAATGTAAAAAATATGCTTCTTTTAGAAGAGAGTAATGGCTACAAAATTTTTGGAAAGACTGGTTGGGCAATGGATATAAAACCACAAGTGGGCTGGTTGACCGGCTGGGTTGAGCAGCCAGATGGAAAAATTGTCGCTTTTGCATTAAATATGGAAATGCGGTCAGAAATGCCGGC
100	gb|DQ013287|+|0-861|ARO:3001124|SHV-70	ATGCGTTATATTCGCCTGTGTATTATCTCCCTGTTAGCCACCCTGCCGCTGGCG...TAA	861.0	16	822	806	861	ATGCGTTATATTCGCCTGTGTATTATCACCCTGTGAGCCACCCTGCCGCTGGCGGTACACGCCAGCCCGCAGCCGCTTGAGCAAATTAAACAAAGCGAAAGCCAGCTGTCGGGCCGCGTAGGCATGATAGAAATGGATCTGGCCAGCGGCCGCACGCTGACCGCCTGGCGCGCCGATGAACGCTTTCCCATGATGAGCACCTTTAAAGTAGTGCTCTGCGGCGCAGTGCTGGCGCGGGTGGATGCCGGTGACGAACAGCTGGAGCGAAAGATCCACTATCGCCAGCAGGATCTGGTGGACTACTCGCCGGTCAGCGAAAAACACCTTGCCGACGGCATGACGGTCGGCGAACTCTGCGCCGCCGCCATTACCATGAGCGATAACAGCGCCGCCAATCTGCTGCTGGCCACCGTCGGCGGCCCCGCAGGATTGACTGCCTTTTTGCGCCAGATCGGCGACAACGTCACCCGCCTTGACCGCTGGGAAACGGAACTGAATGAGGCGCTTCCCGGCGACGCCCGCGACACCACTACCCCGGCCAGCATGGCCGCGACCCTGCGCAAGCTGCTGACCAGCCAGCGTCTGAGCGCCCGTTCGCAACGGCAGCTGCTGCAGTGGATGGTGGACGATCGGGTCGCCGGACCGTTGATCCGCTCCGTGCTGCCGGCGGGCTGGTTTATCGCCGATAAGACCGGAGCTAGCAAGCGGGGTGCGCGCGGGATTGTCGCCCTGCTTGGCCCGAATAACAAAGCAGAGCGCATTGTGGTGATTTATCTGCGGGATACGCCGGCGAGCATGGCCGAGCG
101	gb|HF947514|+|0-825|ARO:3001504|OXA-309	ATGAAAACTTTACAGTTGGCTCTCATCGCCCTCATTACAACCTTCGGTTCTGCA...TAA	825.0	156	929	773	825	ATGAAAACTTTACAGTTGGGCCTCATCGTCCTCATTACTACCTTCGGTTCTGCATGTACCATAATAAGAAGCCCCTCCATAGAAACAGCTAAAAACCATGAGCAACAAAGTGCGCAGCAGCAGATCCAACAGGCCTTCGATCAACTCCAAACCACGGGGGTGATTGTCATAAAGGATAAGCATGGCTTACACAGCTACGGCAATGACTTGAGCCGTGCTCAGACACCCTATGTACCCGCCTCTACCTTTAAAATGCTGAATGCCTTAATCGGACTAGAACATGGTAAAGCAACCAGCACCGAGGTGTTTAAATGGGATGGTCAAAAGAACAGCTTCCCTGCTTGGGAAAAAGACATGACTTTAGGGCAAGCCATGCAAGCATCTGCCGTTCCTGTTTATCAGGAGCTAGCACGGCGCATTGGCCTAGATCTAATGCAAAAAGAAGTACAGCGCATTGGATATGGCAATCAACAGATTGGCACCGTTGTCGATAATTTTTGGTTAGTCGGTCCACTGCAAATTACGCCTGTTCAAGAAGTCCTTTTTGTAGAGAAGCTGGCCAATACGCAACTCGCTTTTAAGCCAGATGTGCAACATACCGTACAAGACATGCTGCTGATTGAACAAAAACCGAATTATAAACTCTACGCCAAATCTGGTTGGGGCATGGACCTAGAACCGCAAGTGGGCTGGTGGACAGGCTGGGTCGAAACAGCAACAGGTGAAAAAGTGTATTTTGCTTTGAATATGCATATGAAAACAGGAATTTCAGC
102	gb|HQ637576|+|0-861|ARO:3001179|SHV-135	ATGCGTTATATTCGCCTGTGTATTATCTCCCTGTTAGCCACCCTGCCGCTGGCG...TAA	861.0	16	822	806	861	ATGCGTTATATTCGCCTGTGTATTATCACCCTGTGAGCCACCCTGCCGCTGGCGGTACACGCCAGCCCGCAGCCGCTTGAGCAAATTAAACAAAGCGAAAGCCAGCTGTCGGGCCGCGTAGGCATGATAGAAATGGATCTGGCCAGCGGCCGCACGCTGACCGCCTGGCGCGCCGATGAACGCTTTCCCATGATGAGCACCTTTAAAGTAGTGCTCTGCGGCGCAGTGCTGGCGCGGGTGGATGCCGGTGACGAACAGCTGGAGCGAAAGATCCACTATCGCCAGCAGGATCTGGTGGACTACTCGCCGGTCAGCGAAAAACACCTTGCCGACGGCATGACGGTCGGCGAACTCTGCGCCGCCGCCATTACCATGAGCGATAACAGCGCCGCCAATCTGCTGCTGGCCACCGTCGGCGGCCCCGCAGGATTGACTGCCTTTTTGCGCCAGATCGGCGACAACGTCACCCGCCTTGACCGCTGGGAAACGGAACTGAATGAGGCGCTTCCCGGCGACGCCCGCGACACCACTACCCCGGCCAGCATGGCCGCGACCCTGCGCAAGCTGCTGACCAGCCAGCGTCTGAGCGCCCGTTCGCAACGGCAGCTGCTGCAGTGGATGGTGGACGATCGGGTCGCCGGACCGTTGATCCGCTCCGTGCTGCCGGCGGGCTGGTTTATCGCCGATAAGACCGGAGCTAGCAAGCGGGGTGCGCGCGGGATTGTCGCCCTGCTTGGCCCGAATAACAAAGCAGAGCGCATTGTGGTGATTTATCTGCGGGATACGCCGGCGAGCATGGCCGAGCG
103	gb|AF117746|+|0-780|ARO:3001080|SHV-22	CTGTTAGCCACCCTGCCGCTGGCGGTACACGCCAGCCCGCAGCCGCTTGAGCAA...AAT	780.0	51	771	720	780	AGCCACCCTGCCGCTGGCGGTACACGCCAGCCCGCAGCCGCTTGAGCAAATTAAACAAAGCGAAAGCCAGCTGTCGGGCCGCGTAGGCATGATAGAAATGGATCTGGCCAGCGGCCGCACGCTGACCGCCTGGCGCGCCGATGAACGCTTTCCCATGATGAGCACCTTTAAAGTAGTGCTCTGCGGCGCAGTGCTGGCGCGGGTGGATGCCGGTGACGAACAGCTGGAGCGAAAGATCCACTATCGCCAGCAGGATCTGGTGGACTACTCGCCGGTCAGCGAAAAACACCTTGCCGACGGCATGACGGTCGGCGAACTCTGCGCCGCCGCCATTACCATGAGCGATAACAGCGCCGCCAATCTGCTGCTGGCCACCGTCGGCGGCCCCGCAGGATTGACTGCCTTTTTGCGCCAGATCGGCGACAACGTCACCCGCCTTGACCGCTGGGAAACGGAACTGAATGAGGCGCTTCCCGGCGACGCCCGCGACACCACTACCCCGGCCAGCATGGCCGCGACCCTGCGCAAGCTGCTGACCAGCCAGCGTCTGAGCGCCCGTTCGCAACGGCAGCTGCTGCAGTGGATGGTGGACGATCGGGTCGCCGGACCGTTGATCCGCTCCGTGCTGCCGGCGGGCTGGTTTATCGCCGATAAGACCGGAGCTAGCAAGCGGGGTGCGCGCGGGATTGTCGCCCTGCTTGGCCCGAATAACAAAGCAGA
104	gb|EU670845|+|1594-2419|ARO:3001655|OXA-138	ATGAACATTAAAACCCTCTTACTTATAACAAGCGCTATTTTTATTTCAGCCTGC...TAG	825.0	54149	54919	770	825	ATGAACATTAAAGCACTCTTACTTATAACAAGCGCTATTTTTATTTCAGCCTGCTCACCTTATATAGTGACTGCTAATCCAAATCACAGCGCTTCAAAATCTGATGTAAAAGCAGAGAAAATTAAAAATTTATTTAACGAAGCACACACTACGGGTGTTTTAGTTATCCAACAAGGCCAAACTCAACAAAGCTATGGTAATGATCTTGCTCGTGCTTCGACCGAGTATGTACCTGCTTCGACCTTCAAAATGCTTAATGCTTTGATCGGCCTTGAGCACCATAAGGCAACCACCACAGAAGTATTTAAGTGGGATGGTAAAAAAAGGTTATTCCCAGAATGGGAAAAGGACATGACCCTAGGCGATGCCATGAAAGCTTCCGCTATTCCAGTTTATCAAGATTTAGCTCGTCGTATTGGACTTGAGCTCATGTCTAAGGAAGTGAAGCGTGTTGGTTATGGCAATGCAGATATCGGTACCCAAGTCGATAATTTTTGGCTGGTGGGTCCTTTAAAAATTACTCCTCAGCAAGAGGCACAGTTTGCTTACAAGCTAGCTAATAAAACGCTTCCATTTAGCCAAAAAGTCCAAGATGAAGTGCAATCCATGCTATTCATAGAAGAAAAGAATGGAAACAAAATATACGCAAAAAGTGGTTGGGGATGGGATGTAAACCCACAAGTAGGCTGGTTAACTGGATGGGTTGTTCAGCCTCAAGGGAATATTGTAGCGTTCTCCCTTAACTTAGAAATGAAAAAAGGAATACCTAG
105	gb|LLNM01000004.1|-|97677-98466|ARO:3003642|OXA-485	ATGCGCCCTCTCCTCTTCAGCGCCCTTCTCCTGCTCTCCGGGCGTGCCCAGGCC...TGA	789.0	19143	19877	734	789	ATGCGCCCTCTCCTCTTCAGCGCCCTTCTCCTGCTCTCCGGGCATGCCCAGGCCAGCGAATGGAACGACAGCCGGGCCGTGGACAAGCTATTCGGAGCGGCCGGTGTGAAAGGCACCTTCGTCCTTTACGATGTGCAGCGGCAGCGCTATGTCGGCCATGACCGGGAGCGCGCGGAAACCCGCTTCGTTCCCGCTTCCACCTACAAGGTGGCGAACAGCCTGATCGGCTTATCCACAGGGGCGGTTAGATCCGCCGACGAGGTTCTTCCCTATGGCGGCAAACCCCAGCGCTTCAAGGCCTGGGAGCACGACATGAGCCTGCGCGACGCGATCAAGGCATCGAACGTACCGGTCTACCAGGAACTGGCGCGGCGCATCGGCCTGGAGCGGATGCGCGCCAATGTCTCGCGCCTGGGTTACGGCAACGCGGAAATCGGCCAGGTTGTGGATAACTTCTGGTTGGTGGGACCGCTGAAGATCAGCGCGATGGAACAGACCCGCTTTCTGCTCCGACTGGCGCAGGGAGAATTGCCATTCCCCGCCCCGGTGCAGTCCACCGTGCGCGCCATGACCCTGCTGGAAAGCGGCCCGGGCTGGGAGCTGCACGGCAAGACCGGCTGGTGCTTCGACTGCACGCCGGAACTCGGCTGGTGGGTGGGCTGGGTGAAGCGCAACGAGCGGCTCTACGGCTTCGCCCTGAACATCGACATGCCCGGCGGCGAGGCCGACATCGG
106	gb|KF057029|+|0-825|ARO:3001683|OXA-312	ATGAACATTAAAGCCCTCTTACTTATAACAAGCGCTATTTTTATTTCAGCCTGC...TAG	825.0	54149	54919	770	825	ATGAACATTAAAGCACTCTTACTTATAACAAGCGCTATTTTTATTTCAGCCTGCTCACCTTATATAGTGACTGCTAATCCAAATCACAGCGCTTCAAAATCTGATGTAAAAGCAGAGAAAATTAAAAATTTATTTAACGAAGCACACACTACGGGTGTTTTAGTTATCCAACAAGGCCAAACTCAACAAAGCTATGGTAATGATCTTGCTCGTGCTTCGACCGAGTATGTACCTGCTTCGACCTTCAAAATGCTTAATGCTTTGATCGGCCTTGAGCACCATAAGGCAACCACCACAGAAGTATTTAAGTGGGATGGTAAAAAAAGGTTATTCCCAGAATGGGAAAAGGACATGACCCTAGGCGATGCCATGAAAGCTTCCGCTATTCCAGTTTATCAAGATTTAGCTCGTCGTATTGGACTTGAGCTCATGTCTAAGGAAGTGAAGCGTGTTGGTTATGGCAATGCAGATATCGGTACCCAAGTCGATAATTTTTGGCTGGTGGGTCCTTTAAAAATTACTCCTCAGCAAGAGGCACAGTTTGCTTACAAGCTAGCTAATAAAACGCTTCCATTTAGCCAAAAAGTCCAAGATGAAGTGCAATCCATGCTATTCATAGAAGAAAAGAATGGAAACAAAATATACGCAAAAAGTGGTTGGGGATGGGATGTAAACCCACAAGTAGGCTGGTTAACTGGATGGGTTGTTCAGCCTCAAGGGAATATTGTAGCGTTCTCCCTTAACTTAGAAATGAAAAAAGGAATACCTAG
107	gb|KJ420612.1|+|1821-2622|ARO:3001409|OXA-14	ATGAAAACATTTGCCGCATATGTAATTATCGCGTGTCTTTCGAGTACGGCATTA...TAA	801.0	659	1405	746	801	ATGAAAACATTTGCCGCATATGTAATTATCGCGTGTCTTTCGAGTACGGCATTAGCTGGTTCAATTACAGAAAATACGTCTTGGAACAAAGAGTTCTCTGCCGAAGCCGTCAATGGTGTCTTCGTGCTTTGTAAAAGTAGCAGTAAATCCTGCGCTACCAATGACTTAGCTCGTGCATCAAAGGAATATCTTCCAGCATCAACATTTAAGATCCCCAACGCAATTATCGGCCTAGAAACTGGTGTCATAAAGAATGAGCATCAGGTTTTCAAATGGGACGGAAAGCCAAGAGCCATGAAGCAATGGGAAAGAGACTTGACCTTAAGAGGGGCAATACAAGTTTCAGCTGTTCCCGTATTTCAACAAATCGCCAGAGAAGTTGGCGAAGTAAGAATGCAGAAATACCTTAAAAAATTTTCCTATGGCAACCAGAATATCAGTGGTGGCATTGACAAATTCTGGTTGGAAGGCCAGCTTAGAATTTCCGCAGTTAATCAAGTGGAGTTTCTAGAGTCTCTATATTTAAATAAATTGTCAGCATCTAAAGAAAACCAGCTAATAGTAAAAGAGGCTTTGGTAACGGAGGCGGCACCTGAATATCTAGTGCATTCAAAAACTGGTTTTTCTGGTGTGGGAACTGAGTCAAATCCTGGTGTCGCATGGTGGGTTGGGTGGGTTGAGAAGGAGACAGAGGTTTACTTTTTCGCCTTTAACATGGATATAGACAACGAAAGTAAGTTGCCGCT
108	gb|AF117747|+|0-780|ARO:3001081|SHV-23	CTGTTAGCCACCCTGCCGCTGGCGGTACACGCCAGCCCGCAGCCGCTTGAGCAA...AAT	780.0	51	771	720	780	AGCCACCCTGCCGCTGGCGGTACACGCCAGCCCGCAGCCGCTTGAGCAAATTAAACAAAGCGAAAGCCAGCTGTCGGGCCGCGTAGGCATGATAGAAATGGATCTGGCCAGCGGCCGCACGCTGACCGCCTGGCGCGCCGATGAACGCTTTCCCATGATGAGCACCTTTAAAGTAGTGCTCTGCGGCGCAGTGCTGGCGCGGGTGGATGCCGGTGACGAACAGCTGGAGCGAAAGATCCACTATCGCCAGCAGGATCTGGTGGACTACTCGCCGGTCAGCGAAAAACACCTTGCCGACGGCATGACGGTCGGCGAACTCTGCGCCGCCGCCATTACCATGAGCGATAACAGCGCCGCCAATCTGCTGCTGGCCACCGTCGGCGGCCCCGCAGGATTGACTGCCTTTTTGCGCCAGATCGGCGACAACGTCACCCGCCTTGACCGCTGGGAAACGGAACTGAATGAGGCGCTTCCCGGCGACGCCCGCGACACCACTACCCCGGCCAGCATGGCCGCGACCCTGCGCAAGCTGCTGACCAGCCAGCGTCTGAGCGCCCGTTCGCAACGGCAGCTGCTGCAGTGGATGGTGGACGATCGGGTCGCCGGACCGTTGATCCGCTCCGTGCTGCCGGCGGGCTGGTTTATCGCCGATAAGACCGGAGCTAGCAAGCGGGGTGCGCGCGGGATTGTCGCCCTGCTTGGCCCGAATAACAAAGCAGA
109	gb|KJ949070.1|+|0-1215|ARO:3005039|PDC-55	ATGCGCGATACCAGATTCCCCTGCCTGTGCGGCATCGCCGCTTCCACACTGCTG...TAG	1215.0	35513	36681	1168	1215	ATGCGCGATACCAGATTCCCCTGCCTGTGCGGCATCGCCGCTTCCACACTGCTGTTCGCCACCACCCCGGCCATTGCCGATGAGGCCCCGGCGGATCGCCTGAAGGCACTGGTCGACGCCGCCGTACAACCGGTGATGAAGGCCAATGACATTCCGGGCCTGGCCGTAGCCATCAGCCTGAAAGGAGAACCGCATTACTTCAGCTATGGGCTGGCCTCGAAAGAGGACGGCCGCCGGGTGACGCCGGAGACCCTGTTCGAGATCGGCTCGGTGAGCAAGACCTTCACCGTCACCCTCGCCGGCTATGCCCTGGCCCAGGACAAGATGCGCCTCGACGACCGCGCCAGCCAGCACTGGCCGGCACTGCAGGGCAGCCGCTTCGACGGCATCAGCCTGCTCGACCTCGCGACCTATACCGCCGGCGGCTTGCCGCTGCAGTTCCCCGACTCGGTGCAGAAGGACCAGGCACAGATCCGCGACTACTACCGCCAGTGGCAGCCGACCTACGCGCCGGGCAGCCAGCGCCTCTATTCCAACCCGAGCATCGGCCTGTTCGGCTATCTCGCCGCGCGCAGCCTGGGCCAGCCGTTCGAACGGCTCATGGAGCAGCAATTGTTCCCGGCACTGGGCCTCGAACAGACCCACCTCGACGTGCCCGAGGCGGCGCTGGCGCAGTACGCCCAGGGCTACGGCAAGGACGACCGCCCGCTACGGGTCGGTCCCGGCCCGCTGGATGCCGAAGGCTACGGGGTGAAGACCAGCGCGGCCGACCTGCTGCGCTTCGTCGATGCCAACCTGCATCCGGAGCGCCTGGACAGGCCCTGGGCGCAGGCGCTCGATGCCACCCATCGCGGTTACTACAAGGTCGGCGACATGACCCAGGGCCTGGGCTGGGAAGCCTACGACTGGCCGATCTCCCTGAAGCGCCTGCAGGCCGGCAACTCGACGCCGATGGCGCTGCAACCACACAGGATCGCCAGGCTGCCCGCGCCACAGGCGCTGGAGGGCCAGCGCCTGCTGAACAAGACCGGCTCCACCAACGGCTTCGGCGCCTACGTGGCGTTCGTCCCGGGCCGCGACCTGGGCCTGGTGATCCTGGCCAACCGCAACTATCCCAATGCCGAGCGGGTGAAGATCGCCTACGCCATCCTCAGCGGCCTGGAGCAGC
110	gb|AM176546|+|0-861|ARO:3001125|SHV-71	ATGCGTTATATTCGCCTGTGTATTATCTCCCTGTTAGCCACCCTGCCGCTGGCG...TAA	861.0	16	822	806	861	ATGCGTTATATTCGCCTGTGTATTATCACCCTGTGAGCCACCCTGCCGCTGGCGGTACACGCCAGCCCGCAGCCGCTTGAGCAAATTAAACAAAGCGAAAGCCAGCTGTCGGGCCGCGTAGGCATGATAGAAATGGATCTGGCCAGCGGCCGCACGCTGACCGCCTGGCGCGCCGATGAACGCTTTCCCATGATGAGCACCTTTAAAGTAGTGCTCTGCGGCGCAGTGCTGGCGCGGGTGGATGCCGGTGACGAACAGCTGGAGCGAAAGATCCACTATCGCCAGCAGGATCTGGTGGACTACTCGCCGGTCAGCGAAAAACACCTTGCCGACGGCATGACGGTCGGCGAACTCTGCGCCGCCGCCATTACCATGAGCGATAACAGCGCCGCCAATCTGCTGCTGGCCACCGTCGGCGGCCCCGCAGGATTGACTGCCTTTTTGCGCCAGATCGGCGACAACGTCACCCGCCTTGACCGCTGGGAAACGGAACTGAATGAGGCGCTTCCCGGCGACGCCCGCGACACCACTACCCCGGCCAGCATGGCCGCGACCCTGCGCAAGCTGCTGACCAGCCAGCGTCTGAGCGCCCGTTCGCAACGGCAGCTGCTGCAGTGGATGGTGGACGATCGGGTCGCCGGACCGTTGATCCGCTCCGTGCTGCCGGCGGGCTGGTTTATCGCCGATAAGACCGGAGCTAGCAAGCGGGGTGCGCGCGGGATTGTCGCCCTGCTTGGCCCGAATAACAAAGCAGAGCGCATTGTGGTGATTTATCTGCGGGATACGCCGGCGAGCATGGCCGAGCG
111	gb|DQ883640.1|+|0-1167|ARO:3003855|ADC-10	ATGCGATTTAAAAAAATTTCTTGTCTACTTTTATCCCCGCTTTTTATTTTTAGT...TAA	1167.0	63	1160	1097	1167	ATGCGATTTAAAAAAATTTCTTGTCTACTTTTATCCCCGCTTTTTATTTTTAGTACCTCAATTTATGCGGGCAATACACCAAAAGACCAAGAAATTAAAAAACTGGTAGATCAAAACTTTAAACCGTTATTAGAAAAATATGATGTGCCAGGTATGGCTGTGGGTGTTATTCAAAATAATAAAAAGTATGAAATGTATTATGGTCTTCAATCTGTTCAAGATAAAAAAGCCGTAAATAGCAGTACTATTTTTGAGCTAGGTTCTGTCAGTAAATTATTTACCGCGACAGCAGGTGGATATGCAAAAAATAAAGGAAAAATCTCTTTTGACGATACGCCTGGTAAGTATTGGAAAGAACTAAAAAATACACCGATTGACCAAGTTAACTTACTTCAACTCGCGACGTATACAAGTGGTAACCTTGCCTTGCAATTTCCAGATGAAGTAAAAACAGATCAGCAAGTTTTAACATTTTTTAAAGACTGGAAACCTAAAAACTCAATCGGTGAATATCGACAATATTCAAACCCAAGCATTGGTTTATTTGGAAAAGTTGTAGCTTTGTCTATGAATAAACCTTTCGACCAAGTCTTAGAAAAAACAATTTTTCCGGCCCTTGGCTTAAAACATAGCTATGTAAATGTACCTAAGACCCAGATGCAAAACTATGCTTTTGGCTATAACCAAGAAAATCAGCCGATTCGAGTTAACCCCGGCCCACTCGATGCCCCAGCATATGGCGTCAAATCGACACTACCCGACATGTTGAGTTTTATTCATGCCAACCTAAATCCACAAAAATATCCAGCAGATATTCAACGGGCAATTAATGAAACACATCAGGGTCGCTATCAAGTAAATACCATGTATCAGGCACTCGGTTGGGAAGAGTTTTCTTATCCGGCAACGTTACAAACTTTATTAGACAGTAATTCAGAACAGATTGTGATGAAACCTAATAAAGTGACTGCTATTTCAAAGGAACCTTCAGTTAAGATGTACCATAAAACTGGCTCAACTACCGGTTTCGGAACATATGTGGTGTTTATTCCTAAAGAAAATATTGGTTTAGTCATGTTAACCAATAAACGTATTCC
112	gb|CP038661.1|+|6223618-6224407|ARO:3003643|OXA-486	ATGCGCCCTCTCCTCTTCAGTGCCCTTCTCCTGCTTTCCGGGCATACCCAGGCC...TGA	789.0	19143	19877	734	789	ATGCGCCCTCTCCTCTTCAGCGCCCTTCTCCTGCTCTCCGGGCATGCCCAGGCCAGCGAATGGAACGACAGCCGGGCCGTGGACAAGCTATTCGGAGCGGCCGGTGTGAAAGGCACCTTCGTCCTTTACGATGTGCAGCGGCAGCGCTATGTCGGCCATGACCGGGAGCGCGCGGAAACCCGCTTCGTTCCCGCTTCCACCTACAAGGTGGCGAACAGCCTGATCGGCTTATCCACAGGGGCGGTTAGATCCGCCGACGAGGTTCTTCCCTATGGCGGCAAACCCCAGCGCTTCAAGGCCTGGGAGCACGACATGAGCCTGCGCGACGCGATCAAGGCATCGAACGTACCGGTCTACCAGGAACTGGCGCGGCGCATCGGCCTGGAGCGGATGCGCGCCAATGTCTCGCGCCTGGGTTACGGCAACGCGGAAATCGGCCAGGTTGTGGATAACTTCTGGTTGGTGGGACCGCTGAAGATCAGCGCGATGGAACAGACCCGCTTTCTGCTCCGACTGGCGCAGGGAGAATTGCCATTCCCCGCCCCGGTGCAGTCCACCGTGCGCGCCATGACCCTGCTGGAAAGCGGCCCGGGCTGGGAGCTGCACGGCAAGACCGGCTGGTGCTTCGACTGCACGCCGGAACTCGGCTGGTGGGTGGGCTGGGTGAAGCGCAACGAGCGGCTCTACGGCTTCGCCCTGAACATCGACATGCCCGGCGGCGAGGCCGACATCGG
113	gb|AM176547|+|30-891|ARO:3001126|SHV-72	ATGCGTTATTTTCGCCTGTGTATTATCTCCCTGTTAGCCACCCTGCCGCTGGCG...TAA	861.0	16	822	806	861	ATGCGTTATATTCGCCTGTGTATTATCACCCTGTGAGCCACCCTGCCGCTGGCGGTACACGCCAGCCCGCAGCCGCTTGAGCAAATTAAACAAAGCGAAAGCCAGCTGTCGGGCCGCGTAGGCATGATAGAAATGGATCTGGCCAGCGGCCGCACGCTGACCGCCTGGCGCGCCGATGAACGCTTTCCCATGATGAGCACCTTTAAAGTAGTGCTCTGCGGCGCAGTGCTGGCGCGGGTGGATGCCGGTGACGAACAGCTGGAGCGAAAGATCCACTATCGCCAGCAGGATCTGGTGGACTACTCGCCGGTCAGCGAAAAACACCTTGCCGACGGCATGACGGTCGGCGAACTCTGCGCCGCCGCCATTACCATGAGCGATAACAGCGCCGCCAATCTGCTGCTGGCCACCGTCGGCGGCCCCGCAGGATTGACTGCCTTTTTGCGCCAGATCGGCGACAACGTCACCCGCCTTGACCGCTGGGAAACGGAACTGAATGAGGCGCTTCCCGGCGACGCCCGCGACACCACTACCCCGGCCAGCATGGCCGCGACCCTGCGCAAGCTGCTGACCAGCCAGCGTCTGAGCGCCCGTTCGCAACGGCAGCTGCTGCAGTGGATGGTGGACGATCGGGTCGCCGGACCGTTGATCCGCTCCGTGCTGCCGGCGGGCTGGTTTATCGCCGATAAGACCGGAGCTAGCAAGCGGGGTGCGCGCGGGATTGTCGCCCTGCTTGGCCCGAATAACAAAGCAGAGCGCATTGTGGTGATTTATCTGCGGGATACGCCGGCGAGCATGGCCGAGCG
114	gb|AB023477|+|0-861|ARO:3001082|SHV-24	ATGCGTTATATTCGCCTGTGTATTATCTCCCTGTTAGCCACCCTGCCGCTGGCG...TAA	861.0	16	822	806	861	ATGCGTTATATTCGCCTGTGTATTATCACCCTGTGAGCCACCCTGCCGCTGGCGGTACACGCCAGCCCGCAGCCGCTTGAGCAAATTAAACAAAGCGAAAGCCAGCTGTCGGGCCGCGTAGGCATGATAGAAATGGATCTGGCCAGCGGCCGCACGCTGACCGCCTGGCGCGCCGATGAACGCTTTCCCATGATGAGCACCTTTAAAGTAGTGCTCTGCGGCGCAGTGCTGGCGCGGGTGGATGCCGGTGACGAACAGCTGGAGCGAAAGATCCACTATCGCCAGCAGGATCTGGTGGACTACTCGCCGGTCAGCGAAAAACACCTTGCCGACGGCATGACGGTCGGCGAACTCTGCGCCGCCGCCATTACCATGAGCGATAACAGCGCCGCCAATCTGCTGCTGGCCACCGTCGGCGGCCCCGCAGGATTGACTGCCTTTTTGCGCCAGATCGGCGACAACGTCACCCGCCTTGACCGCTGGGAAACGGAACTGAATGAGGCGCTTCCCGGCGACGCCCGCGACACCACTACCCCGGCCAGCATGGCCGCGACCCTGCGCAAGCTGCTGACCAGCCAGCGTCTGAGCGCCCGTTCGCAACGGCAGCTGCTGCAGTGGATGGTGGACGATCGGGTCGCCGGACCGTTGATCCGCTCCGTGCTGCCGGCGGGCTGGTTTATCGCCGATAAGACCGGAGCTAGCAAGCGGGGTGCGCGCGGGATTGTCGCCCTGCTTGGCCCGAATAACAAAGCAGAGCGCATTGTGGTGATTTATCTGCGGGATACGCCGGCGAGCATGGCCGAGCG
115	gb|HQ661363|+|71-932|ARO:3001181|SHV-137	ATGCGTTATATTCGCCTGTGTATTATCTCCCTGTTAGCCACCCTGCCGCTGGCG...TAA	861.0	16	822	806	861	ATGCGTTATATTCGCCTGTGTATTATCACCCTGTGAGCCACCCTGCCGCTGGCGGTACACGCCAGCCCGCAGCCGCTTGAGCAAATTAAACAAAGCGAAAGCCAGCTGTCGGGCCGCGTAGGCATGATAGAAATGGATCTGGCCAGCGGCCGCACGCTGACCGCCTGGCGCGCCGATGAACGCTTTCCCATGATGAGCACCTTTAAAGTAGTGCTCTGCGGCGCAGTGCTGGCGCGGGTGGATGCCGGTGACGAACAGCTGGAGCGAAAGATCCACTATCGCCAGCAGGATCTGGTGGACTACTCGCCGGTCAGCGAAAAACACCTTGCCGACGGCATGACGGTCGGCGAACTCTGCGCCGCCGCCATTACCATGAGCGATAACAGCGCCGCCAATCTGCTGCTGGCCACCGTCGGCGGCCCCGCAGGATTGACTGCCTTTTTGCGCCAGATCGGCGACAACGTCACCCGCCTTGACCGCTGGGAAACGGAACTGAATGAGGCGCTTCCCGGCGACGCCCGCGACACCACTACCCCGGCCAGCATGGCCGCGACCCTGCGCAAGCTGCTGACCAGCCAGCGTCTGAGCGCCCGTTCGCAACGGCAGCTGCTGCAGTGGATGGTGGACGATCGGGTCGCCGGACCGTTGATCCGCTCCGTGCTGCCGGCGGGCTGGTTTATCGCCGATAAGACCGGAGCTAGCAAGCGGGGTGCGCGCGGGATTGTCGCCCTGCTTGGCCCGAATAACAAAGCAGAGCGCATTGTGGTGATTTATCTGCGGGATACGCCGGCGAGCATGGCCGAGCG
116	gb|EU358785|+|720-1521|ARO:3001803|OXA-142	ATGAAAACATTTGCCGCATATGTAATTATCGCGTGTCTTTCGAGTACGGCATTA...TAA	801.0	659	1405	746	801	ATGAAAACATTTGCCGCATATGTAATTATCGCGTGTCTTTCGAGTACGGCATTAGCTGGTTCAATTACAGAAAATACGTCTTGGAACAAAGAGTTCTCTGCCGAAGCCGTCAATGGTGTCTTCGTGCTTTGTAAAAGTAGCAGTAAATCCTGCGCTACCAATGACTTAGCTCGTGCATCAAAGGAATATCTTCCAGCATCAACATTTAAGATCCCCAACGCAATTATCGGCCTAGAAACTGGTGTCATAAAGAATGAGCATCAGGTTTTCAAATGGGACGGAAAGCCAAGAGCCATGAAGCAATGGGAAAGAGACTTGACCTTAAGAGGGGCAATACAAGTTTCAGCTGTTCCCGTATTTCAACAAATCGCCAGAGAAGTTGGCGAAGTAAGAATGCAGAAATACCTTAAAAAATTTTCCTATGGCAACCAGAATATCAGTGGTGGCATTGACAAATTCTGGTTGGAAGGCCAGCTTAGAATTTCCGCAGTTAATCAAGTGGAGTTTCTAGAGTCTCTATATTTAAATAAATTGTCAGCATCTAAAGAAAACCAGCTAATAGTAAAAGAGGCTTTGGTAACGGAGGCGGCACCTGAATATCTAGTGCATTCAAAAACTGGTTTTTCTGGTGTGGGAACTGAGTCAAATCCTGGTGTCGCATGGTGGGTTGGGTGGGTTGAGAAGGAGACAGAGGTTTACTTTTTCGCCTTTAACATGGATATAGACAACGAAAGTAAGTTGCCGCT
117	gb|SMRY02000082.1|-|17219-18008|ARO:3003645|OXA-488	ATGCGCCCTCTCCTCTTCAGCGCCCTTCTCCTGCTCTCCGGGCATGCCCAGGCC...TGA	789.0	19143	19877	734	789	ATGCGCCCTCTCCTCTTCAGCGCCCTTCTCCTGCTCTCCGGGCATGCCCAGGCCAGCGAATGGAACGACAGCCGGGCCGTGGACAAGCTATTCGGAGCGGCCGGTGTGAAAGGCACCTTCGTCCTTTACGATGTGCAGCGGCAGCGCTATGTCGGCCATGACCGGGAGCGCGCGGAAACCCGCTTCGTTCCCGCTTCCACCTACAAGGTGGCGAACAGCCTGATCGGCTTATCCACAGGGGCGGTTAGATCCGCCGACGAGGTTCTTCCCTATGGCGGCAAACCCCAGCGCTTCAAGGCCTGGGAGCACGACATGAGCCTGCGCGACGCGATCAAGGCATCGAACGTACCGGTCTACCAGGAACTGGCGCGGCGCATCGGCCTGGAGCGGATGCGCGCCAATGTCTCGCGCCTGGGTTACGGCAACGCGGAAATCGGCCAGGTTGTGGATAACTTCTGGTTGGTGGGACCGCTGAAGATCAGCGCGATGGAACAGACCCGCTTTCTGCTCCGACTGGCGCAGGGAGAATTGCCATTCCCCGCCCCGGTGCAGTCCACCGTGCGCGCCATGACCCTGCTGGAAAGCGGCCCGGGCTGGGAGCTGCACGGCAAGACCGGCTGGTGCTTCGACTGCACGCCGGAACTCGGCTGGTGGGTGGGCTGGGTGAAGCGCAACGAGCGGCTCTACGGCTTCGCCCTGAACATCGACATGCCCGGCGGCGAGGCCGACATCGG
118	gb|AM176548|+|16-874|ARO:3001127|SHV-73	ATGCGTATTCGCCTGTGTATTATCTCCCTGTTAGCCACCCTGCCGCTGGCGGTA...TAA	858.0	16	822	806	858	ATGCGTTATATTCGCCTGTGTATTATCACCCTGTGAGCCACCCTGCCGCTGGCGGTACACGCCAGCCCGCAGCCGCTTGAGCAAATTAAACAAAGCGAAAGCCAGCTGTCGGGCCGCGTAGGCATGATAGAAATGGATCTGGCCAGCGGCCGCACGCTGACCGCCTGGCGCGCCGATGAACGCTTTCCCATGATGAGCACCTTTAAAGTAGTGCTCTGCGGCGCAGTGCTGGCGCGGGTGGATGCCGGTGACGAACAGCTGGAGCGAAAGATCCACTATCGCCAGCAGGATCTGGTGGACTACTCGCCGGTCAGCGAAAAACACCTTGCCGACGGCATGACGGTCGGCGAACTCTGCGCCGCCGCCATTACCATGAGCGATAACAGCGCCGCCAATCTGCTGCTGGCCACCGTCGGCGGCCCCGCAGGATTGACTGCCTTTTTGCGCCAGATCGGCGACAACGTCACCCGCCTTGACCGCTGGGAAACGGAACTGAATGAGGCGCTTCCCGGCGACGCCCGCGACACCACTACCCCGGCCAGCATGGCCGCGACCCTGCGCAAGCTGCTGACCAGCCAGCGTCTGAGCGCCCGTTCGCAACGGCAGCTGCTGCAGTGGATGGTGGACGATCGGGTCGCCGGACCGTTGATCCGCTCCGTGCTGCCGGCGGGCTGGTTTATCGCCGATAAGACCGGAGCTAGCAAGCGGGGTGCGCGCGGGATTGTCGCCCTGCTTGGCCCGAATAACAAAGCAGAGCGCATTGTGGTGATTTATCTGCGGGATACGCCGGCGAGCATGGCCGAGCG
119	gb|FJ666069|+|0-1194|ARO:3002505|PDC-6	ATGCGCGATACCAGATTCCCCTGCCTGTGCGGCATCGCCGCTTCCACACTGCTG...TGA	1194.0	35513	36652	1139	1194	ATGCGCGATACCAGATTCCCCTGCCTGTGCGGCATCGCCGCTTCCACACTGCTGTTCGCCACCACCCCGGCCATTGCCGATGAGGCCCCGGCGGATCGCCTGAAGGCACTGGTCGACGCCGCCGTACAACCGGTGATGAAGGCCAATGACATTCCGGGCCTGGCCGTAGCCATCAGCCTGAAAGGAGAACCGCATTACTTCAGCTATGGGCTGGCCTCGAAAGAGGACGGCCGCCGGGTGACGCCGGAGACCCTGTTCGAGATCGGCTCGGTGAGCAAGACCTTCACCGTCACCCTCGCCGGCTATGCCCTGGCCCAGGACAAGATGCGCCTCGACGACCGCGCCAGCCAGCACTGGCCGGCACTGCAGGGCAGCCGCTTCGACGGCATCAGCCTGCTCGACCTCGCGACCTATACCGCCGGCGGCTTGCCGCTGCAGTTCCCCGACTCGGTGCAGAAGGACCAGGCACAGATCCGCGACTACTACCGCCAGTGGCAGCCGACCTACGCGCCGGGCAGCCAGCGCCTCTATTCCAACCCGAGCATCGGCCTGTTCGGCTATCTCGCCGCGCGCAGCCTGGGCCAGCCGTTCGAACGGCTCATGGAGCAGCAATTGTTCCCGGCACTGGGCCTCGAACAGACCCACCTCGACGTGCCCGAGGCGGCGCTGGCGCAGTACGCCCAGGGCTACGGCAAGGACGACCGCCCGCTACGGGTCGGTCCCGGCCCGCTGGATGCCGAAGGCTACGGGGTGAAGACCAGCGCGGCCGACCTGCTGCGCTTCGTCGATGCCAACCTGCATCCGGAGCGCCTGGACAGGCCCTGGGCGCAGGCGCTCGATGCCACCCATCGCGGTTACTACAAGGTCGGCGACATGACCCAGGGCCTGGGCTGGGAAGCCTACGACTGGCCGATCTCCCTGAAGCGCCTGCAGGCCGGCAACTCGACGCCGATGGCGCTGCAACCACACAGGATCGCCAGGCTGCCCGCGCCACAGGCGCTGGAGGGCCAGCGCCTGCTGAACAAGACCGGCTCCACCAACGGCTTCGGCGCCTACGTGGCGTTCGTCCCGGGCCGCGACCTGGGCCTGGTGATCCTGGCCAACCGCAACTATCCCAATGCCGAGCGGGTGAAGATCGC
120	gb|AF226622|+|54-915|ARO:3001073|SHV-14	ATGCGTTATTTTCGCCTGTGTATTATCTCCCTGTTAGCCACCCTGCCGCTGGCG...TAA	861.0	16	822	806	861	ATGCGTTATATTCGCCTGTGTATTATCACCCTGTGAGCCACCCTGCCGCTGGCGGTACACGCCAGCCCGCAGCCGCTTGAGCAAATTAAACAAAGCGAAAGCCAGCTGTCGGGCCGCGTAGGCATGATAGAAATGGATCTGGCCAGCGGCCGCACGCTGACCGCCTGGCGCGCCGATGAACGCTTTCCCATGATGAGCACCTTTAAAGTAGTGCTCTGCGGCGCAGTGCTGGCGCGGGTGGATGCCGGTGACGAACAGCTGGAGCGAAAGATCCACTATCGCCAGCAGGATCTGGTGGACTACTCGCCGGTCAGCGAAAAACACCTTGCCGACGGCATGACGGTCGGCGAACTCTGCGCCGCCGCCATTACCATGAGCGATAACAGCGCCGCCAATCTGCTGCTGGCCACCGTCGGCGGCCCCGCAGGATTGACTGCCTTTTTGCGCCAGATCGGCGACAACGTCACCCGCCTTGACCGCTGGGAAACGGAACTGAATGAGGCGCTTCCCGGCGACGCCCGCGACACCACTACCCCGGCCAGCATGGCCGCGACCCTGCGCAAGCTGCTGACCAGCCAGCGTCTGAGCGCCCGTTCGCAACGGCAGCTGCTGCAGTGGATGGTGGACGATCGGGTCGCCGGACCGTTGATCCGCTCCGTGCTGCCGGCGGGCTGGTTTATCGCCGATAAGACCGGAGCTAGCAAGCGGGGTGCGCGCGGGATTGTCGCCCTGCTTGGCCCGAATAACAAAGCAGAGCGCATTGTGGTGATTTATCTGCGGGATACGCCGGCGAGCATGGCCGAGCG
121	gb|AY288523|+|0-825|ARO:3001671|OXA-49	ATGAATAAATATTTTACTTGCTATGTGGTTGCTTCTCTTTTTCTTTCTGGTTGT...TAA	825.0	80	847	767	825	ATGAATAAATATTTTACTTGCTATGTGGTTGCTTCTCTTTTTCTTTCTGGTTGTACGGTTCAGCATAATTTAATAAATGAAACCCCGAGTCAGATTGTTCAAGGACATAATCAGGTGATTCATCAATACTTTGATGAAAAAAACACCTCAGGTGTGCTGGTTATTCAAACAGATAAAAAAATTAATCTATATGGTAATGCTCTAAGCCGCGCAAATACAGAATATGTGCCAGCCTCTACATTTAAAATGTTGAATGCCCTGATCGGATTGGAGAACCAGAAAACGGATATTAATGAAATATTTAAATGGAAGGGCGAGAAAAGGTCATTTACCGCTTGGGAAAAAGACATGACACTAGGAGAAGCCATGAAGCTTTCTGCAGTCCCAGTCTATCAGGAACTTGCGCGACGTATCGGTCTTGATCTCATGCAAAAAGAAGTAAAACGTATTGGTTTCGGTAATGCTGAAATTGGACAGCAGGTTGATAATTTCTGGTTGGTAGGACCATTAAAGGTTACGCCTATTCAAGAGGTAGAGTTTGTTTCCCAATTAGCACATACACAGCTTCCATTTAGTGAAAAAGTGCAGGCTAATGTAAAAAATATGCTTCTTTTAGAAGAGAGTAATGGCTACAAAATTTTTGGAAAGACTGGTTGGGCAATGGATATAAAACCACAAGTGGGCTGGTTGACCGGCTGGGTTGAGCAGCCAGATGGAAAAATTGTCGCTTTTGCATTAAATATGGAAATGCGGTCAGAAATGCCGGC
122	gb|AF208796|+|0-861|ARO:3001083|SHV-25	ATGCGTTATATTCGCCTGTGTATTATCTCCCTGTTAGCCGCCCTGCCGCTGGCG...TAA	861.0	16	822	806	861	ATGCGTTATATTCGCCTGTGTATTATCACCCTGTGAGCCACCCTGCCGCTGGCGGTACACGCCAGCCCGCAGCCGCTTGAGCAAATTAAACAAAGCGAAAGCCAGCTGTCGGGCCGCGTAGGCATGATAGAAATGGATCTGGCCAGCGGCCGCACGCTGACCGCCTGGCGCGCCGATGAACGCTTTCCCATGATGAGCACCTTTAAAGTAGTGCTCTGCGGCGCAGTGCTGGCGCGGGTGGATGCCGGTGACGAACAGCTGGAGCGAAAGATCCACTATCGCCAGCAGGATCTGGTGGACTACTCGCCGGTCAGCGAAAAACACCTTGCCGACGGCATGACGGTCGGCGAACTCTGCGCCGCCGCCATTACCATGAGCGATAACAGCGCCGCCAATCTGCTGCTGGCCACCGTCGGCGGCCCCGCAGGATTGACTGCCTTTTTGCGCCAGATCGGCGACAACGTCACCCGCCTTGACCGCTGGGAAACGGAACTGAATGAGGCGCTTCCCGGCGACGCCCGCGACACCACTACCCCGGCCAGCATGGCCGCGACCCTGCGCAAGCTGCTGACCAGCCAGCGTCTGAGCGCCCGTTCGCAACGGCAGCTGCTGCAGTGGATGGTGGACGATCGGGTCGCCGGACCGTTGATCCGCTCCGTGCTGCCGGCGGGCTGGTTTATCGCCGATAAGACCGGAGCTAGCAAGCGGGGTGCGCGCGGGATTGTCGCCCTGCTTGGCCCGAATAACAAAGCAGAGCGCATTGTGGTGATTTATCTGCGGGATACGCCGGCGAGCATGGCCGAGCG
123	gb|AM176549|+|30-891|ARO:3001128|SHV-74	ATGCGTTATATTCGCCTGTGTATTATCTCCCTGTTAGCCACCCTGCCGCTGACG...TAA	861.0	16	822	806	861	ATGCGTTATATTCGCCTGTGTATTATCACCCTGTGAGCCACCCTGCCGCTGGCGGTACACGCCAGCCCGCAGCCGCTTGAGCAAATTAAACAAAGCGAAAGCCAGCTGTCGGGCCGCGTAGGCATGATAGAAATGGATCTGGCCAGCGGCCGCACGCTGACCGCCTGGCGCGCCGATGAACGCTTTCCCATGATGAGCACCTTTAAAGTAGTGCTCTGCGGCGCAGTGCTGGCGCGGGTGGATGCCGGTGACGAACAGCTGGAGCGAAAGATCCACTATCGCCAGCAGGATCTGGTGGACTACTCGCCGGTCAGCGAAAAACACCTTGCCGACGGCATGACGGTCGGCGAACTCTGCGCCGCCGCCATTACCATGAGCGATAACAGCGCCGCCAATCTGCTGCTGGCCACCGTCGGCGGCCCCGCAGGATTGACTGCCTTTTTGCGCCAGATCGGCGACAACGTCACCCGCCTTGACCGCTGGGAAACGGAACTGAATGAGGCGCTTCCCGGCGACGCCCGCGACACCACTACCCCGGCCAGCATGGCCGCGACCCTGCGCAAGCTGCTGACCAGCCAGCGTCTGAGCGCCCGTTCGCAACGGCAGCTGCTGCAGTGGATGGTGGACGATCGGGTCGCCGGACCGTTGATCCGCTCCGTGCTGCCGGCGGGCTGGTTTATCGCCGATAAGACCGGAGCTAGCAAGCGGGGTGCGCGCGGGATTGTCGCCCTGCTTGGCCCGAATAACAAAGCAGAGCGCATTGTGGTGATTTATCTGCGGGATACGCCGGCGAGCATGGCCGAGCG
124	gb|FJ872530|+|0-825|ARO:3002480|OXA-144	ATGAACATTAAAGCACTCTTACTTATAACAAGCGCTATTTTTATTTCAGCCTGC...TAG	825.0	54149	54919	770	825	ATGAACATTAAAGCACTCTTACTTATAACAAGCGCTATTTTTATTTCAGCCTGCTCACCTTATATAGTGACTGCTAATCCAAATCACAGCGCTTCAAAATCTGATGTAAAAGCAGAGAAAATTAAAAATTTATTTAACGAAGCACACACTACGGGTGTTTTAGTTATCCAACAAGGCCAAACTCAACAAAGCTATGGTAATGATCTTGCTCGTGCTTCGACCGAGTATGTACCTGCTTCGACCTTCAAAATGCTTAATGCTTTGATCGGCCTTGAGCACCATAAGGCAACCACCACAGAAGTATTTAAGTGGGATGGTAAAAAAAGGTTATTCCCAGAATGGGAAAAGGACATGACCCTAGGCGATGCCATGAAAGCTTCCGCTATTCCAGTTTATCAAGATTTAGCTCGTCGTATTGGACTTGAGCTCATGTCTAAGGAAGTGAAGCGTGTTGGTTATGGCAATGCAGATATCGGTACCCAAGTCGATAATTTTTGGCTGGTGGGTCCTTTAAAAATTACTCCTCAGCAAGAGGCACAGTTTGCTTACAAGCTAGCTAATAAAACGCTTCCATTTAGCCAAAAAGTCCAAGATGAAGTGCAATCCATGCTATTCATAGAAGAAAAGAATGGAAACAAAATATACGCAAAAAGTGGTTGGGGATGGGATGTAAACCCACAAGTAGGCTGGTTAACTGGATGGGTTGTTCAGCCTCAAGGGAATATTGTAGCGTTCTCCCTTAACTTAGAAATGAAAAAAGGAATACCTAG
125	gb|KF057030|+|0-825|ARO:3001684|OXA-313	ATGAACATTAAAGCCCTCTTACTTATAACAAGCGCTATTTTTATTTCAGCCTGC...TAG	825.0	54149	54919	770	825	ATGAACATTAAAGCACTCTTACTTATAACAAGCGCTATTTTTATTTCAGCCTGCTCACCTTATATAGTGACTGCTAATCCAAATCACAGCGCTTCAAAATCTGATGTAAAAGCAGAGAAAATTAAAAATTTATTTAACGAAGCACACACTACGGGTGTTTTAGTTATCCAACAAGGCCAAACTCAACAAAGCTATGGTAATGATCTTGCTCGTGCTTCGACCGAGTATGTACCTGCTTCGACCTTCAAAATGCTTAATGCTTTGATCGGCCTTGAGCACCATAAGGCAACCACCACAGAAGTATTTAAGTGGGATGGTAAAAAAAGGTTATTCCCAGAATGGGAAAAGGACATGACCCTAGGCGATGCCATGAAAGCTTCCGCTATTCCAGTTTATCAAGATTTAGCTCGTCGTATTGGACTTGAGCTCATGTCTAAGGAAGTGAAGCGTGTTGGTTATGGCAATGCAGATATCGGTACCCAAGTCGATAATTTTTGGCTGGTGGGTCCTTTAAAAATTACTCCTCAGCAAGAGGCACAGTTTGCTTACAAGCTAGCTAATAAAACGCTTCCATTTAGCCAAAAAGTCCAAGATGAAGTGCAATCCATGCTATTCATAGAAGAAAAGAATGGAAACAAAATATACGCAAAAAGTGGTTGGGGATGGGATGTAAACCCACAAGTAGGCTGGTTAACTGGATGGGTTGTTCAGCCTCAAGGGAATATTGTAGCGTTCTCCCTTAACTTAGAAATGAAAAAAGGAATACCTAG
126	gb|AY306130|+|0-789|ARO:3001796|OXA-50	ATGCGCCCTCTCCTCTTCAGTGCCCTTCTCCTGCTTTCCGGGCATACCCAGGCC...TGA	789.0	19143	19877	734	789	ATGCGCCCTCTCCTCTTCAGCGCCCTTCTCCTGCTCTCCGGGCATGCCCAGGCCAGCGAATGGAACGACAGCCGGGCCGTGGACAAGCTATTCGGAGCGGCCGGTGTGAAAGGCACCTTCGTCCTTTACGATGTGCAGCGGCAGCGCTATGTCGGCCATGACCGGGAGCGCGCGGAAACCCGCTTCGTTCCCGCTTCCACCTACAAGGTGGCGAACAGCCTGATCGGCTTATCCACAGGGGCGGTTAGATCCGCCGACGAGGTTCTTCCCTATGGCGGCAAACCCCAGCGCTTCAAGGCCTGGGAGCACGACATGAGCCTGCGCGACGCGATCAAGGCATCGAACGTACCGGTCTACCAGGAACTGGCGCGGCGCATCGGCCTGGAGCGGATGCGCGCCAATGTCTCGCGCCTGGGTTACGGCAACGCGGAAATCGGCCAGGTTGTGGATAACTTCTGGTTGGTGGGACCGCTGAAGATCAGCGCGATGGAACAGACCCGCTTTCTGCTCCGACTGGCGCAGGGAGAATTGCCATTCCCCGCCCCGGTGCAGTCCACCGTGCGCGCCATGACCCTGCTGGAAAGCGGCCCGGGCTGGGAGCTGCACGGCAAGACCGGCTGGTGCTTCGACTGCACGCCGGAACTCGGCTGGTGGGTGGGCTGGGTGAAGCGCAACGAGCGGCTCTACGGCTTCGCCCTGAACATCGACATGCCCGGCGGCGAGGCCGACATCGG
127	gb|GU591983.1|+|0-1152|ARO:3004615|ADC-11	ATGCGATTTAAAAAAATTTCTTGTCTACTTTTATCCCCGCTTTTTATTTTTAGT...TAA	1152.0	63	1160	1097	1152	ATGCGATTTAAAAAAATTTCTTGTCTACTTTTATCCCCGCTTTTTATTTTTAGTACCTCAATTTATGCGGGCAATACACCAAAAGACCAAGAAATTAAAAAACTGGTAGATCAAAACTTTAAACCGTTATTAGAAAAATATGATGTGCCAGGTATGGCTGTGGGTGTTATTCAAAATAATAAAAAGTATGAAATGTATTATGGTCTTCAATCTGTTCAAGATAAAAAAGCCGTAAATAGCAGTACTATTTTTGAGCTAGGTTCTGTCAGTAAATTATTTACCGCGACAGCAGGTGGATATGCAAAAAATAAAGGAAAAATCTCTTTTGACGATACGCCTGGTAAGTATTGGAAAGAACTAAAAAATACACCGATTGACCAAGTTAACTTACTTCAACTCGCGACGTATACAAGTGGTAACCTTGCCTTGCAATTTCCAGATGAAGTAAAAACAGATCAGCAAGTTTTAACATTTTTTAAAGACTGGAAACCTAAAAACTCAATCGGTGAATATCGACAATATTCAAACCCAAGCATTGGTTTATTTGGAAAAGTTGTAGCTTTGTCTATGAATAAACCTTTCGACCAAGTCTTAGAAAAAACAATTTTTCCGGCCCTTGGCTTAAAACATAGCTATGTAAATGTACCTAAGACCCAGATGCAAAACTATGCTTTTGGCTATAACCAAGAAAATCAGCCGATTCGAGTTAACCCCGGCCCACTCGATGCCCCAGCATATGGCGTCAAATCGACACTACCCGACATGTTGAGTTTTATTCATGCCAACCTAAATCCACAAAAATATCCAGCAGATATTCAACGGGCAATTAATGAAACACATCAGGGTCGCTATCAAGTAAATACCATGTATCAGGCACTCGGTTGGGAAGAGTTTTCTTATCCGGCAACGTTACAAACTTTATTAGACAGTAATTCAGAACAGATTGTGATGAAACCTAATAAAGTGACTGCTATTTCAAAGGAACCTTCAGTTAAGATGTACCATAAAACTGGCTCAACTACCGGTTTCGGAACATATGTGGTGTTTATTCCTAAAGAAAATATTGGTTTAGTCATGTTAACCAATAAACGTATTCC
128	gb|AM176550|+|30-891|ARO:3001129|SHV-75	ATGCGTTATATTCGCCTGTGTATTATCTCCCTGTTAGCCACCCTGCCGCTGGCG...TAA	861.0	16	822	806	861	ATGCGTTATATTCGCCTGTGTATTATCACCCTGTGAGCCACCCTGCCGCTGGCGGTACACGCCAGCCCGCAGCCGCTTGAGCAAATTAAACAAAGCGAAAGCCAGCTGTCGGGCCGCGTAGGCATGATAGAAATGGATCTGGCCAGCGGCCGCACGCTGACCGCCTGGCGCGCCGATGAACGCTTTCCCATGATGAGCACCTTTAAAGTAGTGCTCTGCGGCGCAGTGCTGGCGCGGGTGGATGCCGGTGACGAACAGCTGGAGCGAAAGATCCACTATCGCCAGCAGGATCTGGTGGACTACTCGCCGGTCAGCGAAAAACACCTTGCCGACGGCATGACGGTCGGCGAACTCTGCGCCGCCGCCATTACCATGAGCGATAACAGCGCCGCCAATCTGCTGCTGGCCACCGTCGGCGGCCCCGCAGGATTGACTGCCTTTTTGCGCCAGATCGGCGACAACGTCACCCGCCTTGACCGCTGGGAAACGGAACTGAATGAGGCGCTTCCCGGCGACGCCCGCGACACCACTACCCCGGCCAGCATGGCCGCGACCCTGCGCAAGCTGCTGACCAGCCAGCGTCTGAGCGCCCGTTCGCAACGGCAGCTGCTGCAGTGGATGGTGGACGATCGGGTCGCCGGACCGTTGATCCGCTCCGTGCTGCCGGCGGGCTGGTTTATCGCCGATAAGACCGGAGCTAGCAAGCGGGGTGCGCGCGGGATTGTCGCCCTGCTTGGCCCGAATAACAAAGCAGAGCGCATTGTGGTGATTTATCTGCGGGATACGCCGGCGAGCATGGCCGAGCG
129	gb|AF227204|+|73-934|ARO:3001084|SHV-26	ATGCGTTATATTCGCCTGTGTATTATCTCCCTGTTAGCCACCCTGCCGCTGGCG...TAA	861.0	16	822	806	861	ATGCGTTATATTCGCCTGTGTATTATCACCCTGTGAGCCACCCTGCCGCTGGCGGTACACGCCAGCCCGCAGCCGCTTGAGCAAATTAAACAAAGCGAAAGCCAGCTGTCGGGCCGCGTAGGCATGATAGAAATGGATCTGGCCAGCGGCCGCACGCTGACCGCCTGGCGCGCCGATGAACGCTTTCCCATGATGAGCACCTTTAAAGTAGTGCTCTGCGGCGCAGTGCTGGCGCGGGTGGATGCCGGTGACGAACAGCTGGAGCGAAAGATCCACTATCGCCAGCAGGATCTGGTGGACTACTCGCCGGTCAGCGAAAAACACCTTGCCGACGGCATGACGGTCGGCGAACTCTGCGCCGCCGCCATTACCATGAGCGATAACAGCGCCGCCAATCTGCTGCTGGCCACCGTCGGCGGCCCCGCAGGATTGACTGCCTTTTTGCGCCAGATCGGCGACAACGTCACCCGCCTTGACCGCTGGGAAACGGAACTGAATGAGGCGCTTCCCGGCGACGCCCGCGACACCACTACCCCGGCCAGCATGGCCGCGACCCTGCGCAAGCTGCTGACCAGCCAGCGTCTGAGCGCCCGTTCGCAACGGCAGCTGCTGCAGTGGATGGTGGACGATCGGGTCGCCGGACCGTTGATCCGCTCCGTGCTGCCGGCGGGCTGGTTTATCGCCGATAAGACCGGAGCTAGCAAGCGGGGTGCGCGCGGGATTGTCGCCCTGCTTGGCCCGAATAACAAAGCAGAGCGCATTGTGGTGATTTATCTGCGGGATACGCCGGCGAGCATGGCCGAGCG
130	gb|JN051143|+|0-861|ARO:3001182|SHV-140	AAGCGTTATATTCGCCTGTGTATTATCTCCCTGTTAGCCACCCTGCCGCTGGCG...TAA	861.0	18	822	804	861	GCGTTATATTCGCCTGTGTATTATCACCCTGTGAGCCACCCTGCCGCTGGCGGTACACGCCAGCCCGCAGCCGCTTGAGCAAATTAAACAAAGCGAAAGCCAGCTGTCGGGCCGCGTAGGCATGATAGAAATGGATCTGGCCAGCGGCCGCACGCTGACCGCCTGGCGCGCCGATGAACGCTTTCCCATGATGAGCACCTTTAAAGTAGTGCTCTGCGGCGCAGTGCTGGCGCGGGTGGATGCCGGTGACGAACAGCTGGAGCGAAAGATCCACTATCGCCAGCAGGATCTGGTGGACTACTCGCCGGTCAGCGAAAAACACCTTGCCGACGGCATGACGGTCGGCGAACTCTGCGCCGCCGCCATTACCATGAGCGATAACAGCGCCGCCAATCTGCTGCTGGCCACCGTCGGCGGCCCCGCAGGATTGACTGCCTTTTTGCGCCAGATCGGCGACAACGTCACCCGCCTTGACCGCTGGGAAACGGAACTGAATGAGGCGCTTCCCGGCGACGCCCGCGACACCACTACCCCGGCCAGCATGGCCGCGACCCTGCGCAAGCTGCTGACCAGCCAGCGTCTGAGCGCCCGTTCGCAACGGCAGCTGCTGCAGTGGATGGTGGACGATCGGGTCGCCGGACCGTTGATCCGCTCCGTGCTGCCGGCGGGCTGGTTTATCGCCGATAAGACCGGAGCTAGCAAGCGGGGTGCGCGCGGGATTGTCGCCCTGCTTGGCCCGAATAACAAAGCAGAGCGCATTGTGGTGATTTATCTGCGGGATACGCCGGCGAGCATGGCCGAGCG
131	gb|AM176551|+|30-891|ARO:3001130|SHV-76	ATGCGTTATATTCGCCTGTGTATTATCTCCCTGTTAGCCGCCCTGCCGCTGGCG...TAA	861.0	16	822	806	861	ATGCGTTATATTCGCCTGTGTATTATCACCCTGTGAGCCACCCTGCCGCTGGCGGTACACGCCAGCCCGCAGCCGCTTGAGCAAATTAAACAAAGCGAAAGCCAGCTGTCGGGCCGCGTAGGCATGATAGAAATGGATCTGGCCAGCGGCCGCACGCTGACCGCCTGGCGCGCCGATGAACGCTTTCCCATGATGAGCACCTTTAAAGTAGTGCTCTGCGGCGCAGTGCTGGCGCGGGTGGATGCCGGTGACGAACAGCTGGAGCGAAAGATCCACTATCGCCAGCAGGATCTGGTGGACTACTCGCCGGTCAGCGAAAAACACCTTGCCGACGGCATGACGGTCGGCGAACTCTGCGCCGCCGCCATTACCATGAGCGATAACAGCGCCGCCAATCTGCTGCTGGCCACCGTCGGCGGCCCCGCAGGATTGACTGCCTTTTTGCGCCAGATCGGCGACAACGTCACCCGCCTTGACCGCTGGGAAACGGAACTGAATGAGGCGCTTCCCGGCGACGCCCGCGACACCACTACCCCGGCCAGCATGGCCGCGACCCTGCGCAAGCTGCTGACCAGCCAGCGTCTGAGCGCCCGTTCGCAACGGCAGCTGCTGCAGTGGATGGTGGACGATCGGGTCGCCGGACCGTTGATCCGCTCCGTGCTGCCGGCGGGCTGGTTTATCGCCGATAAGACCGGAGCTAGCAAGCGGGGTGCGCGCGGGATTGTCGCCCTGCTTGGCCCGAATAACAAAGCAGAGCGCATTGTGGTGATTTATCTGCGGGATACGCCGGCGAGCATGGCCGAGCG
132	gb|AJ309734|+|0-825|ARO:3001612|OXA-51	ATGAACATTAAAACACTCTTACTTATAACAAGCGCTATTTTTATTTCAGCCTGC...TAG	825.0	54149	54919	770	825	ATGAACATTAAAGCACTCTTACTTATAACAAGCGCTATTTTTATTTCAGCCTGCTCACCTTATATAGTGACTGCTAATCCAAATCACAGCGCTTCAAAATCTGATGTAAAAGCAGAGAAAATTAAAAATTTATTTAACGAAGCACACACTACGGGTGTTTTAGTTATCCAACAAGGCCAAACTCAACAAAGCTATGGTAATGATCTTGCTCGTGCTTCGACCGAGTATGTACCTGCTTCGACCTTCAAAATGCTTAATGCTTTGATCGGCCTTGAGCACCATAAGGCAACCACCACAGAAGTATTTAAGTGGGATGGTAAAAAAAGGTTATTCCCAGAATGGGAAAAGGACATGACCCTAGGCGATGCCATGAAAGCTTCCGCTATTCCAGTTTATCAAGATTTAGCTCGTCGTATTGGACTTGAGCTCATGTCTAAGGAAGTGAAGCGTGTTGGTTATGGCAATGCAGATATCGGTACCCAAGTCGATAATTTTTGGCTGGTGGGTCCTTTAAAAATTACTCCTCAGCAAGAGGCACAGTTTGCTTACAAGCTAGCTAATAAAACGCTTCCATTTAGCCAAAAAGTCCAAGATGAAGTGCAATCCATGCTATTCATAGAAGAAAAGAATGGAAACAAAATATACGCAAAAAGTGGTTGGGGATGGGATGTAAACCCACAAGTAGGCTGGTTAACTGGATGGGTTGTTCAGCCTCAAGGGAATATTGTAGCGTTCTCCCTTAACTTAGAAATGAAAAAAGGAATACCTAG
133	gb|FJ790516|+|1287-2085|ARO:3001804|OXA-145	ATGAAAACATTTGCCGCATATGTAATTACTGCGTGTCTTTCAAGTACGGCATTA...TAA	798.0	659	1405	746	798	ATGAAAACATTTGCCGCATATGTAATTATCGCGTGTCTTTCGAGTACGGCATTAGCTGGTTCAATTACAGAAAATACGTCTTGGAACAAAGAGTTCTCTGCCGAAGCCGTCAATGGTGTCTTCGTGCTTTGTAAAAGTAGCAGTAAATCCTGCGCTACCAATGACTTAGCTCGTGCATCAAAGGAATATCTTCCAGCATCAACATTTAAGATCCCCAACGCAATTATCGGCCTAGAAACTGGTGTCATAAAGAATGAGCATCAGGTTTTCAAATGGGACGGAAAGCCAAGAGCCATGAAGCAATGGGAAAGAGACTTGACCTTAAGAGGGGCAATACAAGTTTCAGCTGTTCCCGTATTTCAACAAATCGCCAGAGAAGTTGGCGAAGTAAGAATGCAGAAATACCTTAAAAAATTTTCCTATGGCAACCAGAATATCAGTGGTGGCATTGACAAATTCTGGTTGGAAGGCCAGCTTAGAATTTCCGCAGTTAATCAAGTGGAGTTTCTAGAGTCTCTATATTTAAATAAATTGTCAGCATCTAAAGAAAACCAGCTAATAGTAAAAGAGGCTTTGGTAACGGAGGCGGCACCTGAATATCTAGTGCATTCAAAAACTGGTTTTTCTGGTGTGGGAACTGAGTCAAATCCTGGTGTCGCATGGTGGGTTGGGTGGGTTGAGAAGGAGACAGAGGTTTACTTTTTCGCCTTTAACATGGATATAGACAACGAAAGTAAGTTGCCGCT
134	gb|KF057031|+|0-825|ARO:3001685|OXA-314	ATGAACATTAAAGCACTCTTACTTATAACAAGCGCTATTTTTATTTCAGCCTGC...TAG	825.0	54149	54919	770	825	ATGAACATTAAAGCACTCTTACTTATAACAAGCGCTATTTTTATTTCAGCCTGCTCACCTTATATAGTGACTGCTAATCCAAATCACAGCGCTTCAAAATCTGATGTAAAAGCAGAGAAAATTAAAAATTTATTTAACGAAGCACACACTACGGGTGTTTTAGTTATCCAACAAGGCCAAACTCAACAAAGCTATGGTAATGATCTTGCTCGTGCTTCGACCGAGTATGTACCTGCTTCGACCTTCAAAATGCTTAATGCTTTGATCGGCCTTGAGCACCATAAGGCAACCACCACAGAAGTATTTAAGTGGGATGGTAAAAAAAGGTTATTCCCAGAATGGGAAAAGGACATGACCCTAGGCGATGCCATGAAAGCTTCCGCTATTCCAGTTTATCAAGATTTAGCTCGTCGTATTGGACTTGAGCTCATGTCTAAGGAAGTGAAGCGTGTTGGTTATGGCAATGCAGATATCGGTACCCAAGTCGATAATTTTTGGCTGGTGGGTCCTTTAAAAATTACTCCTCAGCAAGAGGCACAGTTTGCTTACAAGCTAGCTAATAAAACGCTTCCATTTAGCCAAAAAGTCCAAGATGAAGTGCAATCCATGCTATTCATAGAAGAAAAGAATGGAAACAAAATATACGCAAAAAGTGGTTGGGGATGGGATGTAAACCCACAAGTAGGCTGGTTAACTGGATGGGTTGTTCAGCCTCAAGGGAATATTGTAGCGTTCTCCCTTAACTTAGAAATGAAAAAAGGAATACCTAG
135	gb|JQ388884|+|0-861|ARO:3001183|SHV-141	ATGCGTTATATTCGCCTGTGTATTATCTCCCTGTTAGCCACCCTGCCGCTGGCG...TAA	861.0	16	822	806	861	ATGCGTTATATTCGCCTGTGTATTATCACCCTGTGAGCCACCCTGCCGCTGGCGGTACACGCCAGCCCGCAGCCGCTTGAGCAAATTAAACAAAGCGAAAGCCAGCTGTCGGGCCGCGTAGGCATGATAGAAATGGATCTGGCCAGCGGCCGCACGCTGACCGCCTGGCGCGCCGATGAACGCTTTCCCATGATGAGCACCTTTAAAGTAGTGCTCTGCGGCGCAGTGCTGGCGCGGGTGGATGCCGGTGACGAACAGCTGGAGCGAAAGATCCACTATCGCCAGCAGGATCTGGTGGACTACTCGCCGGTCAGCGAAAAACACCTTGCCGACGGCATGACGGTCGGCGAACTCTGCGCCGCCGCCATTACCATGAGCGATAACAGCGCCGCCAATCTGCTGCTGGCCACCGTCGGCGGCCCCGCAGGATTGACTGCCTTTTTGCGCCAGATCGGCGACAACGTCACCCGCCTTGACCGCTGGGAAACGGAACTGAATGAGGCGCTTCCCGGCGACGCCCGCGACACCACTACCCCGGCCAGCATGGCCGCGACCCTGCGCAAGCTGCTGACCAGCCAGCGTCTGAGCGCCCGTTCGCAACGGCAGCTGCTGCAGTGGATGGTGGACGATCGGGTCGCCGGACCGTTGATCCGCTCCGTGCTGCCGGCGGGCTGGTTTATCGCCGATAAGACCGGAGCTAGCAAGCGGGGTGCGCGCGGGATTGTCGCCCTGCTTGGCCCGAATAACAAAGCAGAGCGCATTGTGGTGATTTATCTGCGGGATACGCCGGCGAGCATGGCCGAGCG
136	gb|KJ949080.1|+|0-1194|ARO:3005038|PDC-65	ATGCGCGATACCAGATTCCCCTGCCTGTGCGGCATCGCCGCTTCCACACTGCTG...TGA	1194.0	35513	36652	1139	1194	ATGCGCGATACCAGATTCCCCTGCCTGTGCGGCATCGCCGCTTCCACACTGCTGTTCGCCACCACCCCGGCCATTGCCGATGAGGCCCCGGCGGATCGCCTGAAGGCACTGGTCGACGCCGCCGTACAACCGGTGATGAAGGCCAATGACATTCCGGGCCTGGCCGTAGCCATCAGCCTGAAAGGAGAACCGCATTACTTCAGCTATGGGCTGGCCTCGAAAGAGGACGGCCGCCGGGTGACGCCGGAGACCCTGTTCGAGATCGGCTCGGTGAGCAAGACCTTCACCGTCACCCTCGCCGGCTATGCCCTGGCCCAGGACAAGATGCGCCTCGACGACCGCGCCAGCCAGCACTGGCCGGCACTGCAGGGCAGCCGCTTCGACGGCATCAGCCTGCTCGACCTCGCGACCTATACCGCCGGCGGCTTGCCGCTGCAGTTCCCCGACTCGGTGCAGAAGGACCAGGCACAGATCCGCGACTACTACCGCCAGTGGCAGCCGACCTACGCGCCGGGCAGCCAGCGCCTCTATTCCAACCCGAGCATCGGCCTGTTCGGCTATCTCGCCGCGCGCAGCCTGGGCCAGCCGTTCGAACGGCTCATGGAGCAGCAATTGTTCCCGGCACTGGGCCTCGAACAGACCCACCTCGACGTGCCCGAGGCGGCGCTGGCGCAGTACGCCCAGGGCTACGGCAAGGACGACCGCCCGCTACGGGTCGGTCCCGGCCCGCTGGATGCCGAAGGCTACGGGGTGAAGACCAGCGCGGCCGACCTGCTGCGCTTCGTCGATGCCAACCTGCATCCGGAGCGCCTGGACAGGCCCTGGGCGCAGGCGCTCGATGCCACCCATCGCGGTTACTACAAGGTCGGCGACATGACCCAGGGCCTGGGCTGGGAAGCCTACGACTGGCCGATCTCCCTGAAGCGCCTGCAGGCCGGCAACTCGACGCCGATGGCGCTGCAACCACACAGGATCGCCAGGCTGCCCGCGCCACAGGCGCTGGAGGGCCAGCGCCTGCTGAACAAGACCGGCTCCACCAACGGCTTCGGCGCCTACGTGGCGTTCGTCCCGGGCCGCGACCTGGGCCTGGTGATCCTGGCCAACCGCAACTATCCCAATGCCGAGCGGGTGAAGATCGC
137	gb|FJ194494|+|171-996|ARO:3001779|OXA-146	ATGAATAAATATTTTACTTGCTATGTGGTTGCTTCTCTTTTTCTTTCTGGTTGT...TAA	825.0	80	847	767	825	ATGAATAAATATTTTACTTGCTATGTGGTTGCTTCTCTTTTTCTTTCTGGTTGTACGGTTCAGCATAATTTAATAAATGAAACCCCGAGTCAGATTGTTCAAGGACATAATCAGGTGATTCATCAATACTTTGATGAAAAAAACACCTCAGGTGTGCTGGTTATTCAAACAGATAAAAAAATTAATCTATATGGTAATGCTCTAAGCCGCGCAAATACAGAATATGTGCCAGCCTCTACATTTAAAATGTTGAATGCCCTGATCGGATTGGAGAACCAGAAAACGGATATTAATGAAATATTTAAATGGAAGGGCGAGAAAAGGTCATTTACCGCTTGGGAAAAAGACATGACACTAGGAGAAGCCATGAAGCTTTCTGCAGTCCCAGTCTATCAGGAACTTGCGCGACGTATCGGTCTTGATCTCATGCAAAAAGAAGTAAAACGTATTGGTTTCGGTAATGCTGAAATTGGACAGCAGGTTGATAATTTCTGGTTGGTAGGACCATTAAAGGTTACGCCTATTCAAGAGGTAGAGTTTGTTTCCCAATTAGCACATACACAGCTTCCATTTAGTGAAAAAGTGCAGGCTAATGTAAAAAATATGCTTCTTTTAGAAGAGAGTAATGGCTACAAAATTTTTGGAAAGACTGGTTGGGCAATGGATATAAAACCACAAGTGGGCTGGTTGACCGGCTGGGTTGAGCAGCCAGATGGAAAAATTGTCGCTTTTGCATTAAATATGGAAATGCGGTCAGAAATGCCGGC
138	gb|AF293345|+|0-861|ARO:3001085|SHV-27	ATGCGTTATATTCGCCTGTGTATTATCTCCCTGTTAGCCACCCTGCCGCTGGCG...TAA	861.0	16	822	806	861	ATGCGTTATATTCGCCTGTGTATTATCACCCTGTGAGCCACCCTGCCGCTGGCGGTACACGCCAGCCCGCAGCCGCTTGAGCAAATTAAACAAAGCGAAAGCCAGCTGTCGGGCCGCGTAGGCATGATAGAAATGGATCTGGCCAGCGGCCGCACGCTGACCGCCTGGCGCGCCGATGAACGCTTTCCCATGATGAGCACCTTTAAAGTAGTGCTCTGCGGCGCAGTGCTGGCGCGGGTGGATGCCGGTGACGAACAGCTGGAGCGAAAGATCCACTATCGCCAGCAGGATCTGGTGGACTACTCGCCGGTCAGCGAAAAACACCTTGCCGACGGCATGACGGTCGGCGAACTCTGCGCCGCCGCCATTACCATGAGCGATAACAGCGCCGCCAATCTGCTGCTGGCCACCGTCGGCGGCCCCGCAGGATTGACTGCCTTTTTGCGCCAGATCGGCGACAACGTCACCCGCCTTGACCGCTGGGAAACGGAACTGAATGAGGCGCTTCCCGGCGACGCCCGCGACACCACTACCCCGGCCAGCATGGCCGCGACCCTGCGCAAGCTGCTGACCAGCCAGCGTCTGAGCGCCCGTTCGCAACGGCAGCTGCTGCAGTGGATGGTGGACGATCGGGTCGCCGGACCGTTGATCCGCTCCGTGCTGCCGGCGGGCTGGTTTATCGCCGATAAGACCGGAGCTAGCAAGCGGGGTGCGCGCGGGATTGTCGCCCTGCTTGGCCCGAATAACAAAGCAGAGCGCATTGTGGTGATTTATCTGCGGGATACGCCGGCGAGCATGGCCGAGCG
139	gb|JQ029959|+|28-889|ARO:3001184|SHV-142	ATGCGTTATATTCGCCTGTGTATTATCTCCCTGTTAGCCGCCCTGCCGCTGGCG...TAA	861.0	16	822	806	861	ATGCGTTATATTCGCCTGTGTATTATCACCCTGTGAGCCACCCTGCCGCTGGCGGTACACGCCAGCCCGCAGCCGCTTGAGCAAATTAAACAAAGCGAAAGCCAGCTGTCGGGCCGCGTAGGCATGATAGAAATGGATCTGGCCAGCGGCCGCACGCTGACCGCCTGGCGCGCCGATGAACGCTTTCCCATGATGAGCACCTTTAAAGTAGTGCTCTGCGGCGCAGTGCTGGCGCGGGTGGATGCCGGTGACGAACAGCTGGAGCGAAAGATCCACTATCGCCAGCAGGATCTGGTGGACTACTCGCCGGTCAGCGAAAAACACCTTGCCGACGGCATGACGGTCGGCGAACTCTGCGCCGCCGCCATTACCATGAGCGATAACAGCGCCGCCAATCTGCTGCTGGCCACCGTCGGCGGCCCCGCAGGATTGACTGCCTTTTTGCGCCAGATCGGCGACAACGTCACCCGCCTTGACCGCTGGGAAACGGAACTGAATGAGGCGCTTCCCGGCGACGCCCGCGACACCACTACCCCGGCCAGCATGGCCGCGACCCTGCGCAAGCTGCTGACCAGCCAGCGTCTGAGCGCCCGTTCGCAACGGCAGCTGCTGCAGTGGATGGTGGACGATCGGGTCGCCGGACCGTTGATCCGCTCCGTGCTGCCGGCGGGCTGGTTTATCGCCGATAAGACCGGAGCTAGCAAGCGGGGTGCGCGCGGGATTGTCGCCCTGCTTGGCCCGAATAACAAAGCAGAGCGCATTGTGGTGATTTATCTGCGGGATACGCCGGCGAGCATGGCCGAGCG
140	gb|AY445080|+|0-801|ARO:3001795|OXA-56	ATGAAAACATTTGCCGCATATGTAATTACTGCGTGTCTTTCAAGTACGGCATTA...TAA	801.0	659	1405	746	801	ATGAAAACATTTGCCGCATATGTAATTATCGCGTGTCTTTCGAGTACGGCATTAGCTGGTTCAATTACAGAAAATACGTCTTGGAACAAAGAGTTCTCTGCCGAAGCCGTCAATGGTGTCTTCGTGCTTTGTAAAAGTAGCAGTAAATCCTGCGCTACCAATGACTTAGCTCGTGCATCAAAGGAATATCTTCCAGCATCAACATTTAAGATCCCCAACGCAATTATCGGCCTAGAAACTGGTGTCATAAAGAATGAGCATCAGGTTTTCAAATGGGACGGAAAGCCAAGAGCCATGAAGCAATGGGAAAGAGACTTGACCTTAAGAGGGGCAATACAAGTTTCAGCTGTTCCCGTATTTCAACAAATCGCCAGAGAAGTTGGCGAAGTAAGAATGCAGAAATACCTTAAAAAATTTTCCTATGGCAACCAGAATATCAGTGGTGGCATTGACAAATTCTGGTTGGAAGGCCAGCTTAGAATTTCCGCAGTTAATCAAGTGGAGTTTCTAGAGTCTCTATATTTAAATAAATTGTCAGCATCTAAAGAAAACCAGCTAATAGTAAAAGAGGCTTTGGTAACGGAGGCGGCACCTGAATATCTAGTGCATTCAAAAACTGGTTTTTCTGGTGTGGGAACTGAGTCAAATCCTGGTGTCGCATGGTGGGTTGGGTGGGTTGAGAAGGAGACAGAGGTTTACTTTTTCGCCTTTAACATGGATATAGACAACGAAAGTAAGTTGCCGCT
141	gb|FJ848783|+|1270-2071|ARO:3001801|OXA-147	ATGAAAACATTTGCCGCATATGTAATTACTGCGTGTCTTTCAAGTACGGCATTA...TAA	801.0	659	1405	746	801	ATGAAAACATTTGCCGCATATGTAATTATCGCGTGTCTTTCGAGTACGGCATTAGCTGGTTCAATTACAGAAAATACGTCTTGGAACAAAGAGTTCTCTGCCGAAGCCGTCAATGGTGTCTTCGTGCTTTGTAAAAGTAGCAGTAAATCCTGCGCTACCAATGACTTAGCTCGTGCATCAAAGGAATATCTTCCAGCATCAACATTTAAGATCCCCAACGCAATTATCGGCCTAGAAACTGGTGTCATAAAGAATGAGCATCAGGTTTTCAAATGGGACGGAAAGCCAAGAGCCATGAAGCAATGGGAAAGAGACTTGACCTTAAGAGGGGCAATACAAGTTTCAGCTGTTCCCGTATTTCAACAAATCGCCAGAGAAGTTGGCGAAGTAAGAATGCAGAAATACCTTAAAAAATTTTCCTATGGCAACCAGAATATCAGTGGTGGCATTGACAAATTCTGGTTGGAAGGCCAGCTTAGAATTTCCGCAGTTAATCAAGTGGAGTTTCTAGAGTCTCTATATTTAAATAAATTGTCAGCATCTAAAGAAAACCAGCTAATAGTAAAAGAGGCTTTGGTAACGGAGGCGGCACCTGAATATCTAGTGCATTCAAAAACTGGTTTTTCTGGTGTGGGAACTGAGTCAAATCCTGGTGTCGCATGGTGGGTTGGGTGGGTTGAGAAGGAGACAGAGGTTTACTTTTTCGCCTTTAACATGGATATAGACAACGAAAGTAAGTTGCCGCT
142	gb|AM176552|+|30-891|ARO:3001131|SHV-77	ATGCGTTATATTCGCCTGTGTATTATCTCCCTGTTAGCCACCCTGCCGCTGGCG...TAA	861.0	16	822	806	861	ATGCGTTATATTCGCCTGTGTATTATCACCCTGTGAGCCACCCTGCCGCTGGCGGTACACGCCAGCCCGCAGCCGCTTGAGCAAATTAAACAAAGCGAAAGCCAGCTGTCGGGCCGCGTAGGCATGATAGAAATGGATCTGGCCAGCGGCCGCACGCTGACCGCCTGGCGCGCCGATGAACGCTTTCCCATGATGAGCACCTTTAAAGTAGTGCTCTGCGGCGCAGTGCTGGCGCGGGTGGATGCCGGTGACGAACAGCTGGAGCGAAAGATCCACTATCGCCAGCAGGATCTGGTGGACTACTCGCCGGTCAGCGAAAAACACCTTGCCGACGGCATGACGGTCGGCGAACTCTGCGCCGCCGCCATTACCATGAGCGATAACAGCGCCGCCAATCTGCTGCTGGCCACCGTCGGCGGCCCCGCAGGATTGACTGCCTTTTTGCGCCAGATCGGCGACAACGTCACCCGCCTTGACCGCTGGGAAACGGAACTGAATGAGGCGCTTCCCGGCGACGCCCGCGACACCACTACCCCGGCCAGCATGGCCGCGACCCTGCGCAAGCTGCTGACCAGCCAGCGTCTGAGCGCCCGTTCGCAACGGCAGCTGCTGCAGTGGATGGTGGACGATCGGGTCGCCGGACCGTTGATCCGCTCCGTGCTGCCGGCGGGCTGGTTTATCGCCGATAAGACCGGAGCTAGCAAGCGGGGTGCGCGCGGGATTGTCGCCCTGCTTGGCCCGAATAACAAAGCAGAGCGCATTGTGGTGATTTATCTGCGGGATACGCCGGCGAGCATGGCCGAGCG
143	gb|MG229642.1|+|0-1152|ARO:3005037|ADC-159	ATGCGATTTAAAAAAATTTCTTGTCTACTTTTATCCCCGCTTTTTATTTTTAGT...TAA	1152.0	63	1160	1097	1152	ATGCGATTTAAAAAAATTTCTTGTCTACTTTTATCCCCGCTTTTTATTTTTAGTACCTCAATTTATGCGGGCAATACACCAAAAGACCAAGAAATTAAAAAACTGGTAGATCAAAACTTTAAACCGTTATTAGAAAAATATGATGTGCCAGGTATGGCTGTGGGTGTTATTCAAAATAATAAAAAGTATGAAATGTATTATGGTCTTCAATCTGTTCAAGATAAAAAAGCCGTAAATAGCAGTACTATTTTTGAGCTAGGTTCTGTCAGTAAATTATTTACCGCGACAGCAGGTGGATATGCAAAAAATAAAGGAAAAATCTCTTTTGACGATACGCCTGGTAAGTATTGGAAAGAACTAAAAAATACACCGATTGACCAAGTTAACTTACTTCAACTCGCGACGTATACAAGTGGTAACCTTGCCTTGCAATTTCCAGATGAAGTAAAAACAGATCAGCAAGTTTTAACATTTTTTAAAGACTGGAAACCTAAAAACTCAATCGGTGAATATCGACAATATTCAAACCCAAGCATTGGTTTATTTGGAAAAGTTGTAGCTTTGTCTATGAATAAACCTTTCGACCAAGTCTTAGAAAAAACAATTTTTCCGGCCCTTGGCTTAAAACATAGCTATGTAAATGTACCTAAGACCCAGATGCAAAACTATGCTTTTGGCTATAACCAAGAAAATCAGCCGATTCGAGTTAACCCCGGCCCACTCGATGCCCCAGCATATGGCGTCAAATCGACACTACCCGACATGTTGAGTTTTATTCATGCCAACCTAAATCCACAAAAATATCCAGCAGATATTCAACGGGCAATTAATGAAACACATCAGGGTCGCTATCAAGTAAATACCATGTATCAGGCACTCGGTTGGGAAGAGTTTTCTTATCCGGCAACGTTACAAACTTTATTAGACAGTAATTCAGAACAGATTGTGATGAAACCTAATAAAGTGACTGCTATTTCAAAGGAACCTTCAGTTAAGATGTACCATAAAACTGGCTCAACTACCGGTTTCGGAACATATGTGGTGTTTATTCCTAAAGAAAATATTGGTTTAGTCATGTTAACCAATAAACGTATTCC
144	gb|KF057032|+|0-825|ARO:3001686|OXA-315	ATGAACATTCAAGCACTCTTACTTATAACAAGCGCTATTTTTATTTCAGCCTGC...TAG	825.0	54149	54919	770	825	ATGAACATTAAAGCACTCTTACTTATAACAAGCGCTATTTTTATTTCAGCCTGCTCACCTTATATAGTGACTGCTAATCCAAATCACAGCGCTTCAAAATCTGATGTAAAAGCAGAGAAAATTAAAAATTTATTTAACGAAGCACACACTACGGGTGTTTTAGTTATCCAACAAGGCCAAACTCAACAAAGCTATGGTAATGATCTTGCTCGTGCTTCGACCGAGTATGTACCTGCTTCGACCTTCAAAATGCTTAATGCTTTGATCGGCCTTGAGCACCATAAGGCAACCACCACAGAAGTATTTAAGTGGGATGGTAAAAAAAGGTTATTCCCAGAATGGGAAAAGGACATGACCCTAGGCGATGCCATGAAAGCTTCCGCTATTCCAGTTTATCAAGATTTAGCTCGTCGTATTGGACTTGAGCTCATGTCTAAGGAAGTGAAGCGTGTTGGTTATGGCAATGCAGATATCGGTACCCAAGTCGATAATTTTTGGCTGGTGGGTCCTTTAAAAATTACTCCTCAGCAAGAGGCACAGTTTGCTTACAAGCTAGCTAATAAAACGCTTCCATTTAGCCAAAAAGTCCAAGATGAAGTGCAATCCATGCTATTCATAGAAGAAAAGAATGGAAACAAAATATACGCAAAAAGTGGTTGGGGATGGGATGTAAACCCACAAGTAGGCTGGTTAACTGGATGGGTTGTTCAGCCTCAAGGGAATATTGTAGCGTTCTCCCTTAACTTAGAAATGAAAAAAGGAATACCTAG
145	gb|AF299299|+|0-861|ARO:3001086|SHV-28	ATGCGTTTTATTCGCCTGTGTATTATCTCCCTGTTAGCCACCCTGCCGCTGGCG...TAA	861.0	16	822	806	861	ATGCGTTATATTCGCCTGTGTATTATCACCCTGTGAGCCACCCTGCCGCTGGCGGTACACGCCAGCCCGCAGCCGCTTGAGCAAATTAAACAAAGCGAAAGCCAGCTGTCGGGCCGCGTAGGCATGATAGAAATGGATCTGGCCAGCGGCCGCACGCTGACCGCCTGGCGCGCCGATGAACGCTTTCCCATGATGAGCACCTTTAAAGTAGTGCTCTGCGGCGCAGTGCTGGCGCGGGTGGATGCCGGTGACGAACAGCTGGAGCGAAAGATCCACTATCGCCAGCAGGATCTGGTGGACTACTCGCCGGTCAGCGAAAAACACCTTGCCGACGGCATGACGGTCGGCGAACTCTGCGCCGCCGCCATTACCATGAGCGATAACAGCGCCGCCAATCTGCTGCTGGCCACCGTCGGCGGCCCCGCAGGATTGACTGCCTTTTTGCGCCAGATCGGCGACAACGTCACCCGCCTTGACCGCTGGGAAACGGAACTGAATGAGGCGCTTCCCGGCGACGCCCGCGACACCACTACCCCGGCCAGCATGGCCGCGACCCTGCGCAAGCTGCTGACCAGCCAGCGTCTGAGCGCCCGTTCGCAACGGCAGCTGCTGCAGTGGATGGTGGACGATCGGGTCGCCGGACCGTTGATCCGCTCCGTGCTGCCGGCGGGCTGGTTTATCGCCGATAAGACCGGAGCTAGCAAGCGGGGTGCGCGCGGGATTGTCGCCCTGCTTGGCCCGAATAACAAAGCAGAGCGCATTGTGGTGATTTATCTGCGGGATACGCCGGCGAGCATGGCCGAGCG
146	gb|JQ341060.1|-|881-1742|ARO:3001344|SHV-143	ATGCGTTATATTCGCCTGTGTATTATCTCCCTGTTAGCCACCCTGCCGCTGGCG...TAA	861.0	16	822	806	861	ATGCGTTATATTCGCCTGTGTATTATCACCCTGTGAGCCACCCTGCCGCTGGCGGTACACGCCAGCCCGCAGCCGCTTGAGCAAATTAAACAAAGCGAAAGCCAGCTGTCGGGCCGCGTAGGCATGATAGAAATGGATCTGGCCAGCGGCCGCACGCTGACCGCCTGGCGCGCCGATGAACGCTTTCCCATGATGAGCACCTTTAAAGTAGTGCTCTGCGGCGCAGTGCTGGCGCGGGTGGATGCCGGTGACGAACAGCTGGAGCGAAAGATCCACTATCGCCAGCAGGATCTGGTGGACTACTCGCCGGTCAGCGAAAAACACCTTGCCGACGGCATGACGGTCGGCGAACTCTGCGCCGCCGCCATTACCATGAGCGATAACAGCGCCGCCAATCTGCTGCTGGCCACCGTCGGCGGCCCCGCAGGATTGACTGCCTTTTTGCGCCAGATCGGCGACAACGTCACCCGCCTTGACCGCTGGGAAACGGAACTGAATGAGGCGCTTCCCGGCGACGCCCGCGACACCACTACCCCGGCCAGCATGGCCGCGACCCTGCGCAAGCTGCTGACCAGCCAGCGTCTGAGCGCCCGTTCGCAACGGCAGCTGCTGCAGTGGATGGTGGACGATCGGGTCGCCGGACCGTTGATCCGCTCCGTGCTGCCGGCGGGCTGGTTTATCGCCGATAAGACCGGAGCTAGCAAGCGGGGTGCGCGCGGGATTGTCGCCCTGCTTGGCCCGAATAACAAAGCAGAGCGCATTGTGGTGATTTATCTGCGGGATACGCCGGCGAGCATGGCCGAGCG
147	gb|AY750907|+|0-825|ARO:3001613|OXA-64	ATGAACATTAAAGCACTCTTACTTATAACAAGCGCTATTTTTATTTCAGCCTGC...TAG	825.0	54149	54919	770	825	ATGAACATTAAAGCACTCTTACTTATAACAAGCGCTATTTTTATTTCAGCCTGCTCACCTTATATAGTGACTGCTAATCCAAATCACAGCGCTTCAAAATCTGATGTAAAAGCAGAGAAAATTAAAAATTTATTTAACGAAGCACACACTACGGGTGTTTTAGTTATCCAACAAGGCCAAACTCAACAAAGCTATGGTAATGATCTTGCTCGTGCTTCGACCGAGTATGTACCTGCTTCGACCTTCAAAATGCTTAATGCTTTGATCGGCCTTGAGCACCATAAGGCAACCACCACAGAAGTATTTAAGTGGGATGGTAAAAAAAGGTTATTCCCAGAATGGGAAAAGGACATGACCCTAGGCGATGCCATGAAAGCTTCCGCTATTCCAGTTTATCAAGATTTAGCTCGTCGTATTGGACTTGAGCTCATGTCTAAGGAAGTGAAGCGTGTTGGTTATGGCAATGCAGATATCGGTACCCAAGTCGATAATTTTTGGCTGGTGGGTCCTTTAAAAATTACTCCTCAGCAAGAGGCACAGTTTGCTTACAAGCTAGCTAATAAAACGCTTCCATTTAGCCAAAAAGTCCAAGATGAAGTGCAATCCATGCTATTCATAGAAGAAAAGAATGGAAACAAAATATACGCAAAAAGTGGTTGGGGATGGGATGTAAACCCACAAGTAGGCTGGTTAACTGGATGGGTTGTTCAGCCTCAAGGGAATATTGTAGCGTTCTCCCTTAACTTAGAAATGAAAAAAGGAATACCTAG
148	gb|GQ853679|+|0-825|ARO:3001453|OXA-148	ATGAACATTAAAGCACTCTTACTTATAACAAGCGCTATTTTTATTTCAGCCTGC...TAG	825.0	54149	54919	770	825	ATGAACATTAAAGCACTCTTACTTATAACAAGCGCTATTTTTATTTCAGCCTGCTCACCTTATATAGTGACTGCTAATCCAAATCACAGCGCTTCAAAATCTGATGTAAAAGCAGAGAAAATTAAAAATTTATTTAACGAAGCACACACTACGGGTGTTTTAGTTATCCAACAAGGCCAAACTCAACAAAGCTATGGTAATGATCTTGCTCGTGCTTCGACCGAGTATGTACCTGCTTCGACCTTCAAAATGCTTAATGCTTTGATCGGCCTTGAGCACCATAAGGCAACCACCACAGAAGTATTTAAGTGGGATGGTAAAAAAAGGTTATTCCCAGAATGGGAAAAGGACATGACCCTAGGCGATGCCATGAAAGCTTCCGCTATTCCAGTTTATCAAGATTTAGCTCGTCGTATTGGACTTGAGCTCATGTCTAAGGAAGTGAAGCGTGTTGGTTATGGCAATGCAGATATCGGTACCCAAGTCGATAATTTTTGGCTGGTGGGTCCTTTAAAAATTACTCCTCAGCAAGAGGCACAGTTTGCTTACAAGCTAGCTAATAAAACGCTTCCATTTAGCCAAAAAGTCCAAGATGAAGTGCAATCCATGCTATTCATAGAAGAAAAGAATGGAAACAAAATATACGCAAAAAGTGGTTGGGGATGGGATGTAAACCCACAAGTAGGCTGGTTAACTGGATGGGTTGTTCAGCCTCAAGGGAATATTGTAGCGTTCTCCCTTAACTTAGAAATGAAAAAAGGAATACCTAG
149	gb|AY750908|+|0-825|ARO:3001614|OXA-65	ATGAACATTAAAGCACTCTTACTTATAACAAGCGCTATTTTTATTTCAGCCTGC...TAG	825.0	54149	54919	770	825	ATGAACATTAAAGCACTCTTACTTATAACAAGCGCTATTTTTATTTCAGCCTGCTCACCTTATATAGTGACTGCTAATCCAAATCACAGCGCTTCAAAATCTGATGTAAAAGCAGAGAAAATTAAAAATTTATTTAACGAAGCACACACTACGGGTGTTTTAGTTATCCAACAAGGCCAAACTCAACAAAGCTATGGTAATGATCTTGCTCGTGCTTCGACCGAGTATGTACCTGCTTCGACCTTCAAAATGCTTAATGCTTTGATCGGCCTTGAGCACCATAAGGCAACCACCACAGAAGTATTTAAGTGGGATGGTAAAAAAAGGTTATTCCCAGAATGGGAAAAGGACATGACCCTAGGCGATGCCATGAAAGCTTCCGCTATTCCAGTTTATCAAGATTTAGCTCGTCGTATTGGACTTGAGCTCATGTCTAAGGAAGTGAAGCGTGTTGGTTATGGCAATGCAGATATCGGTACCCAAGTCGATAATTTTTGGCTGGTGGGTCCTTTAAAAATTACTCCTCAGCAAGAGGCACAGTTTGCTTACAAGCTAGCTAATAAAACGCTTCCATTTAGCCAAAAAGTCCAAGATGAAGTGCAATCCATGCTATTCATAGAAGAAAAGAATGGAAACAAAATATACGCAAAAAGTGGTTGGGGATGGGATGTAAACCCACAAGTAGGCTGGTTAACTGGATGGGTTGTTCAGCCTCAAGGGAATATTGTAGCGTTCTCCCTTAACTTAGAAATGAAAAAAGGAATACCTAG
150	gb|JQ926986|+|0-861|ARO:3001345|SHV-144	ATGCGTTATATTCGCCTGTGTATTATCTCCCTGTTAGCCACCCTGCCGCTGGCG...TAA	861.0	16	822	806	861	ATGCGTTATATTCGCCTGTGTATTATCACCCTGTGAGCCACCCTGCCGCTGGCGGTACACGCCAGCCCGCAGCCGCTTGAGCAAATTAAACAAAGCGAAAGCCAGCTGTCGGGCCGCGTAGGCATGATAGAAATGGATCTGGCCAGCGGCCGCACGCTGACCGCCTGGCGCGCCGATGAACGCTTTCCCATGATGAGCACCTTTAAAGTAGTGCTCTGCGGCGCAGTGCTGGCGCGGGTGGATGCCGGTGACGAACAGCTGGAGCGAAAGATCCACTATCGCCAGCAGGATCTGGTGGACTACTCGCCGGTCAGCGAAAAACACCTTGCCGACGGCATGACGGTCGGCGAACTCTGCGCCGCCGCCATTACCATGAGCGATAACAGCGCCGCCAATCTGCTGCTGGCCACCGTCGGCGGCCCCGCAGGATTGACTGCCTTTTTGCGCCAGATCGGCGACAACGTCACCCGCCTTGACCGCTGGGAAACGGAACTGAATGAGGCGCTTCCCGGCGACGCCCGCGACACCACTACCCCGGCCAGCATGGCCGCGACCCTGCGCAAGCTGCTGACCAGCCAGCGTCTGAGCGCCCGTTCGCAACGGCAGCTGCTGCAGTGGATGGTGGACGATCGGGTCGCCGGACCGTTGATCCGCTCCGTGCTGCCGGCGGGCTGGTTTATCGCCGATAAGACCGGAGCTAGCAAGCGGGGTGCGCGCGGGATTGTCGCCCTGCTTGGCCCGAATAACAAAGCAGAGCGCATTGTGGTGATTTATCTGCGGGATACGCCGGCGAGCATGGCCGAGCG
151	gb|AF301532|+|7-868|ARO:3001087|SHV-29	ATGCGTTATATTCGCCTGTGTATTATCTCCCTGTTAGCCACCCTGCCGCTGGCG...TAA	861.0	16	822	806	861	ATGCGTTATATTCGCCTGTGTATTATCACCCTGTGAGCCACCCTGCCGCTGGCGGTACACGCCAGCCCGCAGCCGCTTGAGCAAATTAAACAAAGCGAAAGCCAGCTGTCGGGCCGCGTAGGCATGATAGAAATGGATCTGGCCAGCGGCCGCACGCTGACCGCCTGGCGCGCCGATGAACGCTTTCCCATGATGAGCACCTTTAAAGTAGTGCTCTGCGGCGCAGTGCTGGCGCGGGTGGATGCCGGTGACGAACAGCTGGAGCGAAAGATCCACTATCGCCAGCAGGATCTGGTGGACTACTCGCCGGTCAGCGAAAAACACCTTGCCGACGGCATGACGGTCGGCGAACTCTGCGCCGCCGCCATTACCATGAGCGATAACAGCGCCGCCAATCTGCTGCTGGCCACCGTCGGCGGCCCCGCAGGATTGACTGCCTTTTTGCGCCAGATCGGCGACAACGTCACCCGCCTTGACCGCTGGGAAACGGAACTGAATGAGGCGCTTCCCGGCGACGCCCGCGACACCACTACCCCGGCCAGCATGGCCGCGACCCTGCGCAAGCTGCTGACCAGCCAGCGTCTGAGCGCCCGTTCGCAACGGCAGCTGCTGCAGTGGATGGTGGACGATCGGGTCGCCGGACCGTTGATCCGCTCCGTGCTGCCGGCGGGCTGGTTTATCGCCGATAAGACCGGAGCTAGCAAGCGGGGTGCGCGCGGGATTGTCGCCCTGCTTGGCCCGAATAACAAAGCAGAGCGCATTGTGGTGATTTATCTGCGGGATACGCCGGCGAGCATGGCCGAGCG
152	gb|EF016356.1|+|0-825|ARO:3001615|OXA-66	ATGAACATTAAAGCACTCTTACTTATAACAAGCGCTATTTTTATTTCAGCCTGC...TAG	825.0	54149	54919	770	825	ATGAACATTAAAGCACTCTTACTTATAACAAGCGCTATTTTTATTTCAGCCTGCTCACCTTATATAGTGACTGCTAATCCAAATCACAGCGCTTCAAAATCTGATGTAAAAGCAGAGAAAATTAAAAATTTATTTAACGAAGCACACACTACGGGTGTTTTAGTTATCCAACAAGGCCAAACTCAACAAAGCTATGGTAATGATCTTGCTCGTGCTTCGACCGAGTATGTACCTGCTTCGACCTTCAAAATGCTTAATGCTTTGATCGGCCTTGAGCACCATAAGGCAACCACCACAGAAGTATTTAAGTGGGATGGTAAAAAAAGGTTATTCCCAGAATGGGAAAAGGACATGACCCTAGGCGATGCCATGAAAGCTTCCGCTATTCCAGTTTATCAAGATTTAGCTCGTCGTATTGGACTTGAGCTCATGTCTAAGGAAGTGAAGCGTGTTGGTTATGGCAATGCAGATATCGGTACCCAAGTCGATAATTTTTGGCTGGTGGGTCCTTTAAAAATTACTCCTCAGCAAGAGGCACAGTTTGCTTACAAGCTAGCTAATAAAACGCTTCCATTTAGCCAAAAAGTCCAAGATGAAGTGCAATCCATGCTATTCATAGAAGAAAAGAATGGAAACAAAATATACGCAAAAAGTGGTTGGGGATGGGATGTAAACCCACAAGTAGGCTGGTTAACTGGATGGGTTGTTCAGCCTCAAGGGAATATTGTAGCGTTCTCCCTTAACTTAGAAATGAAAAAAGGAATACCTAG
153	gb|AM176553|+|30-891|ARO:3001132|SHV-78	ATGCGTTATATTCGCCTGTGTATTATCTCCCTGTTAGCCACCCTGCCGCTGGCG...TAA	861.0	16	822	806	861	ATGCGTTATATTCGCCTGTGTATTATCACCCTGTGAGCCACCCTGCCGCTGGCGGTACACGCCAGCCCGCAGCCGCTTGAGCAAATTAAACAAAGCGAAAGCCAGCTGTCGGGCCGCGTAGGCATGATAGAAATGGATCTGGCCAGCGGCCGCACGCTGACCGCCTGGCGCGCCGATGAACGCTTTCCCATGATGAGCACCTTTAAAGTAGTGCTCTGCGGCGCAGTGCTGGCGCGGGTGGATGCCGGTGACGAACAGCTGGAGCGAAAGATCCACTATCGCCAGCAGGATCTGGTGGACTACTCGCCGGTCAGCGAAAAACACCTTGCCGACGGCATGACGGTCGGCGAACTCTGCGCCGCCGCCATTACCATGAGCGATAACAGCGCCGCCAATCTGCTGCTGGCCACCGTCGGCGGCCCCGCAGGATTGACTGCCTTTTTGCGCCAGATCGGCGACAACGTCACCCGCCTTGACCGCTGGGAAACGGAACTGAATGAGGCGCTTCCCGGCGACGCCCGCGACACCACTACCCCGGCCAGCATGGCCGCGACCCTGCGCAAGCTGCTGACCAGCCAGCGTCTGAGCGCCCGTTCGCAACGGCAGCTGCTGCAGTGGATGGTGGACGATCGGGTCGCCGGACCGTTGATCCGCTCCGTGCTGCCGGCGGGCTGGTTTATCGCCGATAAGACCGGAGCTAGCAAGCGGGGTGCGCGCGGGATTGTCGCCCTGCTTGGCCCGAATAACAAAGCAGAGCGCATTGTGGTGATTTATCTGCGGGATACGCCGGCGAGCATGGCCGAGCG
154	gb|GQ853680|+|0-825|ARO:3001454|OXA-149	ATGAACATTAAAGCCCTCTTACTTATAACAAGCGCTATTTTTATTTCAGCCTGC...TAG	825.0	54149	54919	770	825	ATGAACATTAAAGCACTCTTACTTATAACAAGCGCTATTTTTATTTCAGCCTGCTCACCTTATATAGTGACTGCTAATCCAAATCACAGCGCTTCAAAATCTGATGTAAAAGCAGAGAAAATTAAAAATTTATTTAACGAAGCACACACTACGGGTGTTTTAGTTATCCAACAAGGCCAAACTCAACAAAGCTATGGTAATGATCTTGCTCGTGCTTCGACCGAGTATGTACCTGCTTCGACCTTCAAAATGCTTAATGCTTTGATCGGCCTTGAGCACCATAAGGCAACCACCACAGAAGTATTTAAGTGGGATGGTAAAAAAAGGTTATTCCCAGAATGGGAAAAGGACATGACCCTAGGCGATGCCATGAAAGCTTCCGCTATTCCAGTTTATCAAGATTTAGCTCGTCGTATTGGACTTGAGCTCATGTCTAAGGAAGTGAAGCGTGTTGGTTATGGCAATGCAGATATCGGTACCCAAGTCGATAATTTTTGGCTGGTGGGTCCTTTAAAAATTACTCCTCAGCAAGAGGCACAGTTTGCTTACAAGCTAGCTAATAAAACGCTTCCATTTAGCCAAAAAGTCCAAGATGAAGTGCAATCCATGCTATTCATAGAAGAAAAGAATGGAAACAAAATATACGCAAAAAGTGGTTGGGGATGGGATGTAAACCCACAAGTAGGCTGGTTAACTGGATGGGTTGTTCAGCCTCAAGGGAATATTGTAGCGTTCTCCCTTAACTTAGAAATGAAAAAAGGAATACCTAG
155	gb|KF057033|+|0-825|ARO:3001687|OXA-316	ATGAACATTCAAGCACTCTTACTTATAACAAGCGCTATTTTTATTTCAGCCTGC...TAG	825.0	54149	54919	770	825	ATGAACATTAAAGCACTCTTACTTATAACAAGCGCTATTTTTATTTCAGCCTGCTCACCTTATATAGTGACTGCTAATCCAAATCACAGCGCTTCAAAATCTGATGTAAAAGCAGAGAAAATTAAAAATTTATTTAACGAAGCACACACTACGGGTGTTTTAGTTATCCAACAAGGCCAAACTCAACAAAGCTATGGTAATGATCTTGCTCGTGCTTCGACCGAGTATGTACCTGCTTCGACCTTCAAAATGCTTAATGCTTTGATCGGCCTTGAGCACCATAAGGCAACCACCACAGAAGTATTTAAGTGGGATGGTAAAAAAAGGTTATTCCCAGAATGGGAAAAGGACATGACCCTAGGCGATGCCATGAAAGCTTCCGCTATTCCAGTTTATCAAGATTTAGCTCGTCGTATTGGACTTGAGCTCATGTCTAAGGAAGTGAAGCGTGTTGGTTATGGCAATGCAGATATCGGTACCCAAGTCGATAATTTTTGGCTGGTGGGTCCTTTAAAAATTACTCCTCAGCAAGAGGCACAGTTTGCTTACAAGCTAGCTAATAAAACGCTTCCATTTAGCCAAAAAGTCCAAGATGAAGTGCAATCCATGCTATTCATAGAAGAAAAGAATGGAAACAAAATATACGCAAAAAGTGGTTGGGGATGGGATGTAAACCCACAAGTAGGCTGGTTAACTGGATGGGTTGTTCAGCCTCAAGGGAATATTGTAGCGTTCTCCCTTAACTTAGAAATGAAAAAAGGAATACCTAG
156	gb|JX013655|+|0-861|ARO:3001185|SHV-145	ATGCGTTATATTCGCCTGTGTATTATCTCCCTGTTAGCCACCCTGCCGCTGGCG...TAA	861.0	16	822	806	861	ATGCGTTATATTCGCCTGTGTATTATCACCCTGTGAGCCACCCTGCCGCTGGCGGTACACGCCAGCCCGCAGCCGCTTGAGCAAATTAAACAAAGCGAAAGCCAGCTGTCGGGCCGCGTAGGCATGATAGAAATGGATCTGGCCAGCGGCCGCACGCTGACCGCCTGGCGCGCCGATGAACGCTTTCCCATGATGAGCACCTTTAAAGTAGTGCTCTGCGGCGCAGTGCTGGCGCGGGTGGATGCCGGTGACGAACAGCTGGAGCGAAAGATCCACTATCGCCAGCAGGATCTGGTGGACTACTCGCCGGTCAGCGAAAAACACCTTGCCGACGGCATGACGGTCGGCGAACTCTGCGCCGCCGCCATTACCATGAGCGATAACAGCGCCGCCAATCTGCTGCTGGCCACCGTCGGCGGCCCCGCAGGATTGACTGCCTTTTTGCGCCAGATCGGCGACAACGTCACCCGCCTTGACCGCTGGGAAACGGAACTGAATGAGGCGCTTCCCGGCGACGCCCGCGACACCACTACCCCGGCCAGCATGGCCGCGACCCTGCGCAAGCTGCTGACCAGCCAGCGTCTGAGCGCCCGTTCGCAACGGCAGCTGCTGCAGTGGATGGTGGACGATCGGGTCGCCGGACCGTTGATCCGCTCCGTGCTGCCGGCGGGCTGGTTTATCGCCGATAAGACCGGAGCTAGCAAGCGGGGTGCGCGCGGGATTGTCGCCCTGCTTGGCCCGAATAACAAAGCAGAGCGCATTGTGGTGATTTATCTGCGGGATACGCCGGCGAGCATGGCCGAGCG
157	gb|X98102|+|73-934|ARO:3001061|SHV-2A	ATGCGTTATATTCGCCTGTGTATTATCTCCCTGTTAGCCACCCTGCCGCTGGCG...TAA	861.0	16	822	806	861	ATGCGTTATATTCGCCTGTGTATTATCACCCTGTGAGCCACCCTGCCGCTGGCGGTACACGCCAGCCCGCAGCCGCTTGAGCAAATTAAACAAAGCGAAAGCCAGCTGTCGGGCCGCGTAGGCATGATAGAAATGGATCTGGCCAGCGGCCGCACGCTGACCGCCTGGCGCGCCGATGAACGCTTTCCCATGATGAGCACCTTTAAAGTAGTGCTCTGCGGCGCAGTGCTGGCGCGGGTGGATGCCGGTGACGAACAGCTGGAGCGAAAGATCCACTATCGCCAGCAGGATCTGGTGGACTACTCGCCGGTCAGCGAAAAACACCTTGCCGACGGCATGACGGTCGGCGAACTCTGCGCCGCCGCCATTACCATGAGCGATAACAGCGCCGCCAATCTGCTGCTGGCCACCGTCGGCGGCCCCGCAGGATTGACTGCCTTTTTGCGCCAGATCGGCGACAACGTCACCCGCCTTGACCGCTGGGAAACGGAACTGAATGAGGCGCTTCCCGGCGACGCCCGCGACACCACTACCCCGGCCAGCATGGCCGCGACCCTGCGCAAGCTGCTGACCAGCCAGCGTCTGAGCGCCCGTTCGCAACGGCAGCTGCTGCAGTGGATGGTGGACGATCGGGTCGCCGGACCGTTGATCCGCTCCGTGCTGCCGGCGGGCTGGTTTATCGCCGATAAGACCGGAGCTAGCAAGCGGGGTGCGCGCGGGATTGTCGCCCTGCTTGGCCCGAATAACAAAGCAGAGCGCATTGTGGTGATTTATCTGCGGGATACGCCGGCGAGCATGGCCGAGCG
158	gb|GQ853681|+|0-825|ARO:3001455|OXA-150	ATGAACATTAAAGCACTCTTACTTATAACAAGCGCTATTTTTATTTCAGCCTGC...TAG	825.0	54149	54919	770	825	ATGAACATTAAAGCACTCTTACTTATAACAAGCGCTATTTTTATTTCAGCCTGCTCACCTTATATAGTGACTGCTAATCCAAATCACAGCGCTTCAAAATCTGATGTAAAAGCAGAGAAAATTAAAAATTTATTTAACGAAGCACACACTACGGGTGTTTTAGTTATCCAACAAGGCCAAACTCAACAAAGCTATGGTAATGATCTTGCTCGTGCTTCGACCGAGTATGTACCTGCTTCGACCTTCAAAATGCTTAATGCTTTGATCGGCCTTGAGCACCATAAGGCAACCACCACAGAAGTATTTAAGTGGGATGGTAAAAAAAGGTTATTCCCAGAATGGGAAAAGGACATGACCCTAGGCGATGCCATGAAAGCTTCCGCTATTCCAGTTTATCAAGATTTAGCTCGTCGTATTGGACTTGAGCTCATGTCTAAGGAAGTGAAGCGTGTTGGTTATGGCAATGCAGATATCGGTACCCAAGTCGATAATTTTTGGCTGGTGGGTCCTTTAAAAATTACTCCTCAGCAAGAGGCACAGTTTGCTTACAAGCTAGCTAATAAAACGCTTCCATTTAGCCAAAAAGTCCAAGATGAAGTGCAATCCATGCTATTCATAGAAGAAAAGAATGGAAACAAAATATACGCAAAAAGTGGTTGGGGATGGGATGTAAACCCACAAGTAGGCTGGTTAACTGGATGGGTTGTTCAGCCTCAAGGGAATATTGTAGCGTTCTCCCTTAACTTAGAAATGAAAAAAGGAATACCTAG
159	gb|FJ666070|+|0-1194|ARO:3002506|PDC-7	ATGCGCGATACCAGATTCCCCTGCCTGTGCGGCATCGCCGCTTCCACACTGCTG...TGA	1194.0	35513	36652	1139	1194	ATGCGCGATACCAGATTCCCCTGCCTGTGCGGCATCGCCGCTTCCACACTGCTGTTCGCCACCACCCCGGCCATTGCCGATGAGGCCCCGGCGGATCGCCTGAAGGCACTGGTCGACGCCGCCGTACAACCGGTGATGAAGGCCAATGACATTCCGGGCCTGGCCGTAGCCATCAGCCTGAAAGGAGAACCGCATTACTTCAGCTATGGGCTGGCCTCGAAAGAGGACGGCCGCCGGGTGACGCCGGAGACCCTGTTCGAGATCGGCTCGGTGAGCAAGACCTTCACCGTCACCCTCGCCGGCTATGCCCTGGCCCAGGACAAGATGCGCCTCGACGACCGCGCCAGCCAGCACTGGCCGGCACTGCAGGGCAGCCGCTTCGACGGCATCAGCCTGCTCGACCTCGCGACCTATACCGCCGGCGGCTTGCCGCTGCAGTTCCCCGACTCGGTGCAGAAGGACCAGGCACAGATCCGCGACTACTACCGCCAGTGGCAGCCGACCTACGCGCCGGGCAGCCAGCGCCTCTATTCCAACCCGAGCATCGGCCTGTTCGGCTATCTCGCCGCGCGCAGCCTGGGCCAGCCGTTCGAACGGCTCATGGAGCAGCAATTGTTCCCGGCACTGGGCCTCGAACAGACCCACCTCGACGTGCCCGAGGCGGCGCTGGCGCAGTACGCCCAGGGCTACGGCAAGGACGACCGCCCGCTACGGGTCGGTCCCGGCCCGCTGGATGCCGAAGGCTACGGGGTGAAGACCAGCGCGGCCGACCTGCTGCGCTTCGTCGATGCCAACCTGCATCCGGAGCGCCTGGACAGGCCCTGGGCGCAGGCGCTCGATGCCACCCATCGCGGTTACTACAAGGTCGGCGACATGACCCAGGGCCTGGGCTGGGAAGCCTACGACTGGCCGATCTCCCTGAAGCGCCTGCAGGCCGGCAACTCGACGCCGATGGCGCTGCAACCACACAGGATCGCCAGGCTGCCCGCGCCACAGGCGCTGGAGGGCCAGCGCCTGCTGAACAAGACCGGCTCCACCAACGGCTTCGGCGCCTACGTGGCGTTCGTCCCGGGCCGCGACCTGGGCCTGGTGATCCTGGCCAACCGCAACTATCCCAATGCCGAGCGGGTGAAGATCGC
160	gb|JCMW02000002.1|-|55721-56522|ARO:3004489|OXA-663	ATGAAAACATTTGCCGCATATGTAATTATCGCGTGTCTTTCGAGTAAGGCATTA...TAA	801.0	659	1405	746	801	ATGAAAACATTTGCCGCATATGTAATTATCGCGTGTCTTTCGAGTACGGCATTAGCTGGTTCAATTACAGAAAATACGTCTTGGAACAAAGAGTTCTCTGCCGAAGCCGTCAATGGTGTCTTCGTGCTTTGTAAAAGTAGCAGTAAATCCTGCGCTACCAATGACTTAGCTCGTGCATCAAAGGAATATCTTCCAGCATCAACATTTAAGATCCCCAACGCAATTATCGGCCTAGAAACTGGTGTCATAAAGAATGAGCATCAGGTTTTCAAATGGGACGGAAAGCCAAGAGCCATGAAGCAATGGGAAAGAGACTTGACCTTAAGAGGGGCAATACAAGTTTCAGCTGTTCCCGTATTTCAACAAATCGCCAGAGAAGTTGGCGAAGTAAGAATGCAGAAATACCTTAAAAAATTTTCCTATGGCAACCAGAATATCAGTGGTGGCATTGACAAATTCTGGTTGGAAGGCCAGCTTAGAATTTCCGCAGTTAATCAAGTGGAGTTTCTAGAGTCTCTATATTTAAATAAATTGTCAGCATCTAAAGAAAACCAGCTAATAGTAAAAGAGGCTTTGGTAACGGAGGCGGCACCTGAATATCTAGTGCATTCAAAAACTGGTTTTTCTGGTGTGGGAACTGAGTCAAATCCTGGTGTCGCATGGTGGGTTGGGTGGGTTGAGAAGGAGACAGAGGTTTACTTTTTCGCCTTTAACATGGATATAGACAACGAAAGTAAGTTGCCGCT
161	gb|KF057034|+|0-825|ARO:3001688|OXA-317	ATGAACATTAAAGCACTCTTACTTATAACAAGCGCTATTTTTATTTCAGCCTGC...TAG	825.0	54149	54919	770	825	ATGAACATTAAAGCACTCTTACTTATAACAAGCGCTATTTTTATTTCAGCCTGCTCACCTTATATAGTGACTGCTAATCCAAATCACAGCGCTTCAAAATCTGATGTAAAAGCAGAGAAAATTAAAAATTTATTTAACGAAGCACACACTACGGGTGTTTTAGTTATCCAACAAGGCCAAACTCAACAAAGCTATGGTAATGATCTTGCTCGTGCTTCGACCGAGTATGTACCTGCTTCGACCTTCAAAATGCTTAATGCTTTGATCGGCCTTGAGCACCATAAGGCAACCACCACAGAAGTATTTAAGTGGGATGGTAAAAAAAGGTTATTCCCAGAATGGGAAAAGGACATGACCCTAGGCGATGCCATGAAAGCTTCCGCTATTCCAGTTTATCAAGATTTAGCTCGTCGTATTGGACTTGAGCTCATGTCTAAGGAAGTGAAGCGTGTTGGTTATGGCAATGCAGATATCGGTACCCAAGTCGATAATTTTTGGCTGGTGGGTCCTTTAAAAATTACTCCTCAGCAAGAGGCACAGTTTGCTTACAAGCTAGCTAATAAAACGCTTCCATTTAGCCAAAAAGTCCAAGATGAAGTGCAATCCATGCTATTCATAGAAGAAAAGAATGGAAACAAAATATACGCAAAAAGTGGTTGGGGATGGGATGTAAACCCACAAGTAGGCTGGTTAACTGGATGGGTTGTTCAGCCTCAAGGGAATATTGTAGCGTTCTCCCTTAACTTAGAAATGAAAAAAGGAATACCTAG
162	gb|JX121114|+|0-858|ARO:3001186|SHV-147	ATGCGTTATATTCGCCTGTGTATTATCTCCCTGTTAGCCACCCTGCCGCTGGCG...CGC	858.0	16	819	803	858	ATGCGTTATATTCGCCTGTGTATTATCACCCTGTGAGCCACCCTGCCGCTGGCGGTACACGCCAGCCCGCAGCCGCTTGAGCAAATTAAACAAAGCGAAAGCCAGCTGTCGGGCCGCGTAGGCATGATAGAAATGGATCTGGCCAGCGGCCGCACGCTGACCGCCTGGCGCGCCGATGAACGCTTTCCCATGATGAGCACCTTTAAAGTAGTGCTCTGCGGCGCAGTGCTGGCGCGGGTGGATGCCGGTGACGAACAGCTGGAGCGAAAGATCCACTATCGCCAGCAGGATCTGGTGGACTACTCGCCGGTCAGCGAAAAACACCTTGCCGACGGCATGACGGTCGGCGAACTCTGCGCCGCCGCCATTACCATGAGCGATAACAGCGCCGCCAATCTGCTGCTGGCCACCGTCGGCGGCCCCGCAGGATTGACTGCCTTTTTGCGCCAGATCGGCGACAACGTCACCCGCCTTGACCGCTGGGAAACGGAACTGAATGAGGCGCTTCCCGGCGACGCCCGCGACACCACTACCCCGGCCAGCATGGCCGCGACCCTGCGCAAGCTGCTGACCAGCCAGCGTCTGAGCGCCCGTTCGCAACGGCAGCTGCTGCAGTGGATGGTGGACGATCGGGTCGCCGGACCGTTGATCCGCTCCGTGCTGCCGGCGGGCTGGTTTATCGCCGATAAGACCGGAGCTAGCAAGCGGGGTGCGCGCGGGATTGTCGCCCTGCTTGGCCCGAATAACAAAGCAGAGCGCATTGTGGTGATTTATCTGCGGGATACGCCGGCGAGCATGGCCGA
163	gb|KX092356.1|+|192-1053|ARO:3001062|SHV-3	ATGCGTTATATTCGCCTGTGTATTATCTCCCTGTTAGCCACCCTGCCGCTGGCG...TAA	861.0	16	822	806	861	ATGCGTTATATTCGCCTGTGTATTATCACCCTGTGAGCCACCCTGCCGCTGGCGGTACACGCCAGCCCGCAGCCGCTTGAGCAAATTAAACAAAGCGAAAGCCAGCTGTCGGGCCGCGTAGGCATGATAGAAATGGATCTGGCCAGCGGCCGCACGCTGACCGCCTGGCGCGCCGATGAACGCTTTCCCATGATGAGCACCTTTAAAGTAGTGCTCTGCGGCGCAGTGCTGGCGCGGGTGGATGCCGGTGACGAACAGCTGGAGCGAAAGATCCACTATCGCCAGCAGGATCTGGTGGACTACTCGCCGGTCAGCGAAAAACACCTTGCCGACGGCATGACGGTCGGCGAACTCTGCGCCGCCGCCATTACCATGAGCGATAACAGCGCCGCCAATCTGCTGCTGGCCACCGTCGGCGGCCCCGCAGGATTGACTGCCTTTTTGCGCCAGATCGGCGACAACGTCACCCGCCTTGACCGCTGGGAAACGGAACTGAATGAGGCGCTTCCCGGCGACGCCCGCGACACCACTACCCCGGCCAGCATGGCCGCGACCCTGCGCAAGCTGCTGACCAGCCAGCGTCTGAGCGCCCGTTCGCAACGGCAGCTGCTGCAGTGGATGGTGGACGATCGGGTCGCCGGACCGTTGATCCGCTCCGTGCTGCCGGCGGGCTGGTTTATCGCCGATAAGACCGGAGCTAGCAAGCGGGGTGCGCGCGGGATTGTCGCCCTGCTTGGCCCGAATAACAAAGCAGAGCGCATTGTGGTGATTTATCTGCGGGATACGCCGGCGAGCATGGCCGAGCG
164	gb|JX121115|+|0-858|ARO:3001187|SHV-148	ATGCGTTATATTCGCCTGTGTATTATCTCCCTGTTAGCCACCCTGCCGCTGGCG...CAA	858.0	16	817	801	858	ATGCGTTATATTCGCCTGTGTATTATCACCCTGTGAGCCACCCTGCCGCTGGCGGTACACGCCAGCCCGCAGCCGCTTGAGCAAATTAAACAAAGCGAAAGCCAGCTGTCGGGCCGCGTAGGCATGATAGAAATGGATCTGGCCAGCGGCCGCACGCTGACCGCCTGGCGCGCCGATGAACGCTTTCCCATGATGAGCACCTTTAAAGTAGTGCTCTGCGGCGCAGTGCTGGCGCGGGTGGATGCCGGTGACGAACAGCTGGAGCGAAAGATCCACTATCGCCAGCAGGATCTGGTGGACTACTCGCCGGTCAGCGAAAAACACCTTGCCGACGGCATGACGGTCGGCGAACTCTGCGCCGCCGCCATTACCATGAGCGATAACAGCGCCGCCAATCTGCTGCTGGCCACCGTCGGCGGCCCCGCAGGATTGACTGCCTTTTTGCGCCAGATCGGCGACAACGTCACCCGCCTTGACCGCTGGGAAACGGAACTGAATGAGGCGCTTCCCGGCGACGCCCGCGACACCACTACCCCGGCCAGCATGGCCGCGACCCTGCGCAAGCTGCTGACCAGCCAGCGTCTGAGCGCCCGTTCGCAACGGCAGCTGCTGCAGTGGATGGTGGACGATCGGGTCGCCGGACCGTTGATCCGCTCCGTGCTGCCGGCGGGCTGGTTTATCGCCGATAAGACCGGAGCTAGCAAGCGGGGTGCGCGCGGGATTGTCGCCCTGCTTGGCCCGAATAACAAAGCAGAGCGCATTGTGGTGATTTATCTGCGGGATACGCCGGCGAGCATGGCC
165	gb|AF043100|+|0-775|ARO:3001411|OXA-16  Partial			685	1405	720	775	TATCGCGTGTCTTTCGAGTACGGCATTAGCTGGTTCAATTACAGAAAATACGTCTTGGAACAAAGAGTTCTCTGCCGAAGCCGTCAATGGTGTCTTCGTGCTTTGTAAAAGTAGCAGTAAATCCTGCGCTACCAATGACTTAGCTCGTGCATCAAAGGAATATCTTCCAGCATCAACATTTAAGATCCCCAACGCAATTATCGGCCTAGAAACTGGTGTCATAAAGAATGAGCATCAGGTTTTCAAATGGGACGGAAAGCCAAGAGCCATGAAGCAATGGGAAAGAGACTTGACCTTAAGAGGGGCAATACAAGTTTCAGCTGTTCCCGTATTTCAACAAATCGCCAGAGAAGTTGGCGAAGTAAGAATGCAGAAATACCTTAAAAAATTTTCCTATGGCAACCAGAATATCAGTGGTGGCATTGACAAATTCTGGTTGGAAGGCCAGCTTAGAATTTCCGCAGTTAATCAAGTGGAGTTTCTAGAGTCTCTATATTTAAATAAATTGTCAGCATCTAAAGAAAACCAGCTAATAGTAAAAGAGGCTTTGGTAACGGAGGCGGCACCTGAATATCTAGTGCATTCAAAAACTGGTTTTTCTGGTGTGGGAACTGAGTCAAATCCTGGTGTCGCATGGTGGGTTGGGTGGGTTGAGAAGGAGACAGAGGTTTACTTTTTCGCCTTTAACATGGATATAGACAACGAAAGTAAGTTGCCGCT
166	gb|AY661885|+|48-909|ARO:3001088|SHV-30	ATGCGTTATTTTCGCCTGTGTATTATCTCCCTGTTAGCCACCCTGCCGCTGGCG...TAA	861.0	16	822	806	861	ATGCGTTATATTCGCCTGTGTATTATCACCCTGTGAGCCACCCTGCCGCTGGCGGTACACGCCAGCCCGCAGCCGCTTGAGCAAATTAAACAAAGCGAAAGCCAGCTGTCGGGCCGCGTAGGCATGATAGAAATGGATCTGGCCAGCGGCCGCACGCTGACCGCCTGGCGCGCCGATGAACGCTTTCCCATGATGAGCACCTTTAAAGTAGTGCTCTGCGGCGCAGTGCTGGCGCGGGTGGATGCCGGTGACGAACAGCTGGAGCGAAAGATCCACTATCGCCAGCAGGATCTGGTGGACTACTCGCCGGTCAGCGAAAAACACCTTGCCGACGGCATGACGGTCGGCGAACTCTGCGCCGCCGCCATTACCATGAGCGATAACAGCGCCGCCAATCTGCTGCTGGCCACCGTCGGCGGCCCCGCAGGATTGACTGCCTTTTTGCGCCAGATCGGCGACAACGTCACCCGCCTTGACCGCTGGGAAACGGAACTGAATGAGGCGCTTCCCGGCGACGCCCGCGACACCACTACCCCGGCCAGCATGGCCGCGACCCTGCGCAAGCTGCTGACCAGCCAGCGTCTGAGCGCCCGTTCGCAACGGCAGCTGCTGCAGTGGATGGTGGACGATCGGGTCGCCGGACCGTTGATCCGCTCCGTGCTGCCGGCGGGCTGGTTTATCGCCGATAAGACCGGAGCTAGCAAGCGGGGTGCGCGCGGGATTGTCGCCCTGCTTGGCCCGAATAACAAAGCAGAGCGCATTGTGGTGATTTATCTGCGGGATACGCCGGCGAGCATGGCCGAGCG
167	gb|AY177427.1|+|1141-2293|ARO:3003848|ADC-2	ATGCGATTTAAAAAAATTTCTTGTCTACTTTTATCTCCGCTTTTTATTTTTAGT...TAA	1152.0	63	1160	1097	1152	ATGCGATTTAAAAAAATTTCTTGTCTACTTTTATCCCCGCTTTTTATTTTTAGTACCTCAATTTATGCGGGCAATACACCAAAAGACCAAGAAATTAAAAAACTGGTAGATCAAAACTTTAAACCGTTATTAGAAAAATATGATGTGCCAGGTATGGCTGTGGGTGTTATTCAAAATAATAAAAAGTATGAAATGTATTATGGTCTTCAATCTGTTCAAGATAAAAAAGCCGTAAATAGCAGTACTATTTTTGAGCTAGGTTCTGTCAGTAAATTATTTACCGCGACAGCAGGTGGATATGCAAAAAATAAAGGAAAAATCTCTTTTGACGATACGCCTGGTAAGTATTGGAAAGAACTAAAAAATACACCGATTGACCAAGTTAACTTACTTCAACTCGCGACGTATACAAGTGGTAACCTTGCCTTGCAATTTCCAGATGAAGTAAAAACAGATCAGCAAGTTTTAACATTTTTTAAAGACTGGAAACCTAAAAACTCAATCGGTGAATATCGACAATATTCAAACCCAAGCATTGGTTTATTTGGAAAAGTTGTAGCTTTGTCTATGAATAAACCTTTCGACCAAGTCTTAGAAAAAACAATTTTTCCGGCCCTTGGCTTAAAACATAGCTATGTAAATGTACCTAAGACCCAGATGCAAAACTATGCTTTTGGCTATAACCAAGAAAATCAGCCGATTCGAGTTAACCCCGGCCCACTCGATGCCCCAGCATATGGCGTCAAATCGACACTACCCGACATGTTGAGTTTTATTCATGCCAACCTAAATCCACAAAAATATCCAGCAGATATTCAACGGGCAATTAATGAAACACATCAGGGTCGCTATCAAGTAAATACCATGTATCAGGCACTCGGTTGGGAAGAGTTTTCTTATCCGGCAACGTTACAAACTTTATTAGACAGTAATTCAGAACAGATTGTGATGAAACCTAATAAAGTGACTGCTATTTCAAAGGAACCTTCAGTTAAGATGTACCATAAAACTGGCTCAACTACCGGTTTCGGAACATATGTGGTGTTTATTCCTAAAGAAAATATTGGTTTAGTCATGTTAACCAATAAACGTATTCC
168	gb|JX121116|+|0-858|ARO:3001188|SHV-149	ATGCGTTATATTCGCCTGTGTATTATCTCCCTGTTAGCCACCCTGCCGCTGGCG...CGC	858.0	16	819	803	858	ATGCGTTATATTCGCCTGTGTATTATCACCCTGTGAGCCACCCTGCCGCTGGCGGTACACGCCAGCCCGCAGCCGCTTGAGCAAATTAAACAAAGCGAAAGCCAGCTGTCGGGCCGCGTAGGCATGATAGAAATGGATCTGGCCAGCGGCCGCACGCTGACCGCCTGGCGCGCCGATGAACGCTTTCCCATGATGAGCACCTTTAAAGTAGTGCTCTGCGGCGCAGTGCTGGCGCGGGTGGATGCCGGTGACGAACAGCTGGAGCGAAAGATCCACTATCGCCAGCAGGATCTGGTGGACTACTCGCCGGTCAGCGAAAAACACCTTGCCGACGGCATGACGGTCGGCGAACTCTGCGCCGCCGCCATTACCATGAGCGATAACAGCGCCGCCAATCTGCTGCTGGCCACCGTCGGCGGCCCCGCAGGATTGACTGCCTTTTTGCGCCAGATCGGCGACAACGTCACCCGCCTTGACCGCTGGGAAACGGAACTGAATGAGGCGCTTCCCGGCGACGCCCGCGACACCACTACCCCGGCCAGCATGGCCGCGACCCTGCGCAAGCTGCTGACCAGCCAGCGTCTGAGCGCCCGTTCGCAACGGCAGCTGCTGCAGTGGATGGTGGACGATCGGGTCGCCGGACCGTTGATCCGCTCCGTGCTGCCGGCGGGCTGGTTTATCGCCGATAAGACCGGAGCTAGCAAGCGGGGTGCGCGCGGGATTGTCGCCCTGCTTGGCCCGAATAACAAAGCAGAGCGCATTGTGGTGATTTATCTGCGGGATACGCCGGCGAGCATGGCCGA
169	gb|KF203108|+|0-825|ARO:3001522|OXA-334	ATGAAAACTGTACAGTTGTGCCTCATCGTCCTCATTACTACCTTCGGTTCCGCA...TAA	825.0	156	929	773	825	ATGAAAACTTTACAGTTGGGCCTCATCGTCCTCATTACTACCTTCGGTTCTGCATGTACCATAATAAGAAGCCCCTCCATAGAAACAGCTAAAAACCATGAGCAACAAAGTGCGCAGCAGCAGATCCAACAGGCCTTCGATCAACTCCAAACCACGGGGGTGATTGTCATAAAGGATAAGCATGGCTTACACAGCTACGGCAATGACTTGAGCCGTGCTCAGACACCCTATGTACCCGCCTCTACCTTTAAAATGCTGAATGCCTTAATCGGACTAGAACATGGTAAAGCAACCAGCACCGAGGTGTTTAAATGGGATGGTCAAAAGAACAGCTTCCCTGCTTGGGAAAAAGACATGACTTTAGGGCAAGCCATGCAAGCATCTGCCGTTCCTGTTTATCAGGAGCTAGCACGGCGCATTGGCCTAGATCTAATGCAAAAAGAAGTACAGCGCATTGGATATGGCAATCAACAGATTGGCACCGTTGTCGATAATTTTTGGTTAGTCGGTCCACTGCAAATTACGCCTGTTCAAGAAGTCCTTTTTGTAGAGAAGCTGGCCAATACGCAACTCGCTTTTAAGCCAGATGTGCAACATACCGTACAAGACATGCTGCTGATTGAACAAAAACCGAATTATAAACTCTACGCCAAATCTGGTTGGGGCATGGACCTAGAACCGCAAGTGGGCTGGTGGACAGGCTGGGTCGAAACAGCAACAGGTGAAAAAGTGTATTTTGCTTTGAATATGCATATGAAAACAGGAATTTCAGC
170	gb|AM176554|+|30-891|ARO:3001133|SHV-79	ATGCGTTATATTCGCCTGTGTATTATCTCCCTGTTAGCCACCCTGCCGCTGGCG...TAA	861.0	16	822	806	861	ATGCGTTATATTCGCCTGTGTATTATCACCCTGTGAGCCACCCTGCCGCTGGCGGTACACGCCAGCCCGCAGCCGCTTGAGCAAATTAAACAAAGCGAAAGCCAGCTGTCGGGCCGCGTAGGCATGATAGAAATGGATCTGGCCAGCGGCCGCACGCTGACCGCCTGGCGCGCCGATGAACGCTTTCCCATGATGAGCACCTTTAAAGTAGTGCTCTGCGGCGCAGTGCTGGCGCGGGTGGATGCCGGTGACGAACAGCTGGAGCGAAAGATCCACTATCGCCAGCAGGATCTGGTGGACTACTCGCCGGTCAGCGAAAAACACCTTGCCGACGGCATGACGGTCGGCGAACTCTGCGCCGCCGCCATTACCATGAGCGATAACAGCGCCGCCAATCTGCTGCTGGCCACCGTCGGCGGCCCCGCAGGATTGACTGCCTTTTTGCGCCAGATCGGCGACAACGTCACCCGCCTTGACCGCTGGGAAACGGAACTGAATGAGGCGCTTCCCGGCGACGCCCGCGACACCACTACCCCGGCCAGCATGGCCGCGACCCTGCGCAAGCTGCTGACCAGCCAGCGTCTGAGCGCCCGTTCGCAACGGCAGCTGCTGCAGTGGATGGTGGACGATCGGGTCGCCGGACCGTTGATCCGCTCCGTGCTGCCGGCGGGCTGGTTTATCGCCGATAAGACCGGAGCTAGCAAGCGGGGTGCGCGCGGGATTGTCGCCCTGCTTGGCCCGAATAACAAAGCAGAGCGCATTGTGGTGATTTATCTGCGGGATACGCCGGCGAGCATGGCCGAGCG
171	gb|HM488986|+|0-822|ARO:3001465|OXA-165	ATGAATAAATATTTTACTTGCTATGTGGTTGCTTCTCTTTTTCTTTCTGGTTGT...TAA	822.0	80	847	767	822	ATGAATAAATATTTTACTTGCTATGTGGTTGCTTCTCTTTTTCTTTCTGGTTGTACGGTTCAGCATAATTTAATAAATGAAACCCCGAGTCAGATTGTTCAAGGACATAATCAGGTGATTCATCAATACTTTGATGAAAAAAACACCTCAGGTGTGCTGGTTATTCAAACAGATAAAAAAATTAATCTATATGGTAATGCTCTAAGCCGCGCAAATACAGAATATGTGCCAGCCTCTACATTTAAAATGTTGAATGCCCTGATCGGATTGGAGAACCAGAAAACGGATATTAATGAAATATTTAAATGGAAGGGCGAGAAAAGGTCATTTACCGCTTGGGAAAAAGACATGACACTAGGAGAAGCCATGAAGCTTTCTGCAGTCCCAGTCTATCAGGAACTTGCGCGACGTATCGGTCTTGATCTCATGCAAAAAGAAGTAAAACGTATTGGTTTCGGTAATGCTGAAATTGGACAGCAGGTTGATAATTTCTGGTTGGTAGGACCATTAAAGGTTACGCCTATTCAAGAGGTAGAGTTTGTTTCCCAATTAGCACATACACAGCTTCCATTTAGTGAAAAAGTGCAGGCTAATGTAAAAAATATGCTTCTTTTAGAAGAGAGTAATGGCTACAAAATTTTTGGAAAGACTGGTTGGGCAATGGATATAAAACCACAAGTGGGCTGGTTGACCGGCTGGGTTGAGCAGCCAGATGGAAAAATTGTCGCTTTTGCATTAAATATGGAAATGCGGTCAGAAATGCCGGC
172	gb|AJ011428|+|0-861|ARO:3001074|SHV-15	ATGCGTTATATTCGCCTGTGTATTATCTCCCTGTTAGCCACCCTGCCGCTGGCG...TAA	861.0	16	822	806	861	ATGCGTTATATTCGCCTGTGTATTATCACCCTGTGAGCCACCCTGCCGCTGGCGGTACACGCCAGCCCGCAGCCGCTTGAGCAAATTAAACAAAGCGAAAGCCAGCTGTCGGGCCGCGTAGGCATGATAGAAATGGATCTGGCCAGCGGCCGCACGCTGACCGCCTGGCGCGCCGATGAACGCTTTCCCATGATGAGCACCTTTAAAGTAGTGCTCTGCGGCGCAGTGCTGGCGCGGGTGGATGCCGGTGACGAACAGCTGGAGCGAAAGATCCACTATCGCCAGCAGGATCTGGTGGACTACTCGCCGGTCAGCGAAAAACACCTTGCCGACGGCATGACGGTCGGCGAACTCTGCGCCGCCGCCATTACCATGAGCGATAACAGCGCCGCCAATCTGCTGCTGGCCACCGTCGGCGGCCCCGCAGGATTGACTGCCTTTTTGCGCCAGATCGGCGACAACGTCACCCGCCTTGACCGCTGGGAAACGGAACTGAATGAGGCGCTTCCCGGCGACGCCCGCGACACCACTACCCCGGCCAGCATGGCCGCGACCCTGCGCAAGCTGCTGACCAGCCAGCGTCTGAGCGCCCGTTCGCAACGGCAGCTGCTGCAGTGGATGGTGGACGATCGGGTCGCCGGACCGTTGATCCGCTCCGTGCTGCCGGCGGGCTGGTTTATCGCCGATAAGACCGGAGCTAGCAAGCGGGGTGCGCGCGGGATTGTCGCCCTGCTTGGCCCGAATAACAAAGCAGAGCGCATTGTGGTGATTTATCTGCGGGATACGCCGGCGAGCATGGCCGAGCG
173	gb|DQ491200|+|0-825|ARO:3001437|OXA-67	ATGAACATTAAAGCACTCTTACTTATAACAAGCACTATTTTTATTTCAGCCTGC...TAG	825.0	54149	54919	770	825	ATGAACATTAAAGCACTCTTACTTATAACAAGCGCTATTTTTATTTCAGCCTGCTCACCTTATATAGTGACTGCTAATCCAAATCACAGCGCTTCAAAATCTGATGTAAAAGCAGAGAAAATTAAAAATTTATTTAACGAAGCACACACTACGGGTGTTTTAGTTATCCAACAAGGCCAAACTCAACAAAGCTATGGTAATGATCTTGCTCGTGCTTCGACCGAGTATGTACCTGCTTCGACCTTCAAAATGCTTAATGCTTTGATCGGCCTTGAGCACCATAAGGCAACCACCACAGAAGTATTTAAGTGGGATGGTAAAAAAAGGTTATTCCCAGAATGGGAAAAGGACATGACCCTAGGCGATGCCATGAAAGCTTCCGCTATTCCAGTTTATCAAGATTTAGCTCGTCGTATTGGACTTGAGCTCATGTCTAAGGAAGTGAAGCGTGTTGGTTATGGCAATGCAGATATCGGTACCCAAGTCGATAATTTTTGGCTGGTGGGTCCTTTAAAAATTACTCCTCAGCAAGAGGCACAGTTTGCTTACAAGCTAGCTAATAAAACGCTTCCATTTAGCCAAAAAGTCCAAGATGAAGTGCAATCCATGCTATTCATAGAAGAAAAGAATGGAAACAAAATATACGCAAAAAGTGGTTGGGGATGGGATGTAAACCCACAAGTAGGCTGGTTAACTGGATGGGTTGTTCAGCCTCAAGGGAATATTGTAGCGTTCTCCCTTAACTTAGAAATGAAAAAAGGAATACCTAG
174	gb|KF048907.1|+|0-825|ARO:3001524|OXA-336	ATGAACATTAAAGCACTCTTACTTATAACAAGCGCTATTTTTATTTCAGCCTGC...TAG	825.0	54149	54919	770	825	ATGAACATTAAAGCACTCTTACTTATAACAAGCGCTATTTTTATTTCAGCCTGCTCACCTTATATAGTGACTGCTAATCCAAATCACAGCGCTTCAAAATCTGATGTAAAAGCAGAGAAAATTAAAAATTTATTTAACGAAGCACACACTACGGGTGTTTTAGTTATCCAACAAGGCCAAACTCAACAAAGCTATGGTAATGATCTTGCTCGTGCTTCGACCGAGTATGTACCTGCTTCGACCTTCAAAATGCTTAATGCTTTGATCGGCCTTGAGCACCATAAGGCAACCACCACAGAAGTATTTAAGTGGGATGGTAAAAAAAGGTTATTCCCAGAATGGGAAAAGGACATGACCCTAGGCGATGCCATGAAAGCTTCCGCTATTCCAGTTTATCAAGATTTAGCTCGTCGTATTGGACTTGAGCTCATGTCTAAGGAAGTGAAGCGTGTTGGTTATGGCAATGCAGATATCGGTACCCAAGTCGATAATTTTTGGCTGGTGGGTCCTTTAAAAATTACTCCTCAGCAAGAGGCACAGTTTGCTTACAAGCTAGCTAATAAAACGCTTCCATTTAGCCAAAAAGTCCAAGATGAAGTGCAATCCATGCTATTCATAGAAGAAAAGAATGGAAACAAAATATACGCAAAAAGTGGTTGGGGATGGGATGTAAACCCACAAGTAGGCTGGTTAACTGGATGGGTTGTTCAGCCTCAAGGGAATATTGTAGCGTTCTCCCTTAACTTAGAAATGAAAAAAGGAATACCTAG
175	gb|AY277255|+|66-927|ARO:3001089|SHV-31	ATGCGTTATATTCGCCTGTGTATTATCTCCCTGTTAGCCACCCTGCCGCTGGCG...TAA	861.0	16	822	806	861	ATGCGTTATATTCGCCTGTGTATTATCACCCTGTGAGCCACCCTGCCGCTGGCGGTACACGCCAGCCCGCAGCCGCTTGAGCAAATTAAACAAAGCGAAAGCCAGCTGTCGGGCCGCGTAGGCATGATAGAAATGGATCTGGCCAGCGGCCGCACGCTGACCGCCTGGCGCGCCGATGAACGCTTTCCCATGATGAGCACCTTTAAAGTAGTGCTCTGCGGCGCAGTGCTGGCGCGGGTGGATGCCGGTGACGAACAGCTGGAGCGAAAGATCCACTATCGCCAGCAGGATCTGGTGGACTACTCGCCGGTCAGCGAAAAACACCTTGCCGACGGCATGACGGTCGGCGAACTCTGCGCCGCCGCCATTACCATGAGCGATAACAGCGCCGCCAATCTGCTGCTGGCCACCGTCGGCGGCCCCGCAGGATTGACTGCCTTTTTGCGCCAGATCGGCGACAACGTCACCCGCCTTGACCGCTGGGAAACGGAACTGAATGAGGCGCTTCCCGGCGACGCCCGCGACACCACTACCCCGGCCAGCATGGCCGCGACCCTGCGCAAGCTGCTGACCAGCCAGCGTCTGAGCGCCCGTTCGCAACGGCAGCTGCTGCAGTGGATGGTGGACGATCGGGTCGCCGGACCGTTGATCCGCTCCGTGCTGCCGGCGGGCTGGTTTATCGCCGATAAGACCGGAGCTAGCAAGCGGGGTGCGCGCGGGATTGTCGCCCTGCTTGGCCCGAATAACAAAGCAGAGCGCATTGTGGTGATTTATCTGCGGGATACGCCGGCGAGCATGGCCGAGCG
176	gb|KR057742.1|+|0-1116|ARO:3004336|PDC-73	GGCGAGGCCCCGGCGGATCGCCTGAAGGCACTGGTCGACGCCGCCGTACAACCG...TGA	1116.0	35594	36652	1058	1116	GAGGCCCCGGCGGATCGCCTGAAGGCACTGGTCGACGCCGCCGTACAACCGGTGATGAAGGCCAATGACATTCCGGGCCTGGCCGTAGCCATCAGCCTGAAAGGAGAACCGCATTACTTCAGCTATGGGCTGGCCTCGAAAGAGGACGGCCGCCGGGTGACGCCGGAGACCCTGTTCGAGATCGGCTCGGTGAGCAAGACCTTCACCGTCACCCTCGCCGGCTATGCCCTGGCCCAGGACAAGATGCGCCTCGACGACCGCGCCAGCCAGCACTGGCCGGCACTGCAGGGCAGCCGCTTCGACGGCATCAGCCTGCTCGACCTCGCGACCTATACCGCCGGCGGCTTGCCGCTGCAGTTCCCCGACTCGGTGCAGAAGGACCAGGCACAGATCCGCGACTACTACCGCCAGTGGCAGCCGACCTACGCGCCGGGCAGCCAGCGCCTCTATTCCAACCCGAGCATCGGCCTGTTCGGCTATCTCGCCGCGCGCAGCCTGGGCCAGCCGTTCGAACGGCTCATGGAGCAGCAATTGTTCCCGGCACTGGGCCTCGAACAGACCCACCTCGACGTGCCCGAGGCGGCGCTGGCGCAGTACGCCCAGGGCTACGGCAAGGACGACCGCCCGCTACGGGTCGGTCCCGGCCCGCTGGATGCCGAAGGCTACGGGGTGAAGACCAGCGCGGCCGACCTGCTGCGCTTCGTCGATGCCAACCTGCATCCGGAGCGCCTGGACAGGCCCTGGGCGCAGGCGCTCGATGCCACCCATCGCGGTTACTACAAGGTCGGCGACATGACCCAGGGCCTGGGCTGGGAAGCCTACGACTGGCCGATCTCCCTGAAGCGCCTGCAGGCCGGCAACTCGACGCCGATGGCGCTGCAACCACACAGGATCGCCAGGCTGCCCGCGCCACAGGCGCTGGAGGGCCAGCGCCTGCTGAACAAGACCGGCTCCACCAACGGCTTCGGCGCCTACGTGGCGTTCGTCCCGGGCCGCGACCTGGGCCTGGTGATCCTGGCCAACCGCAACTATCCCAATGCCGAGCGGGTGAAGATCGC
177	gb|U92041|+|0-861|ARO:3001067|SHV-8	ATGCGTTATATTCGCCTGTGTATTATCTCCCTGTTAGCCACCCTGCCGCTGGCG...TAA	861.0	16	822	806	861	ATGCGTTATATTCGCCTGTGTATTATCACCCTGTGAGCCACCCTGCCGCTGGCGGTACACGCCAGCCCGCAGCCGCTTGAGCAAATTAAACAAAGCGAAAGCCAGCTGTCGGGCCGCGTAGGCATGATAGAAATGGATCTGGCCAGCGGCCGCACGCTGACCGCCTGGCGCGCCGATGAACGCTTTCCCATGATGAGCACCTTTAAAGTAGTGCTCTGCGGCGCAGTGCTGGCGCGGGTGGATGCCGGTGACGAACAGCTGGAGCGAAAGATCCACTATCGCCAGCAGGATCTGGTGGACTACTCGCCGGTCAGCGAAAAACACCTTGCCGACGGCATGACGGTCGGCGAACTCTGCGCCGCCGCCATTACCATGAGCGATAACAGCGCCGCCAATCTGCTGCTGGCCACCGTCGGCGGCCCCGCAGGATTGACTGCCTTTTTGCGCCAGATCGGCGACAACGTCACCCGCCTTGACCGCTGGGAAACGGAACTGAATGAGGCGCTTCCCGGCGACGCCCGCGACACCACTACCCCGGCCAGCATGGCCGCGACCCTGCGCAAGCTGCTGACCAGCCAGCGTCTGAGCGCCCGTTCGCAACGGCAGCTGCTGCAGTGGATGGTGGACGATCGGGTCGCCGGACCGTTGATCCGCTCCGTGCTGCCGGCGGGCTGGTTTATCGCCGATAAGACCGGAGCTAGCAAGCGGGGTGCGCGCGGGATTGTCGCCCTGCTTGGCCCGAATAACAAAGCAGAGCGCATTGTGGTGATTTATCTGCGGGATACGCCGGCGAGCATGGCCGAGCG
178	gb|HM488987|+|0-822|ARO:3001466|OXA-166	ATGAATAAATATTTTACTTGCTATGTGGTTGCTTCTCTTTTTCTTTCTGGTTGT...TAA	822.0	80	847	767	822	ATGAATAAATATTTTACTTGCTATGTGGTTGCTTCTCTTTTTCTTTCTGGTTGTACGGTTCAGCATAATTTAATAAATGAAACCCCGAGTCAGATTGTTCAAGGACATAATCAGGTGATTCATCAATACTTTGATGAAAAAAACACCTCAGGTGTGCTGGTTATTCAAACAGATAAAAAAATTAATCTATATGGTAATGCTCTAAGCCGCGCAAATACAGAATATGTGCCAGCCTCTACATTTAAAATGTTGAATGCCCTGATCGGATTGGAGAACCAGAAAACGGATATTAATGAAATATTTAAATGGAAGGGCGAGAAAAGGTCATTTACCGCTTGGGAAAAAGACATGACACTAGGAGAAGCCATGAAGCTTTCTGCAGTCCCAGTCTATCAGGAACTTGCGCGACGTATCGGTCTTGATCTCATGCAAAAAGAAGTAAAACGTATTGGTTTCGGTAATGCTGAAATTGGACAGCAGGTTGATAATTTCTGGTTGGTAGGACCATTAAAGGTTACGCCTATTCAAGAGGTAGAGTTTGTTTCCCAATTAGCACATACACAGCTTCCATTTAGTGAAAAAGTGCAGGCTAATGTAAAAAATATGCTTCTTTTAGAAGAGAGTAATGGCTACAAAATTTTTGGAAAGACTGGTTGGGCAATGGATATAAAACCACAAGTGGGCTGGTTGACCGGCTGGGTTGAGCAGCCAGATGGAAAAATTGTCGCTTTTGCATTAAATATGGAAATGCGGTCAGAAATGCCGGC
179	gb|AY750910|+|0-825|ARO:3001616|OXA-68	ATGAACATTAAAGCACTCTTACTTATAACAAGCGCTATTTTTATTTCAGCCTGC...TAG	825.0	54149	54919	770	825	ATGAACATTAAAGCACTCTTACTTATAACAAGCGCTATTTTTATTTCAGCCTGCTCACCTTATATAGTGACTGCTAATCCAAATCACAGCGCTTCAAAATCTGATGTAAAAGCAGAGAAAATTAAAAATTTATTTAACGAAGCACACACTACGGGTGTTTTAGTTATCCAACAAGGCCAAACTCAACAAAGCTATGGTAATGATCTTGCTCGTGCTTCGACCGAGTATGTACCTGCTTCGACCTTCAAAATGCTTAATGCTTTGATCGGCCTTGAGCACCATAAGGCAACCACCACAGAAGTATTTAAGTGGGATGGTAAAAAAAGGTTATTCCCAGAATGGGAAAAGGACATGACCCTAGGCGATGCCATGAAAGCTTCCGCTATTCCAGTTTATCAAGATTTAGCTCGTCGTATTGGACTTGAGCTCATGTCTAAGGAAGTGAAGCGTGTTGGTTATGGCAATGCAGATATCGGTACCCAAGTCGATAATTTTTGGCTGGTGGGTCCTTTAAAAATTACTCCTCAGCAAGAGGCACAGTTTGCTTACAAGCTAGCTAATAAAACGCTTCCATTTAGCCAAAAAGTCCAAGATGAAGTGCAATCCATGCTATTCATAGAAGAAAAGAATGGAAACAAAATATACGCAAAAAGTGGTTGGGGATGGGATGTAAACCCACAAGTAGGCTGGTTAACTGGATGGGTTGTTCAGCCTCAAGGGAATATTGTAGCGTTCTCCCTTAACTTAGAAATGAAAAAAGGAATACCTAG
180	gb|PYSX01000023.1|+|160178-161003|ARO:3001525|OXA-337	ATGAACATTACAGCACTCTTACTTATAACAAGCGCTATTTTTATTTCAGCCTGC...TAG	825.0	54149	54919	770	825	ATGAACATTAAAGCACTCTTACTTATAACAAGCGCTATTTTTATTTCAGCCTGCTCACCTTATATAGTGACTGCTAATCCAAATCACAGCGCTTCAAAATCTGATGTAAAAGCAGAGAAAATTAAAAATTTATTTAACGAAGCACACACTACGGGTGTTTTAGTTATCCAACAAGGCCAAACTCAACAAAGCTATGGTAATGATCTTGCTCGTGCTTCGACCGAGTATGTACCTGCTTCGACCTTCAAAATGCTTAATGCTTTGATCGGCCTTGAGCACCATAAGGCAACCACCACAGAAGTATTTAAGTGGGATGGTAAAAAAAGGTTATTCCCAGAATGGGAAAAGGACATGACCCTAGGCGATGCCATGAAAGCTTCCGCTATTCCAGTTTATCAAGATTTAGCTCGTCGTATTGGACTTGAGCTCATGTCTAAGGAAGTGAAGCGTGTTGGTTATGGCAATGCAGATATCGGTACCCAAGTCGATAATTTTTGGCTGGTGGGTCCTTTAAAAATTACTCCTCAGCAAGAGGCACAGTTTGCTTACAAGCTAGCTAATAAAACGCTTCCATTTAGCCAAAAAGTCCAAGATGAAGTGCAATCCATGCTATTCATAGAAGAAAAGAATGGAAACAAAATATACGCAAAAAGTGGTTGGGGATGGGATGTAAACCCACAAGTAGGCTGGTTAACTGGATGGGTTGTTCAGCCTCAAGGGAATATTGTAGCGTTCTCCCTTAACTTAGAAATGAAAAAAGGAATACCTAG
181	gb|AM176555|+|0-861|ARO:3001134|SHV-80	ATGCGTTATATTCGCCTGTGTATTATCTCCCTGTTAGCCACCCTGCCGCTGGCG...TAA	861.0	16	822	806	861	ATGCGTTATATTCGCCTGTGTATTATCACCCTGTGAGCCACCCTGCCGCTGGCGGTACACGCCAGCCCGCAGCCGCTTGAGCAAATTAAACAAAGCGAAAGCCAGCTGTCGGGCCGCGTAGGCATGATAGAAATGGATCTGGCCAGCGGCCGCACGCTGACCGCCTGGCGCGCCGATGAACGCTTTCCCATGATGAGCACCTTTAAAGTAGTGCTCTGCGGCGCAGTGCTGGCGCGGGTGGATGCCGGTGACGAACAGCTGGAGCGAAAGATCCACTATCGCCAGCAGGATCTGGTGGACTACTCGCCGGTCAGCGAAAAACACCTTGCCGACGGCATGACGGTCGGCGAACTCTGCGCCGCCGCCATTACCATGAGCGATAACAGCGCCGCCAATCTGCTGCTGGCCACCGTCGGCGGCCCCGCAGGATTGACTGCCTTTTTGCGCCAGATCGGCGACAACGTCACCCGCCTTGACCGCTGGGAAACGGAACTGAATGAGGCGCTTCCCGGCGACGCCCGCGACACCACTACCCCGGCCAGCATGGCCGCGACCCTGCGCAAGCTGCTGACCAGCCAGCGTCTGAGCGCCCGTTCGCAACGGCAGCTGCTGCAGTGGATGGTGGACGATCGGGTCGCCGGACCGTTGATCCGCTCCGTGCTGCCGGCGGGCTGGTTTATCGCCGATAAGACCGGAGCTAGCAAGCGGGGTGCGCGCGGGATTGTCGCCCTGCTTGGCCCGAATAACAAAGCAGAGCGCATTGTGGTGATTTATCTGCGGGATACGCCGGCGAGCATGGCCGAGCG
182	gb|JX121117|+|0-858|ARO:3001189|SHV-150	ATGCGTTATATTCGCCTGTGTATTATCTCCCTGTTAGCCACCCTGCCGCTGGCG...CGC	858.0	16	819	803	858	ATGCGTTATATTCGCCTGTGTATTATCACCCTGTGAGCCACCCTGCCGCTGGCGGTACACGCCAGCCCGCAGCCGCTTGAGCAAATTAAACAAAGCGAAAGCCAGCTGTCGGGCCGCGTAGGCATGATAGAAATGGATCTGGCCAGCGGCCGCACGCTGACCGCCTGGCGCGCCGATGAACGCTTTCCCATGATGAGCACCTTTAAAGTAGTGCTCTGCGGCGCAGTGCTGGCGCGGGTGGATGCCGGTGACGAACAGCTGGAGCGAAAGATCCACTATCGCCAGCAGGATCTGGTGGACTACTCGCCGGTCAGCGAAAAACACCTTGCCGACGGCATGACGGTCGGCGAACTCTGCGCCGCCGCCATTACCATGAGCGATAACAGCGCCGCCAATCTGCTGCTGGCCACCGTCGGCGGCCCCGCAGGATTGACTGCCTTTTTGCGCCAGATCGGCGACAACGTCACCCGCCTTGACCGCTGGGAAACGGAACTGAATGAGGCGCTTCCCGGCGACGCCCGCGACACCACTACCCCGGCCAGCATGGCCGCGACCCTGCGCAAGCTGCTGACCAGCCAGCGTCTGAGCGCCCGTTCGCAACGGCAGCTGCTGCAGTGGATGGTGGACGATCGGGTCGCCGGACCGTTGATCCGCTCCGTGCTGCCGGCGGGCTGGTTTATCGCCGATAAGACCGGAGCTAGCAAGCGGGGTGCGCGCGGGATTGTCGCCCTGCTTGGCCCGAATAACAAAGCAGAGCGCATTGTGGTGATTTATCTGCGGGATACGCCGGCGAGCATGGCCGA
183	gb|KF048909|+|0-825|ARO:3001526|OXA-338	ATGAATATTAAAGCACTCTTACTTATAACAAGCGCTATTTTTATTTCAGCCTGC...TAG	825.0	54149	54919	770	825	ATGAACATTAAAGCACTCTTACTTATAACAAGCGCTATTTTTATTTCAGCCTGCTCACCTTATATAGTGACTGCTAATCCAAATCACAGCGCTTCAAAATCTGATGTAAAAGCAGAGAAAATTAAAAATTTATTTAACGAAGCACACACTACGGGTGTTTTAGTTATCCAACAAGGCCAAACTCAACAAAGCTATGGTAATGATCTTGCTCGTGCTTCGACCGAGTATGTACCTGCTTCGACCTTCAAAATGCTTAATGCTTTGATCGGCCTTGAGCACCATAAGGCAACCACCACAGAAGTATTTAAGTGGGATGGTAAAAAAAGGTTATTCCCAGAATGGGAAAAGGACATGACCCTAGGCGATGCCATGAAAGCTTCCGCTATTCCAGTTTATCAAGATTTAGCTCGTCGTATTGGACTTGAGCTCATGTCTAAGGAAGTGAAGCGTGTTGGTTATGGCAATGCAGATATCGGTACCCAAGTCGATAATTTTTGGCTGGTGGGTCCTTTAAAAATTACTCCTCAGCAAGAGGCACAGTTTGCTTACAAGCTAGCTAATAAAACGCTTCCATTTAGCCAAAAAGTCCAAGATGAAGTGCAATCCATGCTATTCATAGAAGAAAAGAATGGAAACAAAATATACGCAAAAAGTGGTTGGGGATGGGATGTAAACCCACAAGTAGGCTGGTTAACTGGATGGGTTGTTCAGCCTCAAGGGAATATTGTAGCGTTCTCCCTTAACTTAGAAATGAAAAAAGGAATACCTAG
184	gb|CU459141.1|+|2175316-2176141|ARO:3001617|OXA-69	ATGAACATTAAAGCACTCTTACTTATAACAAGCGCTATTTTTATTTCAGCCTGC...TAG	825.0	54149	54919	770	825	ATGAACATTAAAGCACTCTTACTTATAACAAGCGCTATTTTTATTTCAGCCTGCTCACCTTATATAGTGACTGCTAATCCAAATCACAGCGCTTCAAAATCTGATGTAAAAGCAGAGAAAATTAAAAATTTATTTAACGAAGCACACACTACGGGTGTTTTAGTTATCCAACAAGGCCAAACTCAACAAAGCTATGGTAATGATCTTGCTCGTGCTTCGACCGAGTATGTACCTGCTTCGACCTTCAAAATGCTTAATGCTTTGATCGGCCTTGAGCACCATAAGGCAACCACCACAGAAGTATTTAAGTGGGATGGTAAAAAAAGGTTATTCCCAGAATGGGAAAAGGACATGACCCTAGGCGATGCCATGAAAGCTTCCGCTATTCCAGTTTATCAAGATTTAGCTCGTCGTATTGGACTTGAGCTCATGTCTAAGGAAGTGAAGCGTGTTGGTTATGGCAATGCAGATATCGGTACCCAAGTCGATAATTTTTGGCTGGTGGGTCCTTTAAAAATTACTCCTCAGCAAGAGGCACAGTTTGCTTACAAGCTAGCTAATAAAACGCTTCCATTTAGCCAAAAAGTCCAAGATGAAGTGCAATCCATGCTATTCATAGAAGAAAAGAATGGAAACAAAATATACGCAAAAAGTGGTTGGGGATGGGATGTAAACCCACAAGTAGGCTGGTTAACTGGATGGGTTGTTCAGCCTCAAGGGAATATTGTAGCGTTCTCCCTTAACTTAGAAATGAAAAAAGGAATACCTAG
185	gb|HM488988|+|0-822|ARO:3001467|OXA-167	ATGAATAAATATTTTACTTGCTATGTGGTTGCTTCTCTTTTTCTTTCTGGTTGT...TAA	822.0	80	847	767	822	ATGAATAAATATTTTACTTGCTATGTGGTTGCTTCTCTTTTTCTTTCTGGTTGTACGGTTCAGCATAATTTAATAAATGAAACCCCGAGTCAGATTGTTCAAGGACATAATCAGGTGATTCATCAATACTTTGATGAAAAAAACACCTCAGGTGTGCTGGTTATTCAAACAGATAAAAAAATTAATCTATATGGTAATGCTCTAAGCCGCGCAAATACAGAATATGTGCCAGCCTCTACATTTAAAATGTTGAATGCCCTGATCGGATTGGAGAACCAGAAAACGGATATTAATGAAATATTTAAATGGAAGGGCGAGAAAAGGTCATTTACCGCTTGGGAAAAAGACATGACACTAGGAGAAGCCATGAAGCTTTCTGCAGTCCCAGTCTATCAGGAACTTGCGCGACGTATCGGTCTTGATCTCATGCAAAAAGAAGTAAAACGTATTGGTTTCGGTAATGCTGAAATTGGACAGCAGGTTGATAATTTCTGGTTGGTAGGACCATTAAAGGTTACGCCTATTCAAGAGGTAGAGTTTGTTTCCCAATTAGCACATACACAGCTTCCATTTAGTGAAAAAGTGCAGGCTAATGTAAAAAATATGCTTCTTTTAGAAGAGAGTAATGGCTACAAAATTTTTGGAAAGACTGGTTGGGCAATGGATATAAAACCACAAGTGGGCTGGTTGACCGGCTGGGTTGAGCAGCCAGATGGAAAAATTGTCGCTTTTGCATTAAATATGGAAATGCGGTCAGAAATGCCGGC
186	gb|AY037778|+|91-952|ARO:3001090|SHV-32	ATGCGTTATATTCGCCTGTGTATTATCTCCCTGTTAGCCACCCTGCCGCTGGCG...TAA	861.0	16	822	806	861	ATGCGTTATATTCGCCTGTGTATTATCACCCTGTGAGCCACCCTGCCGCTGGCGGTACACGCCAGCCCGCAGCCGCTTGAGCAAATTAAACAAAGCGAAAGCCAGCTGTCGGGCCGCGTAGGCATGATAGAAATGGATCTGGCCAGCGGCCGCACGCTGACCGCCTGGCGCGCCGATGAACGCTTTCCCATGATGAGCACCTTTAAAGTAGTGCTCTGCGGCGCAGTGCTGGCGCGGGTGGATGCCGGTGACGAACAGCTGGAGCGAAAGATCCACTATCGCCAGCAGGATCTGGTGGACTACTCGCCGGTCAGCGAAAAACACCTTGCCGACGGCATGACGGTCGGCGAACTCTGCGCCGCCGCCATTACCATGAGCGATAACAGCGCCGCCAATCTGCTGCTGGCCACCGTCGGCGGCCCCGCAGGATTGACTGCCTTTTTGCGCCAGATCGGCGACAACGTCACCCGCCTTGACCGCTGGGAAACGGAACTGAATGAGGCGCTTCCCGGCGACGCCCGCGACACCACTACCCCGGCCAGCATGGCCGCGACCCTGCGCAAGCTGCTGACCAGCCAGCGTCTGAGCGCCCGTTCGCAACGGCAGCTGCTGCAGTGGATGGTGGACGATCGGGTCGCCGGACCGTTGATCCGCTCCGTGCTGCCGGCGGGCTGGTTTATCGCCGATAAGACCGGAGCTAGCAAGCGGGGTGCGCGCGGGATTGTCGCCCTGCTTGGCCCGAATAACAAAGCAGAGCGCATTGTGGTGATTTATCTGCGGGATACGCCGGCGAGCATGGCCGAGCG
187	gb|AM176556|+|25-886|ARO:3001135|SHV-81	ATGCGTTATATTCGCCTGTGTATTATCTCCCTGTTAGCCACCCTGCCGCTGGCG...TAA	861.0	16	822	806	861	ATGCGTTATATTCGCCTGTGTATTATCACCCTGTGAGCCACCCTGCCGCTGGCGGTACACGCCAGCCCGCAGCCGCTTGAGCAAATTAAACAAAGCGAAAGCCAGCTGTCGGGCCGCGTAGGCATGATAGAAATGGATCTGGCCAGCGGCCGCACGCTGACCGCCTGGCGCGCCGATGAACGCTTTCCCATGATGAGCACCTTTAAAGTAGTGCTCTGCGGCGCAGTGCTGGCGCGGGTGGATGCCGGTGACGAACAGCTGGAGCGAAAGATCCACTATCGCCAGCAGGATCTGGTGGACTACTCGCCGGTCAGCGAAAAACACCTTGCCGACGGCATGACGGTCGGCGAACTCTGCGCCGCCGCCATTACCATGAGCGATAACAGCGCCGCCAATCTGCTGCTGGCCACCGTCGGCGGCCCCGCAGGATTGACTGCCTTTTTGCGCCAGATCGGCGACAACGTCACCCGCCTTGACCGCTGGGAAACGGAACTGAATGAGGCGCTTCCCGGCGACGCCCGCGACACCACTACCCCGGCCAGCATGGCCGCGACCCTGCGCAAGCTGCTGACCAGCCAGCGTCTGAGCGCCCGTTCGCAACGGCAGCTGCTGCAGTGGATGGTGGACGATCGGGTCGCCGGACCGTTGATCCGCTCCGTGCTGCCGGCGGGCTGGTTTATCGCCGATAAGACCGGAGCTAGCAAGCGGGGTGCGCGCGGGATTGTCGCCCTGCTTGGCCCGAATAACAAAGCAGAGCGCATTGTGGTGATTTATCTGCGGGATACGCCGGCGAGCATGGCCGAGCG
188	gb|NG_051744.1|+|100-1294|ARO:3004337|PDC-74	ATGCGCGATACCAGATTCCCCTGCCTGTGCGGCATCGCCGCTTCCACACTGCTG...TGA	1194.0	35513	36652	1139	1194	ATGCGCGATACCAGATTCCCCTGCCTGTGCGGCATCGCCGCTTCCACACTGCTGTTCGCCACCACCCCGGCCATTGCCGATGAGGCCCCGGCGGATCGCCTGAAGGCACTGGTCGACGCCGCCGTACAACCGGTGATGAAGGCCAATGACATTCCGGGCCTGGCCGTAGCCATCAGCCTGAAAGGAGAACCGCATTACTTCAGCTATGGGCTGGCCTCGAAAGAGGACGGCCGCCGGGTGACGCCGGAGACCCTGTTCGAGATCGGCTCGGTGAGCAAGACCTTCACCGTCACCCTCGCCGGCTATGCCCTGGCCCAGGACAAGATGCGCCTCGACGACCGCGCCAGCCAGCACTGGCCGGCACTGCAGGGCAGCCGCTTCGACGGCATCAGCCTGCTCGACCTCGCGACCTATACCGCCGGCGGCTTGCCGCTGCAGTTCCCCGACTCGGTGCAGAAGGACCAGGCACAGATCCGCGACTACTACCGCCAGTGGCAGCCGACCTACGCGCCGGGCAGCCAGCGCCTCTATTCCAACCCGAGCATCGGCCTGTTCGGCTATCTCGCCGCGCGCAGCCTGGGCCAGCCGTTCGAACGGCTCATGGAGCAGCAATTGTTCCCGGCACTGGGCCTCGAACAGACCCACCTCGACGTGCCCGAGGCGGCGCTGGCGCAGTACGCCCAGGGCTACGGCAAGGACGACCGCCCGCTACGGGTCGGTCCCGGCCCGCTGGATGCCGAAGGCTACGGGGTGAAGACCAGCGCGGCCGACCTGCTGCGCTTCGTCGATGCCAACCTGCATCCGGAGCGCCTGGACAGGCCCTGGGCGCAGGCGCTCGATGCCACCCATCGCGGTTACTACAAGGTCGGCGACATGACCCAGGGCCTGGGCTGGGAAGCCTACGACTGGCCGATCTCCCTGAAGCGCCTGCAGGCCGGCAACTCGACGCCGATGGCGCTGCAACCACACAGGATCGCCAGGCTGCCCGCGCCACAGGCGCTGGAGGGCCAGCGCCTGCTGAACAAGACCGGCTCCACCAACGGCTTCGGCGCCTACGTGGCGTTCGTCCCGGGCCGCGACCTGGGCCTGGTGATCCTGGCCAACCGCAACTATCCCAATGCCGAGCGGGTGAAGATCGC
189	gb|EF016355.1|+|0-1152|ARO:3003868|ADC-25	ATGCGATTTAAAAAAATTTCTTGTCTACTTTTATCCCCGCTTTTTATTTTTAGT...TAA	1152.0	63	1160	1097	1152	ATGCGATTTAAAAAAATTTCTTGTCTACTTTTATCCCCGCTTTTTATTTTTAGTACCTCAATTTATGCGGGCAATACACCAAAAGACCAAGAAATTAAAAAACTGGTAGATCAAAACTTTAAACCGTTATTAGAAAAATATGATGTGCCAGGTATGGCTGTGGGTGTTATTCAAAATAATAAAAAGTATGAAATGTATTATGGTCTTCAATCTGTTCAAGATAAAAAAGCCGTAAATAGCAGTACTATTTTTGAGCTAGGTTCTGTCAGTAAATTATTTACCGCGACAGCAGGTGGATATGCAAAAAATAAAGGAAAAATCTCTTTTGACGATACGCCTGGTAAGTATTGGAAAGAACTAAAAAATACACCGATTGACCAAGTTAACTTACTTCAACTCGCGACGTATACAAGTGGTAACCTTGCCTTGCAATTTCCAGATGAAGTAAAAACAGATCAGCAAGTTTTAACATTTTTTAAAGACTGGAAACCTAAAAACTCAATCGGTGAATATCGACAATATTCAAACCCAAGCATTGGTTTATTTGGAAAAGTTGTAGCTTTGTCTATGAATAAACCTTTCGACCAAGTCTTAGAAAAAACAATTTTTCCGGCCCTTGGCTTAAAACATAGCTATGTAAATGTACCTAAGACCCAGATGCAAAACTATGCTTTTGGCTATAACCAAGAAAATCAGCCGATTCGAGTTAACCCCGGCCCACTCGATGCCCCAGCATATGGCGTCAAATCGACACTACCCGACATGTTGAGTTTTATTCATGCCAACCTAAATCCACAAAAATATCCAGCAGATATTCAACGGGCAATTAATGAAACACATCAGGGTCGCTATCAAGTAAATACCATGTATCAGGCACTCGGTTGGGAAGAGTTTTCTTATCCGGCAACGTTACAAACTTTATTAGACAGTAATTCAGAACAGATTGTGATGAAACCTAATAAAGTGACTGCTATTTCAAAGGAACCTTCAGTTAAGATGTACCATAAAACTGGCTCAACTACCGGTTTCGGAACATATGTGGTGTTTATTCCTAAAGAAAATATTGGTTTAGTCATGTTAACCAATAAACGTATTCC
190	gb|HM488989|+|0-822|ARO:3001468|OXA-168	ATGAATAAATATTTTACTTGCTATGTGGTTGCTTCTCTTTTTCTTTCTGGTTGT...TAA	822.0	80	847	767	822	ATGAATAAATATTTTACTTGCTATGTGGTTGCTTCTCTTTTTCTTTCTGGTTGTACGGTTCAGCATAATTTAATAAATGAAACCCCGAGTCAGATTGTTCAAGGACATAATCAGGTGATTCATCAATACTTTGATGAAAAAAACACCTCAGGTGTGCTGGTTATTCAAACAGATAAAAAAATTAATCTATATGGTAATGCTCTAAGCCGCGCAAATACAGAATATGTGCCAGCCTCTACATTTAAAATGTTGAATGCCCTGATCGGATTGGAGAACCAGAAAACGGATATTAATGAAATATTTAAATGGAAGGGCGAGAAAAGGTCATTTACCGCTTGGGAAAAAGACATGACACTAGGAGAAGCCATGAAGCTTTCTGCAGTCCCAGTCTATCAGGAACTTGCGCGACGTATCGGTCTTGATCTCATGCAAAAAGAAGTAAAACGTATTGGTTTCGGTAATGCTGAAATTGGACAGCAGGTTGATAATTTCTGGTTGGTAGGACCATTAAAGGTTACGCCTATTCAAGAGGTAGAGTTTGTTTCCCAATTAGCACATACACAGCTTCCATTTAGTGAAAAAGTGCAGGCTAATGTAAAAAATATGCTTCTTTTAGAAGAGAGTAATGGCTACAAAATTTTTGGAAAGACTGGTTGGGCAATGGATATAAAACCACAAGTGGGCTGGTTGACCGGCTGGGTTGAGCAGCCAGATGGAAAAATTGTCGCTTTTGCATTAAATATGGAAATGCGGTCAGAAATGCCGGC
191	gb|AM176557|+|0-861|ARO:3001136|SHV-82	ATGCGTTATGTTCGCCTGTGTATTATCTCCCTGTTAGCCACCCTGCCGCTGGCG...TAA	861.0	16	822	806	861	ATGCGTTATATTCGCCTGTGTATTATCACCCTGTGAGCCACCCTGCCGCTGGCGGTACACGCCAGCCCGCAGCCGCTTGAGCAAATTAAACAAAGCGAAAGCCAGCTGTCGGGCCGCGTAGGCATGATAGAAATGGATCTGGCCAGCGGCCGCACGCTGACCGCCTGGCGCGCCGATGAACGCTTTCCCATGATGAGCACCTTTAAAGTAGTGCTCTGCGGCGCAGTGCTGGCGCGGGTGGATGCCGGTGACGAACAGCTGGAGCGAAAGATCCACTATCGCCAGCAGGATCTGGTGGACTACTCGCCGGTCAGCGAAAAACACCTTGCCGACGGCATGACGGTCGGCGAACTCTGCGCCGCCGCCATTACCATGAGCGATAACAGCGCCGCCAATCTGCTGCTGGCCACCGTCGGCGGCCCCGCAGGATTGACTGCCTTTTTGCGCCAGATCGGCGACAACGTCACCCGCCTTGACCGCTGGGAAACGGAACTGAATGAGGCGCTTCCCGGCGACGCCCGCGACACCACTACCCCGGCCAGCATGGCCGCGACCCTGCGCAAGCTGCTGACCAGCCAGCGTCTGAGCGCCCGTTCGCAACGGCAGCTGCTGCAGTGGATGGTGGACGATCGGGTCGCCGGACCGTTGATCCGCTCCGTGCTGCCGGCGGGCTGGTTTATCGCCGATAAGACCGGAGCTAGCAAGCGGGGTGCGCGCGGGATTGTCGCCCTGCTTGGCCCGAATAACAAAGCAGAGCGCATTGTGGTGATTTATCTGCGGGATACGCCGGCGAGCATGGCCGAGCG
192	gb|JX121118|+|0-858|ARO:3001190|SHV-151	ATGCGTTATATTCGCCTGTGTATTATCTCCCTGTTAGCCACCCTGCCGCTGGCG...CGC	858.0	16	819	803	858	ATGCGTTATATTCGCCTGTGTATTATCACCCTGTGAGCCACCCTGCCGCTGGCGGTACACGCCAGCCCGCAGCCGCTTGAGCAAATTAAACAAAGCGAAAGCCAGCTGTCGGGCCGCGTAGGCATGATAGAAATGGATCTGGCCAGCGGCCGCACGCTGACCGCCTGGCGCGCCGATGAACGCTTTCCCATGATGAGCACCTTTAAAGTAGTGCTCTGCGGCGCAGTGCTGGCGCGGGTGGATGCCGGTGACGAACAGCTGGAGCGAAAGATCCACTATCGCCAGCAGGATCTGGTGGACTACTCGCCGGTCAGCGAAAAACACCTTGCCGACGGCATGACGGTCGGCGAACTCTGCGCCGCCGCCATTACCATGAGCGATAACAGCGCCGCCAATCTGCTGCTGGCCACCGTCGGCGGCCCCGCAGGATTGACTGCCTTTTTGCGCCAGATCGGCGACAACGTCACCCGCCTTGACCGCTGGGAAACGGAACTGAATGAGGCGCTTCCCGGCGACGCCCGCGACACCACTACCCCGGCCAGCATGGCCGCGACCCTGCGCAAGCTGCTGACCAGCCAGCGTCTGAGCGCCCGTTCGCAACGGCAGCTGCTGCAGTGGATGGTGGACGATCGGGTCGCCGGACCGTTGATCCGCTCCGTGCTGCCGGCGGGCTGGTTTATCGCCGATAAGACCGGAGCTAGCAAGCGGGGTGCGCGCGGGATTGTCGCCCTGCTTGGCCCGAATAACAAAGCAGAGCGCATTGTGGTGATTTATCTGCGGGATACGCCGGCGAGCATGGCCGA
193	gb|X75562|+|134-935|ARO:3001402|OXA-7	ATGAAAACATTTGCCGCATATGTAATTACTGCGTGTCTTTCAAGTACGGCATTA...TAA	801.0	659	1405	746	801	ATGAAAACATTTGCCGCATATGTAATTATCGCGTGTCTTTCGAGTACGGCATTAGCTGGTTCAATTACAGAAAATACGTCTTGGAACAAAGAGTTCTCTGCCGAAGCCGTCAATGGTGTCTTCGTGCTTTGTAAAAGTAGCAGTAAATCCTGCGCTACCAATGACTTAGCTCGTGCATCAAAGGAATATCTTCCAGCATCAACATTTAAGATCCCCAACGCAATTATCGGCCTAGAAACTGGTGTCATAAAGAATGAGCATCAGGTTTTCAAATGGGACGGAAAGCCAAGAGCCATGAAGCAATGGGAAAGAGACTTGACCTTAAGAGGGGCAATACAAGTTTCAGCTGTTCCCGTATTTCAACAAATCGCCAGAGAAGTTGGCGAAGTAAGAATGCAGAAATACCTTAAAAAATTTTCCTATGGCAACCAGAATATCAGTGGTGGCATTGACAAATTCTGGTTGGAAGGCCAGCTTAGAATTTCCGCAGTTAATCAAGTGGAGTTTCTAGAGTCTCTATATTTAAATAAATTGTCAGCATCTAAAGAAAACCAGCTAATAGTAAAAGAGGCTTTGGTAACGGAGGCGGCACCTGAATATCTAGTGCATTCAAAAACTGGTTTTTCTGGTGTGGGAACTGAGTCAAATCCTGGTGTCGCATGGTGGGTTGGGTGGGTTGAGAAGGAGACAGAGGTTTACTTTTTCGCCTTTAACATGGATATAGACAACGAAAGTAAGTTGCCGCT
194	gb|KF048911.1|+|0-825|ARO:3001527|OXA-339	ATGAACATTAAAGCACTCTTACTTATAACAAGCGCTATTTTTATTTCAGCCTGC...TAG	825.0	54149	54919	770	825	ATGAACATTAAAGCACTCTTACTTATAACAAGCGCTATTTTTATTTCAGCCTGCTCACCTTATATAGTGACTGCTAATCCAAATCACAGCGCTTCAAAATCTGATGTAAAAGCAGAGAAAATTAAAAATTTATTTAACGAAGCACACACTACGGGTGTTTTAGTTATCCAACAAGGCCAAACTCAACAAAGCTATGGTAATGATCTTGCTCGTGCTTCGACCGAGTATGTACCTGCTTCGACCTTCAAAATGCTTAATGCTTTGATCGGCCTTGAGCACCATAAGGCAACCACCACAGAAGTATTTAAGTGGGATGGTAAAAAAAGGTTATTCCCAGAATGGGAAAAGGACATGACCCTAGGCGATGCCATGAAAGCTTCCGCTATTCCAGTTTATCAAGATTTAGCTCGTCGTATTGGACTTGAGCTCATGTCTAAGGAAGTGAAGCGTGTTGGTTATGGCAATGCAGATATCGGTACCCAAGTCGATAATTTTTGGCTGGTGGGTCCTTTAAAAATTACTCCTCAGCAAGAGGCACAGTTTGCTTACAAGCTAGCTAATAAAACGCTTCCATTTAGCCAAAAAGTCCAAGATGAAGTGCAATCCATGCTATTCATAGAAGAAAAGAATGGAAACAAAATATACGCAAAAAGTGGTTGGGGATGGGATGTAAACCCACAAGTAGGCTGGTTAACTGGATGGGTTGTTCAGCCTCAAGGGAATATTGTAGCGTTCTCCCTTAACTTAGAAATGAAAAAAGGAATACCTAG
195	gb|JX268631|+|0-861|ARO:3001091|SHV-33	ATGCGTTATATTCGCCTGTGTATTATCTCCCTGTTAGCCACCCTGCCGCTGGCG...TAA	861.0	16	822	806	861	ATGCGTTATATTCGCCTGTGTATTATCACCCTGTGAGCCACCCTGCCGCTGGCGGTACACGCCAGCCCGCAGCCGCTTGAGCAAATTAAACAAAGCGAAAGCCAGCTGTCGGGCCGCGTAGGCATGATAGAAATGGATCTGGCCAGCGGCCGCACGCTGACCGCCTGGCGCGCCGATGAACGCTTTCCCATGATGAGCACCTTTAAAGTAGTGCTCTGCGGCGCAGTGCTGGCGCGGGTGGATGCCGGTGACGAACAGCTGGAGCGAAAGATCCACTATCGCCAGCAGGATCTGGTGGACTACTCGCCGGTCAGCGAAAAACACCTTGCCGACGGCATGACGGTCGGCGAACTCTGCGCCGCCGCCATTACCATGAGCGATAACAGCGCCGCCAATCTGCTGCTGGCCACCGTCGGCGGCCCCGCAGGATTGACTGCCTTTTTGCGCCAGATCGGCGACAACGTCACCCGCCTTGACCGCTGGGAAACGGAACTGAATGAGGCGCTTCCCGGCGACGCCCGCGACACCACTACCCCGGCCAGCATGGCCGCGACCCTGCGCAAGCTGCTGACCAGCCAGCGTCTGAGCGCCCGTTCGCAACGGCAGCTGCTGCAGTGGATGGTGGACGATCGGGTCGCCGGACCGTTGATCCGCTCCGTGCTGCCGGCGGGCTGGTTTATCGCCGATAAGACCGGAGCTAGCAAGCGGGGTGCGCGCGGGATTGTCGCCCTGCTTGGCCCGAATAACAAAGCAGAGCGCATTGTGGTGATTTATCTGCGGGATACGCCGGCGAGCATGGCCGAGCG
196	gb|AM176558|+|0-861|ARO:3001137|SHV-83	AAGCGTTATATTCGCCTGTGTATTATCTCCCTGTTAGCCACCCTGCCGCTGGCG...TAA	861.0	18	822	804	861	GCGTTATATTCGCCTGTGTATTATCACCCTGTGAGCCACCCTGCCGCTGGCGGTACACGCCAGCCCGCAGCCGCTTGAGCAAATTAAACAAAGCGAAAGCCAGCTGTCGGGCCGCGTAGGCATGATAGAAATGGATCTGGCCAGCGGCCGCACGCTGACCGCCTGGCGCGCCGATGAACGCTTTCCCATGATGAGCACCTTTAAAGTAGTGCTCTGCGGCGCAGTGCTGGCGCGGGTGGATGCCGGTGACGAACAGCTGGAGCGAAAGATCCACTATCGCCAGCAGGATCTGGTGGACTACTCGCCGGTCAGCGAAAAACACCTTGCCGACGGCATGACGGTCGGCGAACTCTGCGCCGCCGCCATTACCATGAGCGATAACAGCGCCGCCAATCTGCTGCTGGCCACCGTCGGCGGCCCCGCAGGATTGACTGCCTTTTTGCGCCAGATCGGCGACAACGTCACCCGCCTTGACCGCTGGGAAACGGAACTGAATGAGGCGCTTCCCGGCGACGCCCGCGACACCACTACCCCGGCCAGCATGGCCGCGACCCTGCGCAAGCTGCTGACCAGCCAGCGTCTGAGCGCCCGTTCGCAACGGCAGCTGCTGCAGTGGATGGTGGACGATCGGGTCGCCGGACCGTTGATCCGCTCCGTGCTGCCGGCGGGCTGGTTTATCGCCGATAAGACCGGAGCTAGCAAGCGGGGTGCGCGCGGGATTGTCGCCCTGCTTGGCCCGAATAACAAAGCAGAGCGCATTGTGGTGATTTATCTGCGGGATACGCCGGCGAGCATGGCCGAGCG
197	gb|AY750912|+|0-825|ARO:3001618|OXA-70	ATGAACATTAAAGCACTCTTACTTATAACAAGCGCTATTTTTATTTCAGCCTGC...TAG	825.0	54149	54919	770	825	ATGAACATTAAAGCACTCTTACTTATAACAAGCGCTATTTTTATTTCAGCCTGCTCACCTTATATAGTGACTGCTAATCCAAATCACAGCGCTTCAAAATCTGATGTAAAAGCAGAGAAAATTAAAAATTTATTTAACGAAGCACACACTACGGGTGTTTTAGTTATCCAACAAGGCCAAACTCAACAAAGCTATGGTAATGATCTTGCTCGTGCTTCGACCGAGTATGTACCTGCTTCGACCTTCAAAATGCTTAATGCTTTGATCGGCCTTGAGCACCATAAGGCAACCACCACAGAAGTATTTAAGTGGGATGGTAAAAAAAGGTTATTCCCAGAATGGGAAAAGGACATGACCCTAGGCGATGCCATGAAAGCTTCCGCTATTCCAGTTTATCAAGATTTAGCTCGTCGTATTGGACTTGAGCTCATGTCTAAGGAAGTGAAGCGTGTTGGTTATGGCAATGCAGATATCGGTACCCAAGTCGATAATTTTTGGCTGGTGGGTCCTTTAAAAATTACTCCTCAGCAAGAGGCACAGTTTGCTTACAAGCTAGCTAATAAAACGCTTCCATTTAGCCAAAAAGTCCAAGATGAAGTGCAATCCATGCTATTCATAGAAGAAAAGAATGGAAACAAAATATACGCAAAAAGTGGTTGGGGATGGGATGTAAACCCACAAGTAGGCTGGTTAACTGGATGGGTTGTTCAGCCTCAAGGGAATATTGTAGCGTTCTCCCTTAACTTAGAAATGAAAAAAGGAATACCTAG
198	gb|KR057744.1|+|0-1116|ARO:3004338|PDC-75	GGCGAGGCCCCGGCGGATCGCCTGAAGGCACTGGTCGACGCCGCCGTACAACCG...TGA	1116.0	35594	36652	1058	1116	GAGGCCCCGGCGGATCGCCTGAAGGCACTGGTCGACGCCGCCGTACAACCGGTGATGAAGGCCAATGACATTCCGGGCCTGGCCGTAGCCATCAGCCTGAAAGGAGAACCGCATTACTTCAGCTATGGGCTGGCCTCGAAAGAGGACGGCCGCCGGGTGACGCCGGAGACCCTGTTCGAGATCGGCTCGGTGAGCAAGACCTTCACCGTCACCCTCGCCGGCTATGCCCTGGCCCAGGACAAGATGCGCCTCGACGACCGCGCCAGCCAGCACTGGCCGGCACTGCAGGGCAGCCGCTTCGACGGCATCAGCCTGCTCGACCTCGCGACCTATACCGCCGGCGGCTTGCCGCTGCAGTTCCCCGACTCGGTGCAGAAGGACCAGGCACAGATCCGCGACTACTACCGCCAGTGGCAGCCGACCTACGCGCCGGGCAGCCAGCGCCTCTATTCCAACCCGAGCATCGGCCTGTTCGGCTATCTCGCCGCGCGCAGCCTGGGCCAGCCGTTCGAACGGCTCATGGAGCAGCAATTGTTCCCGGCACTGGGCCTCGAACAGACCCACCTCGACGTGCCCGAGGCGGCGCTGGCGCAGTACGCCCAGGGCTACGGCAAGGACGACCGCCCGCTACGGGTCGGTCCCGGCCCGCTGGATGCCGAAGGCTACGGGGTGAAGACCAGCGCGGCCGACCTGCTGCGCTTCGTCGATGCCAACCTGCATCCGGAGCGCCTGGACAGGCCCTGGGCGCAGGCGCTCGATGCCACCCATCGCGGTTACTACAAGGTCGGCGACATGACCCAGGGCCTGGGCTGGGAAGCCTACGACTGGCCGATCTCCCTGAAGCGCCTGCAGGCCGGCAACTCGACGCCGATGGCGCTGCAACCACACAGGATCGCCAGGCTGCCCGCGCCACAGGCGCTGGAGGGCCAGCGCCTGCTGAACAAGACCGGCTCCACCAACGGCTTCGGCGCCTACGTGGCGTTCGTCCCGGGCCGCGACCTGGGCCTGGTGATCCTGGCCAACCGCAACTATCCCAATGCCGAGCGGGTGAAGATCGC
199	gb|JX121119|+|0-858|ARO:3001191|SHV-152	ATGCGTTATATTCGCCTGTGTATTATCTCCCTGTTAGCCACCCTGCCGCTGGCG...CGC	858.0	16	819	803	858	ATGCGTTATATTCGCCTGTGTATTATCACCCTGTGAGCCACCCTGCCGCTGGCGGTACACGCCAGCCCGCAGCCGCTTGAGCAAATTAAACAAAGCGAAAGCCAGCTGTCGGGCCGCGTAGGCATGATAGAAATGGATCTGGCCAGCGGCCGCACGCTGACCGCCTGGCGCGCCGATGAACGCTTTCCCATGATGAGCACCTTTAAAGTAGTGCTCTGCGGCGCAGTGCTGGCGCGGGTGGATGCCGGTGACGAACAGCTGGAGCGAAAGATCCACTATCGCCAGCAGGATCTGGTGGACTACTCGCCGGTCAGCGAAAAACACCTTGCCGACGGCATGACGGTCGGCGAACTCTGCGCCGCCGCCATTACCATGAGCGATAACAGCGCCGCCAATCTGCTGCTGGCCACCGTCGGCGGCCCCGCAGGATTGACTGCCTTTTTGCGCCAGATCGGCGACAACGTCACCCGCCTTGACCGCTGGGAAACGGAACTGAATGAGGCGCTTCCCGGCGACGCCCGCGACACCACTACCCCGGCCAGCATGGCCGCGACCCTGCGCAAGCTGCTGACCAGCCAGCGTCTGAGCGCCCGTTCGCAACGGCAGCTGCTGCAGTGGATGGTGGACGATCGGGTCGCCGGACCGTTGATCCGCTCCGTGCTGCCGGCGGGCTGGTTTATCGCCGATAAGACCGGAGCTAGCAAGCGGGGTGCGCGCGGGATTGTCGCCCTGCTTGGCCCGAATAACAAAGCAGAGCGCATTGTGGTGATTTATCTGCGGGATACGCCGGCGAGCATGGCCGA
200	gb|AY178995.1|+|0-1152|ARO:3003849|ADC-3	ATGCGATTTAAAAAAATTTCTTGTCTACTTTTATCCCCGCTTTTTTTTTTTAGT...TAA	1152.0	63	1160	1097	1152	ATGCGATTTAAAAAAATTTCTTGTCTACTTTTATCCCCGCTTTTTATTTTTAGTACCTCAATTTATGCGGGCAATACACCAAAAGACCAAGAAATTAAAAAACTGGTAGATCAAAACTTTAAACCGTTATTAGAAAAATATGATGTGCCAGGTATGGCTGTGGGTGTTATTCAAAATAATAAAAAGTATGAAATGTATTATGGTCTTCAATCTGTTCAAGATAAAAAAGCCGTAAATAGCAGTACTATTTTTGAGCTAGGTTCTGTCAGTAAATTATTTACCGCGACAGCAGGTGGATATGCAAAAAATAAAGGAAAAATCTCTTTTGACGATACGCCTGGTAAGTATTGGAAAGAACTAAAAAATACACCGATTGACCAAGTTAACTTACTTCAACTCGCGACGTATACAAGTGGTAACCTTGCCTTGCAATTTCCAGATGAAGTAAAAACAGATCAGCAAGTTTTAACATTTTTTAAAGACTGGAAACCTAAAAACTCAATCGGTGAATATCGACAATATTCAAACCCAAGCATTGGTTTATTTGGAAAAGTTGTAGCTTTGTCTATGAATAAACCTTTCGACCAAGTCTTAGAAAAAACAATTTTTCCGGCCCTTGGCTTAAAACATAGCTATGTAAATGTACCTAAGACCCAGATGCAAAACTATGCTTTTGGCTATAACCAAGAAAATCAGCCGATTCGAGTTAACCCCGGCCCACTCGATGCCCCAGCATATGGCGTCAAATCGACACTACCCGACATGTTGAGTTTTATTCATGCCAACCTAAATCCACAAAAATATCCAGCAGATATTCAACGGGCAATTAATGAAACACATCAGGGTCGCTATCAAGTAAATACCATGTATCAGGCACTCGGTTGGGAAGAGTTTTCTTATCCGGCAACGTTACAAACTTTATTAGACAGTAATTCAGAACAGATTGTGATGAAACCTAATAAAGTGACTGCTATTTCAAAGGAACCTTCAGTTAAGATGTACCATAAAACTGGCTCAACTACCGGTTTCGGAACATATGTGGTGTTTATTCCTAAAGAAAATATTGGTTTAGTCATGTTAACCAATAAACGTATTCC
201	gb|HM488990|+|0-822|ARO:3001469|OXA-169	ATGAATAAATATTTTACTTGCTATGTGGTTGCTTCTCTTTTTCTTTCTGGTTGT...TAA	822.0	80	847	767	822	ATGAATAAATATTTTACTTGCTATGTGGTTGCTTCTCTTTTTCTTTCTGGTTGTACGGTTCAGCATAATTTAATAAATGAAACCCCGAGTCAGATTGTTCAAGGACATAATCAGGTGATTCATCAATACTTTGATGAAAAAAACACCTCAGGTGTGCTGGTTATTCAAACAGATAAAAAAATTAATCTATATGGTAATGCTCTAAGCCGCGCAAATACAGAATATGTGCCAGCCTCTACATTTAAAATGTTGAATGCCCTGATCGGATTGGAGAACCAGAAAACGGATATTAATGAAATATTTAAATGGAAGGGCGAGAAAAGGTCATTTACCGCTTGGGAAAAAGACATGACACTAGGAGAAGCCATGAAGCTTTCTGCAGTCCCAGTCTATCAGGAACTTGCGCGACGTATCGGTCTTGATCTCATGCAAAAAGAAGTAAAACGTATTGGTTTCGGTAATGCTGAAATTGGACAGCAGGTTGATAATTTCTGGTTGGTAGGACCATTAAAGGTTACGCCTATTCAAGAGGTAGAGTTTGTTTCCCAATTAGCACATACACAGCTTCCATTTAGTGAAAAAGTGCAGGCTAATGTAAAAAATATGCTTCTTTTAGAAGAGAGTAATGGCTACAAAATTTTTGGAAAGACTGGTTGGGCAATGGATATAAAACCACAAGTGGGCTGGTTGACCGGCTGGGTTGAGCAGCCAGATGGAAAAATTGTCGCTTTTGCATTAAATATGGAAATGCGGTCAGAAATGCCGGC
202	gb|AY036620|+|88-949|ARO:3001092|SHV-34	ATGCGTTATTTTCGCCTGTGTATTATCTCCCTGTTAGCCACCCTGCCGCTGGCG...TAA	861.0	16	822	806	861	ATGCGTTATATTCGCCTGTGTATTATCACCCTGTGAGCCACCCTGCCGCTGGCGGTACACGCCAGCCCGCAGCCGCTTGAGCAAATTAAACAAAGCGAAAGCCAGCTGTCGGGCCGCGTAGGCATGATAGAAATGGATCTGGCCAGCGGCCGCACGCTGACCGCCTGGCGCGCCGATGAACGCTTTCCCATGATGAGCACCTTTAAAGTAGTGCTCTGCGGCGCAGTGCTGGCGCGGGTGGATGCCGGTGACGAACAGCTGGAGCGAAAGATCCACTATCGCCAGCAGGATCTGGTGGACTACTCGCCGGTCAGCGAAAAACACCTTGCCGACGGCATGACGGTCGGCGAACTCTGCGCCGCCGCCATTACCATGAGCGATAACAGCGCCGCCAATCTGCTGCTGGCCACCGTCGGCGGCCCCGCAGGATTGACTGCCTTTTTGCGCCAGATCGGCGACAACGTCACCCGCCTTGACCGCTGGGAAACGGAACTGAATGAGGCGCTTCCCGGCGACGCCCGCGACACCACTACCCCGGCCAGCATGGCCGCGACCCTGCGCAAGCTGCTGACCAGCCAGCGTCTGAGCGCCCGTTCGCAACGGCAGCTGCTGCAGTGGATGGTGGACGATCGGGTCGCCGGACCGTTGATCCGCTCCGTGCTGCCGGCGGGCTGGTTTATCGCCGATAAGACCGGAGCTAGCAAGCGGGGTGCGCGCGGGATTGTCGCCCTGCTTGGCCCGAATAACAAAGCAGAGCGCATTGTGGTGATTTATCTGCGGGATACGCCGGCGAGCATGGCCGAGCG
203	gb|DQ902344.1|+|2716-3517|ARO:3001412|OXA-17  Partial			659	1405	746	801	ATGAAAACATTTGCCGCATATGTAATTATCGCGTGTCTTTCGAGTACGGCATTAGCTGGTTCAATTACAGAAAATACGTCTTGGAACAAAGAGTTCTCTGCCGAAGCCGTCAATGGTGTCTTCGTGCTTTGTAAAAGTAGCAGTAAATCCTGCGCTACCAATGACTTAGCTCGTGCATCAAAGGAATATCTTCCAGCATCAACATTTAAGATCCCCAACGCAATTATCGGCCTAGAAACTGGTGTCATAAAGAATGAGCATCAGGTTTTCAAATGGGACGGAAAGCCAAGAGCCATGAAGCAATGGGAAAGAGACTTGACCTTAAGAGGGGCAATACAAGTTTCAGCTGTTCCCGTATTTCAACAAATCGCCAGAGAAGTTGGCGAAGTAAGAATGCAGAAATACCTTAAAAAATTTTCCTATGGCAACCAGAATATCAGTGGTGGCATTGACAAATTCTGGTTGGAAGGCCAGCTTAGAATTTCCGCAGTTAATCAAGTGGAGTTTCTAGAGTCTCTATATTTAAATAAATTGTCAGCATCTAAAGAAAACCAGCTAATAGTAAAAGAGGCTTTGGTAACGGAGGCGGCACCTGAATATCTAGTGCATTCAAAAACTGGTTTTTCTGGTGTGGGAACTGAGTCAAATCCTGGTGTCGCATGGTGGGTTGGGTGGGTTGAGAAGGAGACAGAGGTTTACTTTTTCGCCTTTAACATGGATATAGACAACGAAAGTAAGTTGCCGCT
204	gb|NGCN01000023.1|-|65770-66595|ARO:3001528|OXA-340	ATGAACATTAAAGCACTCTTACTTATAACAAGCGCTATTTTTATTTCAGCCTGC...TAG	825.0	54149	54919	770	825	ATGAACATTAAAGCACTCTTACTTATAACAAGCGCTATTTTTATTTCAGCCTGCTCACCTTATATAGTGACTGCTAATCCAAATCACAGCGCTTCAAAATCTGATGTAAAAGCAGAGAAAATTAAAAATTTATTTAACGAAGCACACACTACGGGTGTTTTAGTTATCCAACAAGGCCAAACTCAACAAAGCTATGGTAATGATCTTGCTCGTGCTTCGACCGAGTATGTACCTGCTTCGACCTTCAAAATGCTTAATGCTTTGATCGGCCTTGAGCACCATAAGGCAACCACCACAGAAGTATTTAAGTGGGATGGTAAAAAAAGGTTATTCCCAGAATGGGAAAAGGACATGACCCTAGGCGATGCCATGAAAGCTTCCGCTATTCCAGTTTATCAAGATTTAGCTCGTCGTATTGGACTTGAGCTCATGTCTAAGGAAGTGAAGCGTGTTGGTTATGGCAATGCAGATATCGGTACCCAAGTCGATAATTTTTGGCTGGTGGGTCCTTTAAAAATTACTCCTCAGCAAGAGGCACAGTTTGCTTACAAGCTAGCTAATAAAACGCTTCCATTTAGCCAAAAAGTCCAAGATGAAGTGCAATCCATGCTATTCATAGAAGAAAAGAATGGAAACAAAATATACGCAAAAAGTGGTTGGGGATGGGATGTAAACCCACAAGTAGGCTGGTTAACTGGATGGGTTGTTCAGCCTCAAGGGAATATTGTAGCGTTCTCCCTTAACTTAGAAATGAAAAAAGGAATACCTAG
205	gb|JX121120|+|0-858|ARO:3001192|SHV-153	ATGCGTTATATTCGCCTGTGTATTATCTCCCTGTTAGCCACCCTGCCGCTGGCG...CGC	858.0	16	819	803	858	ATGCGTTATATTCGCCTGTGTATTATCACCCTGTGAGCCACCCTGCCGCTGGCGGTACACGCCAGCCCGCAGCCGCTTGAGCAAATTAAACAAAGCGAAAGCCAGCTGTCGGGCCGCGTAGGCATGATAGAAATGGATCTGGCCAGCGGCCGCACGCTGACCGCCTGGCGCGCCGATGAACGCTTTCCCATGATGAGCACCTTTAAAGTAGTGCTCTGCGGCGCAGTGCTGGCGCGGGTGGATGCCGGTGACGAACAGCTGGAGCGAAAGATCCACTATCGCCAGCAGGATCTGGTGGACTACTCGCCGGTCAGCGAAAAACACCTTGCCGACGGCATGACGGTCGGCGAACTCTGCGCCGCCGCCATTACCATGAGCGATAACAGCGCCGCCAATCTGCTGCTGGCCACCGTCGGCGGCCCCGCAGGATTGACTGCCTTTTTGCGCCAGATCGGCGACAACGTCACCCGCCTTGACCGCTGGGAAACGGAACTGAATGAGGCGCTTCCCGGCGACGCCCGCGACACCACTACCCCGGCCAGCATGGCCGCGACCCTGCGCAAGCTGCTGACCAGCCAGCGTCTGAGCGCCCGTTCGCAACGGCAGCTGCTGCAGTGGATGGTGGACGATCGGGTCGCCGGACCGTTGATCCGCTCCGTGCTGCCGGCGGGCTGGTTTATCGCCGATAAGACCGGAGCTAGCAAGCGGGGTGCGCGCGGGATTGTCGCCCTGCTTGGCCCGAATAACAAAGCAGAGCGCATTGTGGTGATTTATCTGCGGGATACGCCGGCGAGCATGGCCGA
206	gb|AY070258|+|0-861|ARO:3001093|SHV-35	ATGCGTTATATTCGCCTGTGTATTATCTCCCTGTTAGCCACCCTGCCGCTGGCG...TAA	861.0	16	822	806	861	ATGCGTTATATTCGCCTGTGTATTATCACCCTGTGAGCCACCCTGCCGCTGGCGGTACACGCCAGCCCGCAGCCGCTTGAGCAAATTAAACAAAGCGAAAGCCAGCTGTCGGGCCGCGTAGGCATGATAGAAATGGATCTGGCCAGCGGCCGCACGCTGACCGCCTGGCGCGCCGATGAACGCTTTCCCATGATGAGCACCTTTAAAGTAGTGCTCTGCGGCGCAGTGCTGGCGCGGGTGGATGCCGGTGACGAACAGCTGGAGCGAAAGATCCACTATCGCCAGCAGGATCTGGTGGACTACTCGCCGGTCAGCGAAAAACACCTTGCCGACGGCATGACGGTCGGCGAACTCTGCGCCGCCGCCATTACCATGAGCGATAACAGCGCCGCCAATCTGCTGCTGGCCACCGTCGGCGGCCCCGCAGGATTGACTGCCTTTTTGCGCCAGATCGGCGACAACGTCACCCGCCTTGACCGCTGGGAAACGGAACTGAATGAGGCGCTTCCCGGCGACGCCCGCGACACCACTACCCCGGCCAGCATGGCCGCGACCCTGCGCAAGCTGCTGACCAGCCAGCGTCTGAGCGCCCGTTCGCAACGGCAGCTGCTGCAGTGGATGGTGGACGATCGGGTCGCCGGACCGTTGATCCGCTCCGTGCTGCCGGCGGGCTGGTTTATCGCCGATAAGACCGGAGCTAGCAAGCGGGGTGCGCGCGGGATTGTCGCCCTGCTTGGCCCGAATAACAAAGCAGAGCGCATTGTGGTGATTTATCTGCGGGATACGCCGGCGAGCATGGCCGAGCG
207	gb|JF265068.1|+|954-2106|ARO:3004617|ADC-30	ATGCGATTTAAAAAAATTTCTTGTCTACTTTTATCCCCGCTTTTTATTTTTAGT...TAA	1152.0	63	1160	1097	1152	ATGCGATTTAAAAAAATTTCTTGTCTACTTTTATCCCCGCTTTTTATTTTTAGTACCTCAATTTATGCGGGCAATACACCAAAAGACCAAGAAATTAAAAAACTGGTAGATCAAAACTTTAAACCGTTATTAGAAAAATATGATGTGCCAGGTATGGCTGTGGGTGTTATTCAAAATAATAAAAAGTATGAAATGTATTATGGTCTTCAATCTGTTCAAGATAAAAAAGCCGTAAATAGCAGTACTATTTTTGAGCTAGGTTCTGTCAGTAAATTATTTACCGCGACAGCAGGTGGATATGCAAAAAATAAAGGAAAAATCTCTTTTGACGATACGCCTGGTAAGTATTGGAAAGAACTAAAAAATACACCGATTGACCAAGTTAACTTACTTCAACTCGCGACGTATACAAGTGGTAACCTTGCCTTGCAATTTCCAGATGAAGTAAAAACAGATCAGCAAGTTTTAACATTTTTTAAAGACTGGAAACCTAAAAACTCAATCGGTGAATATCGACAATATTCAAACCCAAGCATTGGTTTATTTGGAAAAGTTGTAGCTTTGTCTATGAATAAACCTTTCGACCAAGTCTTAGAAAAAACAATTTTTCCGGCCCTTGGCTTAAAACATAGCTATGTAAATGTACCTAAGACCCAGATGCAAAACTATGCTTTTGGCTATAACCAAGAAAATCAGCCGATTCGAGTTAACCCCGGCCCACTCGATGCCCCAGCATATGGCGTCAAATCGACACTACCCGACATGTTGAGTTTTATTCATGCCAACCTAAATCCACAAAAATATCCAGCAGATATTCAACGGGCAATTAATGAAACACATCAGGGTCGCTATCAAGTAAATACCATGTATCAGGCACTCGGTTGGGAAGAGTTTTCTTATCCGGCAACGTTACAAACTTTATTAGACAGTAATTCAGAACAGATTGTGATGAAACCTAATAAAGTGACTGCTATTTCAAAGGAACCTTCAGTTAAGATGTACCATAAAACTGGCTCAACTACCGGTTTCGGAACATATGTGGTGTTTATTCCTAAAGAAAATATTGGTTTAGTCATGTTAACCAATAAACGTATTCC
208	gb|HM488991|+|0-822|ARO:3001470|OXA-170	ATGAATAAATATTTTACTTGCTATGTGGTTGCTTCTCTTTTTCTTTCTGGTTGT...TAA	822.0	80	847	767	822	ATGAATAAATATTTTACTTGCTATGTGGTTGCTTCTCTTTTTCTTTCTGGTTGTACGGTTCAGCATAATTTAATAAATGAAACCCCGAGTCAGATTGTTCAAGGACATAATCAGGTGATTCATCAATACTTTGATGAAAAAAACACCTCAGGTGTGCTGGTTATTCAAACAGATAAAAAAATTAATCTATATGGTAATGCTCTAAGCCGCGCAAATACAGAATATGTGCCAGCCTCTACATTTAAAATGTTGAATGCCCTGATCGGATTGGAGAACCAGAAAACGGATATTAATGAAATATTTAAATGGAAGGGCGAGAAAAGGTCATTTACCGCTTGGGAAAAAGACATGACACTAGGAGAAGCCATGAAGCTTTCTGCAGTCCCAGTCTATCAGGAACTTGCGCGACGTATCGGTCTTGATCTCATGCAAAAAGAAGTAAAACGTATTGGTTTCGGTAATGCTGAAATTGGACAGCAGGTTGATAATTTCTGGTTGGTAGGACCATTAAAGGTTACGCCTATTCAAGAGGTAGAGTTTGTTTCCCAATTAGCACATACACAGCTTCCATTTAGTGAAAAAGTGCAGGCTAATGTAAAAAATATGCTTCTTTTAGAAGAGAGTAATGGCTACAAAATTTTTGGAAAGACTGGTTGGGCAATGGATATAAAACCACAAGTGGGCTGGTTGACCGGCTGGGTTGAGCAGCCAGATGGAAAAATTGTCGCTTTTGCATTAAATATGGAAATGCGGTCAGAAATGCCGGC
209	gb|JX121121|+|0-858|ARO:3001193|SHV-154	ATGCGTTATATTCGCCTGTGTATTATCTCCCTGTTAGCCACCCTGCCGCTGGCG...CGC	858.0	16	819	803	858	ATGCGTTATATTCGCCTGTGTATTATCACCCTGTGAGCCACCCTGCCGCTGGCGGTACACGCCAGCCCGCAGCCGCTTGAGCAAATTAAACAAAGCGAAAGCCAGCTGTCGGGCCGCGTAGGCATGATAGAAATGGATCTGGCCAGCGGCCGCACGCTGACCGCCTGGCGCGCCGATGAACGCTTTCCCATGATGAGCACCTTTAAAGTAGTGCTCTGCGGCGCAGTGCTGGCGCGGGTGGATGCCGGTGACGAACAGCTGGAGCGAAAGATCCACTATCGCCAGCAGGATCTGGTGGACTACTCGCCGGTCAGCGAAAAACACCTTGCCGACGGCATGACGGTCGGCGAACTCTGCGCCGCCGCCATTACCATGAGCGATAACAGCGCCGCCAATCTGCTGCTGGCCACCGTCGGCGGCCCCGCAGGATTGACTGCCTTTTTGCGCCAGATCGGCGACAACGTCACCCGCCTTGACCGCTGGGAAACGGAACTGAATGAGGCGCTTCCCGGCGACGCCCGCGACACCACTACCCCGGCCAGCATGGCCGCGACCCTGCGCAAGCTGCTGACCAGCCAGCGTCTGAGCGCCCGTTCGCAACGGCAGCTGCTGCAGTGGATGGTGGACGATCGGGTCGCCGGACCGTTGATCCGCTCCGTGCTGCCGGCGGGCTGGTTTATCGCCGATAAGACCGGAGCTAGCAAGCGGGGTGCGCGCGGGATTGTCGCCCTGCTTGGCCCGAATAACAAAGCAGAGCGCATTGTGGTGATTTATCTGCGGGATACGCCGGCGAGCATGGCCGA
210	gb|AY750913|+|0-825|ARO:3001619|OXA-71	ATGAACATTAAAGCCCTCTTACTTATAACAAGCGCTATTTTTATTTCAGCCTGC...TAG	825.0	54149	54919	770	825	ATGAACATTAAAGCACTCTTACTTATAACAAGCGCTATTTTTATTTCAGCCTGCTCACCTTATATAGTGACTGCTAATCCAAATCACAGCGCTTCAAAATCTGATGTAAAAGCAGAGAAAATTAAAAATTTATTTAACGAAGCACACACTACGGGTGTTTTAGTTATCCAACAAGGCCAAACTCAACAAAGCTATGGTAATGATCTTGCTCGTGCTTCGACCGAGTATGTACCTGCTTCGACCTTCAAAATGCTTAATGCTTTGATCGGCCTTGAGCACCATAAGGCAACCACCACAGAAGTATTTAAGTGGGATGGTAAAAAAAGGTTATTCCCAGAATGGGAAAAGGACATGACCCTAGGCGATGCCATGAAAGCTTCCGCTATTCCAGTTTATCAAGATTTAGCTCGTCGTATTGGACTTGAGCTCATGTCTAAGGAAGTGAAGCGTGTTGGTTATGGCAATGCAGATATCGGTACCCAAGTCGATAATTTTTGGCTGGTGGGTCCTTTAAAAATTACTCCTCAGCAAGAGGCACAGTTTGCTTACAAGCTAGCTAATAAAACGCTTCCATTTAGCCAAAAAGTCCAAGATGAAGTGCAATCCATGCTATTCATAGAAGAAAAGAATGGAAACAAAATATACGCAAAAAGTGGTTGGGGATGGGATGTAAACCCACAAGTAGGCTGGTTAACTGGATGGGTTGTTCAGCCTCAAGGGAATATTGTAGCGTTCTCCCTTAACTTAGAAATGAAAAAAGGAATACCTAG
211	gb|AF467947|+|0-861|ARO:3001094|SHV-36	ATGCGTTATGTTCGCCTGTGTATTATCTCCCTGTTAGCCACCCTGCCGCTGGCG...TAA	861.0	16	822	806	861	ATGCGTTATATTCGCCTGTGTATTATCACCCTGTGAGCCACCCTGCCGCTGGCGGTACACGCCAGCCCGCAGCCGCTTGAGCAAATTAAACAAAGCGAAAGCCAGCTGTCGGGCCGCGTAGGCATGATAGAAATGGATCTGGCCAGCGGCCGCACGCTGACCGCCTGGCGCGCCGATGAACGCTTTCCCATGATGAGCACCTTTAAAGTAGTGCTCTGCGGCGCAGTGCTGGCGCGGGTGGATGCCGGTGACGAACAGCTGGAGCGAAAGATCCACTATCGCCAGCAGGATCTGGTGGACTACTCGCCGGTCAGCGAAAAACACCTTGCCGACGGCATGACGGTCGGCGAACTCTGCGCCGCCGCCATTACCATGAGCGATAACAGCGCCGCCAATCTGCTGCTGGCCACCGTCGGCGGCCCCGCAGGATTGACTGCCTTTTTGCGCCAGATCGGCGACAACGTCACCCGCCTTGACCGCTGGGAAACGGAACTGAATGAGGCGCTTCCCGGCGACGCCCGCGACACCACTACCCCGGCCAGCATGGCCGCGACCCTGCGCAAGCTGCTGACCAGCCAGCGTCTGAGCGCCCGTTCGCAACGGCAGCTGCTGCAGTGGATGGTGGACGATCGGGTCGCCGGACCGTTGATCCGCTCCGTGCTGCCGGCGGGCTGGTTTATCGCCGATAAGACCGGAGCTAGCAAGCGGGGTGCGCGCGGGATTGTCGCCCTGCTTGGCCCGAATAACAAAGCAGAGCGCATTGTGGTGATTTATCTGCGGGATACGCCGGCGAGCATGGCCGAGCG
212	gb|HM488992|+|0-822|ARO:3001471|OXA-171	ATGAATAAATATTTTACTTGCTATGTGGTTGCTTCTCTTTTTCTTTCTGGTTGT...TAA	822.0	80	847	767	822	ATGAATAAATATTTTACTTGCTATGTGGTTGCTTCTCTTTTTCTTTCTGGTTGTACGGTTCAGCATAATTTAATAAATGAAACCCCGAGTCAGATTGTTCAAGGACATAATCAGGTGATTCATCAATACTTTGATGAAAAAAACACCTCAGGTGTGCTGGTTATTCAAACAGATAAAAAAATTAATCTATATGGTAATGCTCTAAGCCGCGCAAATACAGAATATGTGCCAGCCTCTACATTTAAAATGTTGAATGCCCTGATCGGATTGGAGAACCAGAAAACGGATATTAATGAAATATTTAAATGGAAGGGCGAGAAAAGGTCATTTACCGCTTGGGAAAAAGACATGACACTAGGAGAAGCCATGAAGCTTTCTGCAGTCCCAGTCTATCAGGAACTTGCGCGACGTATCGGTCTTGATCTCATGCAAAAAGAAGTAAAACGTATTGGTTTCGGTAATGCTGAAATTGGACAGCAGGTTGATAATTTCTGGTTGGTAGGACCATTAAAGGTTACGCCTATTCAAGAGGTAGAGTTTGTTTCCCAATTAGCACATACACAGCTTCCATTTAGTGAAAAAGTGCAGGCTAATGTAAAAAATATGCTTCTTTTAGAAGAGAGTAATGGCTACAAAATTTTTGGAAAGACTGGTTGGGCAATGGATATAAAACCACAAGTGGGCTGGTTGACCGGCTGGGTTGAGCAGCCAGATGGAAAAATTGTCGCTTTTGCATTAAATATGGAAATGCGGTCAGAAATGCCGGC
213	gb|JX121122|+|0-858|ARO:3001194|SHV-155	ATGCGTTATATTCGCCTGTGTATTATCTCCCTGTTAGCCACCCTGCCGCTGGCG...CAA	858.0	16	817	801	858	ATGCGTTATATTCGCCTGTGTATTATCACCCTGTGAGCCACCCTGCCGCTGGCGGTACACGCCAGCCCGCAGCCGCTTGAGCAAATTAAACAAAGCGAAAGCCAGCTGTCGGGCCGCGTAGGCATGATAGAAATGGATCTGGCCAGCGGCCGCACGCTGACCGCCTGGCGCGCCGATGAACGCTTTCCCATGATGAGCACCTTTAAAGTAGTGCTCTGCGGCGCAGTGCTGGCGCGGGTGGATGCCGGTGACGAACAGCTGGAGCGAAAGATCCACTATCGCCAGCAGGATCTGGTGGACTACTCGCCGGTCAGCGAAAAACACCTTGCCGACGGCATGACGGTCGGCGAACTCTGCGCCGCCGCCATTACCATGAGCGATAACAGCGCCGCCAATCTGCTGCTGGCCACCGTCGGCGGCCCCGCAGGATTGACTGCCTTTTTGCGCCAGATCGGCGACAACGTCACCCGCCTTGACCGCTGGGAAACGGAACTGAATGAGGCGCTTCCCGGCGACGCCCGCGACACCACTACCCCGGCCAGCATGGCCGCGACCCTGCGCAAGCTGCTGACCAGCCAGCGTCTGAGCGCCCGTTCGCAACGGCAGCTGCTGCAGTGGATGGTGGACGATCGGGTCGCCGGACCGTTGATCCGCTCCGTGCTGCCGGCGGGCTGGTTTATCGCCGATAAGACCGGAGCTAGCAAGCGGGGTGCGCGCGGGATTGTCGCCCTGCTTGGCCCGAATAACAAAGCAGAGCGCATTGTGGTGATTTATCTGCGGGATACGCCGGCGAGCATGGCC
214	gb|AM087453|+|25-856|ARO:3001138|SHV-84	ATGCGTTATATTCGCCTGTGTATTATCTCCCTGTTAGCCACCCTGCCGCTGGCG...GGC	831.0	16	792	776	831	ATGCGTTATATTCGCCTGTGTATTATCACCCTGTGAGCCACCCTGCCGCTGGCGGTACACGCCAGCCCGCAGCCGCTTGAGCAAATTAAACAAAGCGAAAGCCAGCTGTCGGGCCGCGTAGGCATGATAGAAATGGATCTGGCCAGCGGCCGCACGCTGACCGCCTGGCGCGCCGATGAACGCTTTCCCATGATGAGCACCTTTAAAGTAGTGCTCTGCGGCGCAGTGCTGGCGCGGGTGGATGCCGGTGACGAACAGCTGGAGCGAAAGATCCACTATCGCCAGCAGGATCTGGTGGACTACTCGCCGGTCAGCGAAAAACACCTTGCCGACGGCATGACGGTCGGCGAACTCTGCGCCGCCGCCATTACCATGAGCGATAACAGCGCCGCCAATCTGCTGCTGGCCACCGTCGGCGGCCCCGCAGGATTGACTGCCTTTTTGCGCCAGATCGGCGACAACGTCACCCGCCTTGACCGCTGGGAAACGGAACTGAATGAGGCGCTTCCCGGCGACGCCCGCGACACCACTACCCCGGCCAGCATGGCCGCGACCCTGCGCAAGCTGCTGACCAGCCAGCGTCTGAGCGCCCGTTCGCAACGGCAGCTGCTGCAGTGGATGGTGGACGATCGGGTCGCCGGACCGTTGATCCGCTCCGTGCTGCCGGCGGGCTGGTTTATCGCCGATAAGACCGGAGCTAGCAAGCGGGGTGCGCGCGGGATTGTCGCCCTGCTTGGCCCGAATAACAAAGCAGAGCGCATTGTGGTGATTTATCT
215	gb|AY762325|+|115-937|ARO:3001785|OXA-73	ATGAATAAATATTTTACTTGCTATGTGGTTGCTTCTCTTTTTCTTTCTGGTTGT...TAA	822.0	80	847	767	822	ATGAATAAATATTTTACTTGCTATGTGGTTGCTTCTCTTTTTCTTTCTGGTTGTACGGTTCAGCATAATTTAATAAATGAAACCCCGAGTCAGATTGTTCAAGGACATAATCAGGTGATTCATCAATACTTTGATGAAAAAAACACCTCAGGTGTGCTGGTTATTCAAACAGATAAAAAAATTAATCTATATGGTAATGCTCTAAGCCGCGCAAATACAGAATATGTGCCAGCCTCTACATTTAAAATGTTGAATGCCCTGATCGGATTGGAGAACCAGAAAACGGATATTAATGAAATATTTAAATGGAAGGGCGAGAAAAGGTCATTTACCGCTTGGGAAAAAGACATGACACTAGGAGAAGCCATGAAGCTTTCTGCAGTCCCAGTCTATCAGGAACTTGCGCGACGTATCGGTCTTGATCTCATGCAAAAAGAAGTAAAACGTATTGGTTTCGGTAATGCTGAAATTGGACAGCAGGTTGATAATTTCTGGTTGGTAGGACCATTAAAGGTTACGCCTATTCAAGAGGTAGAGTTTGTTTCCCAATTAGCACATACACAGCTTCCATTTAGTGAAAAAGTGCAGGCTAATGTAAAAAATATGCTTCTTTTAGAAGAGAGTAATGGCTACAAAATTTTTGGAAAGACTGGTTGGGCAATGGATATAAAACCACAAGTGGGCTGGTTGACCGGCTGGGTTGAGCAGCCAGATGGAAAAATTGTCGCTTTTGCATTAAATATGGAAATGCGGTCAGAAATGCCGGC
216	gb|AF467948|+|0-861|ARO:3001095|SHV-37	ATGCGTTATATTCGCCTGTGTATTATCTCCCTGTTAGCCGCCCTGCCGCTGGCG...TAA	861.0	16	822	806	861	ATGCGTTATATTCGCCTGTGTATTATCACCCTGTGAGCCACCCTGCCGCTGGCGGTACACGCCAGCCCGCAGCCGCTTGAGCAAATTAAACAAAGCGAAAGCCAGCTGTCGGGCCGCGTAGGCATGATAGAAATGGATCTGGCCAGCGGCCGCACGCTGACCGCCTGGCGCGCCGATGAACGCTTTCCCATGATGAGCACCTTTAAAGTAGTGCTCTGCGGCGCAGTGCTGGCGCGGGTGGATGCCGGTGACGAACAGCTGGAGCGAAAGATCCACTATCGCCAGCAGGATCTGGTGGACTACTCGCCGGTCAGCGAAAAACACCTTGCCGACGGCATGACGGTCGGCGAACTCTGCGCCGCCGCCATTACCATGAGCGATAACAGCGCCGCCAATCTGCTGCTGGCCACCGTCGGCGGCCCCGCAGGATTGACTGCCTTTTTGCGCCAGATCGGCGACAACGTCACCCGCCTTGACCGCTGGGAAACGGAACTGAATGAGGCGCTTCCCGGCGACGCCCGCGACACCACTACCCCGGCCAGCATGGCCGCGACCCTGCGCAAGCTGCTGACCAGCCAGCGTCTGAGCGCCCGTTCGCAACGGCAGCTGCTGCAGTGGATGGTGGACGATCGGGTCGCCGGACCGTTGATCCGCTCCGTGCTGCCGGCGGGCTGGTTTATCGCCGATAAGACCGGAGCTAGCAAGCGGGGTGCGCGCGGGATTGTCGCCCTGCTTGGCCCGAATAACAAAGCAGAGCGCATTGTGGTGATTTATCTGCGGGATACGCCGGCGAGCATGGCCGAGCG
217	gb|CP001921.1|+|2803996-2805148|ARO:3003870|ADC-31	ATGCGATTTAAAAAAATTTCTTGTCTACTTTTATCCCCGCTTTTTATTTTTAGT...TAA	1152.0	63	1160	1097	1152	ATGCGATTTAAAAAAATTTCTTGTCTACTTTTATCCCCGCTTTTTATTTTTAGTACCTCAATTTATGCGGGCAATACACCAAAAGACCAAGAAATTAAAAAACTGGTAGATCAAAACTTTAAACCGTTATTAGAAAAATATGATGTGCCAGGTATGGCTGTGGGTGTTATTCAAAATAATAAAAAGTATGAAATGTATTATGGTCTTCAATCTGTTCAAGATAAAAAAGCCGTAAATAGCAGTACTATTTTTGAGCTAGGTTCTGTCAGTAAATTATTTACCGCGACAGCAGGTGGATATGCAAAAAATAAAGGAAAAATCTCTTTTGACGATACGCCTGGTAAGTATTGGAAAGAACTAAAAAATACACCGATTGACCAAGTTAACTTACTTCAACTCGCGACGTATACAAGTGGTAACCTTGCCTTGCAATTTCCAGATGAAGTAAAAACAGATCAGCAAGTTTTAACATTTTTTAAAGACTGGAAACCTAAAAACTCAATCGGTGAATATCGACAATATTCAAACCCAAGCATTGGTTTATTTGGAAAAGTTGTAGCTTTGTCTATGAATAAACCTTTCGACCAAGTCTTAGAAAAAACAATTTTTCCGGCCCTTGGCTTAAAACATAGCTATGTAAATGTACCTAAGACCCAGATGCAAAACTATGCTTTTGGCTATAACCAAGAAAATCAGCCGATTCGAGTTAACCCCGGCCCACTCGATGCCCCAGCATATGGCGTCAAATCGACACTACCCGACATGTTGAGTTTTATTCATGCCAACCTAAATCCACAAAAATATCCAGCAGATATTCAACGGGCAATTAATGAAACACATCAGGGTCGCTATCAAGTAAATACCATGTATCAGGCACTCGGTTGGGAAGAGTTTTCTTATCCGGCAACGTTACAAACTTTATTAGACAGTAATTCAGAACAGATTGTGATGAAACCTAATAAAGTGACTGCTATTTCAAAGGAACCTTCAGTTAAGATGTACCATAAAACTGGCTCAACTACCGGTTTCGGAACATATGTGGTGTTTATTCCTAAAGAAAATATTGGTTTAGTCATGTTAACCAATAAACGTATTCC
218	gb|HM113558|+|0-825|ARO:3001656|OXA-172	ATGAACATTAAAGCACTCTTACTTATAACAAGCGCTATTTTTATTTCAGCCTGC...TAG	825.0	54149	54919	770	825	ATGAACATTAAAGCACTCTTACTTATAACAAGCGCTATTTTTATTTCAGCCTGCTCACCTTATATAGTGACTGCTAATCCAAATCACAGCGCTTCAAAATCTGATGTAAAAGCAGAGAAAATTAAAAATTTATTTAACGAAGCACACACTACGGGTGTTTTAGTTATCCAACAAGGCCAAACTCAACAAAGCTATGGTAATGATCTTGCTCGTGCTTCGACCGAGTATGTACCTGCTTCGACCTTCAAAATGCTTAATGCTTTGATCGGCCTTGAGCACCATAAGGCAACCACCACAGAAGTATTTAAGTGGGATGGTAAAAAAAGGTTATTCCCAGAATGGGAAAAGGACATGACCCTAGGCGATGCCATGAAAGCTTCCGCTATTCCAGTTTATCAAGATTTAGCTCGTCGTATTGGACTTGAGCTCATGTCTAAGGAAGTGAAGCGTGTTGGTTATGGCAATGCAGATATCGGTACCCAAGTCGATAATTTTTGGCTGGTGGGTCCTTTAAAAATTACTCCTCAGCAAGAGGCACAGTTTGCTTACAAGCTAGCTAATAAAACGCTTCCATTTAGCCAAAAAGTCCAAGATGAAGTGCAATCCATGCTATTCATAGAAGAAAAGAATGGAAACAAAATATACGCAAAAAGTGGTTGGGGATGGGATGTAAACCCACAAGTAGGCTGGTTAACTGGATGGGTTGTTCAGCCTCAAGGGAATATTGTAGCGTTCTCCCTTAACTTAGAAATGAAAAAAGGAATACCTAG
219	gb|JX121123|+|0-861|ARO:3001195|SHV-156	ATGCGTTATATTCGCCTGTGTATTATCTCCCTGTTAGCCACCCTGCCGCTGGCG...TAA	861.0	16	822	806	861	ATGCGTTATATTCGCCTGTGTATTATCACCCTGTGAGCCACCCTGCCGCTGGCGGTACACGCCAGCCCGCAGCCGCTTGAGCAAATTAAACAAAGCGAAAGCCAGCTGTCGGGCCGCGTAGGCATGATAGAAATGGATCTGGCCAGCGGCCGCACGCTGACCGCCTGGCGCGCCGATGAACGCTTTCCCATGATGAGCACCTTTAAAGTAGTGCTCTGCGGCGCAGTGCTGGCGCGGGTGGATGCCGGTGACGAACAGCTGGAGCGAAAGATCCACTATCGCCAGCAGGATCTGGTGGACTACTCGCCGGTCAGCGAAAAACACCTTGCCGACGGCATGACGGTCGGCGAACTCTGCGCCGCCGCCATTACCATGAGCGATAACAGCGCCGCCAATCTGCTGCTGGCCACCGTCGGCGGCCCCGCAGGATTGACTGCCTTTTTGCGCCAGATCGGCGACAACGTCACCCGCCTTGACCGCTGGGAAACGGAACTGAATGAGGCGCTTCCCGGCGACGCCCGCGACACCACTACCCCGGCCAGCATGGCCGCGACCCTGCGCAAGCTGCTGACCAGCCAGCGTCTGAGCGCCCGTTCGCAACGGCAGCTGCTGCAGTGGATGGTGGACGATCGGGTCGCCGGACCGTTGATCCGCTCCGTGCTGCCGGCGGGCTGGTTTATCGCCGATAAGACCGGAGCTAGCAAGCGGGGTGCGCGCGGGATTGTCGCCCTGCTTGGCCCGAATAACAAAGCAGAGCGCATTGTGGTGATTTATCTGCGGGATACGCCGGCGAGCATGGCCGAGCG
220	gb|KF048913.1|+|0-825|ARO:3001529|OXA-341	ATGAACATTAAAGCACCCTTACTTATAACAAGCGCTATTTTTATTTCAGCCTGC...TAG	825.0	54149	54919	770	825	ATGAACATTAAAGCACTCTTACTTATAACAAGCGCTATTTTTATTTCAGCCTGCTCACCTTATATAGTGACTGCTAATCCAAATCACAGCGCTTCAAAATCTGATGTAAAAGCAGAGAAAATTAAAAATTTATTTAACGAAGCACACACTACGGGTGTTTTAGTTATCCAACAAGGCCAAACTCAACAAAGCTATGGTAATGATCTTGCTCGTGCTTCGACCGAGTATGTACCTGCTTCGACCTTCAAAATGCTTAATGCTTTGATCGGCCTTGAGCACCATAAGGCAACCACCACAGAAGTATTTAAGTGGGATGGTAAAAAAAGGTTATTCCCAGAATGGGAAAAGGACATGACCCTAGGCGATGCCATGAAAGCTTCCGCTATTCCAGTTTATCAAGATTTAGCTCGTCGTATTGGACTTGAGCTCATGTCTAAGGAAGTGAAGCGTGTTGGTTATGGCAATGCAGATATCGGTACCCAAGTCGATAATTTTTGGCTGGTGGGTCCTTTAAAAATTACTCCTCAGCAAGAGGCACAGTTTGCTTACAAGCTAGCTAATAAAACGCTTCCATTTAGCCAAAAAGTCCAAGATGAAGTGCAATCCATGCTATTCATAGAAGAAAAGAATGGAAACAAAATATACGCAAAAAGTGGTTGGGGATGGGATGTAAACCCACAAGTAGGCTGGTTAACTGGATGGGTTGTTCAGCCTCAAGGGAATATTGTAGCGTTCTCCCTTAACTTAGAAATGAAAAAAGGAATACCTAG
221	gb|AY079099|+|148-1009|ARO:3001096|SHV-38	ATGCGTTATATTCGCCTGTGTATTATCTCCCTGTTAGCCACCCTGCCGCTGGCG...TAA	861.0	16	822	806	861	ATGCGTTATATTCGCCTGTGTATTATCACCCTGTGAGCCACCCTGCCGCTGGCGGTACACGCCAGCCCGCAGCCGCTTGAGCAAATTAAACAAAGCGAAAGCCAGCTGTCGGGCCGCGTAGGCATGATAGAAATGGATCTGGCCAGCGGCCGCACGCTGACCGCCTGGCGCGCCGATGAACGCTTTCCCATGATGAGCACCTTTAAAGTAGTGCTCTGCGGCGCAGTGCTGGCGCGGGTGGATGCCGGTGACGAACAGCTGGAGCGAAAGATCCACTATCGCCAGCAGGATCTGGTGGACTACTCGCCGGTCAGCGAAAAACACCTTGCCGACGGCATGACGGTCGGCGAACTCTGCGCCGCCGCCATTACCATGAGCGATAACAGCGCCGCCAATCTGCTGCTGGCCACCGTCGGCGGCCCCGCAGGATTGACTGCCTTTTTGCGCCAGATCGGCGACAACGTCACCCGCCTTGACCGCTGGGAAACGGAACTGAATGAGGCGCTTCCCGGCGACGCCCGCGACACCACTACCCCGGCCAGCATGGCCGCGACCCTGCGCAAGCTGCTGACCAGCCAGCGTCTGAGCGCCCGTTCGCAACGGCAGCTGCTGCAGTGGATGGTGGACGATCGGGTCGCCGGACCGTTGATCCGCTCCGTGCTGCCGGCGGGCTGGTTTATCGCCGATAAGACCGGAGCTAGCAAGCGGGGTGCGCGCGGGATTGTCGCCCTGCTTGGCCCGAATAACAAAGCAGAGCGCATTGTGGTGATTTATCTGCGGGATACGCCGGCGAGCATGGCCGAGCG
222	gb|AJ854182|+|0-801|ARO:3001798|OXA-74	ATGAAAACATTTGCCGCATATGTAATTATCGCGTGTCTTTCGAGTACGGCATTA...TAA	801.0	659	1405	746	801	ATGAAAACATTTGCCGCATATGTAATTATCGCGTGTCTTTCGAGTACGGCATTAGCTGGTTCAATTACAGAAAATACGTCTTGGAACAAAGAGTTCTCTGCCGAAGCCGTCAATGGTGTCTTCGTGCTTTGTAAAAGTAGCAGTAAATCCTGCGCTACCAATGACTTAGCTCGTGCATCAAAGGAATATCTTCCAGCATCAACATTTAAGATCCCCAACGCAATTATCGGCCTAGAAACTGGTGTCATAAAGAATGAGCATCAGGTTTTCAAATGGGACGGAAAGCCAAGAGCCATGAAGCAATGGGAAAGAGACTTGACCTTAAGAGGGGCAATACAAGTTTCAGCTGTTCCCGTATTTCAACAAATCGCCAGAGAAGTTGGCGAAGTAAGAATGCAGAAATACCTTAAAAAATTTTCCTATGGCAACCAGAATATCAGTGGTGGCATTGACAAATTCTGGTTGGAAGGCCAGCTTAGAATTTCCGCAGTTAATCAAGTGGAGTTTCTAGAGTCTCTATATTTAAATAAATTGTCAGCATCTAAAGAAAACCAGCTAATAGTAAAAGAGGCTTTGGTAACGGAGGCGGCACCTGAATATCTAGTGCATTCAAAAACTGGTTTTTCTGGTGTGGGAACTGAGTCAAATCCTGGTGTCGCATGGTGGGTTGGGTGGGTTGAGAAGGAGACAGAGGTTTACTTTTTCGCCTTTAACATGGATATAGACAACGAAAGTAAGTTGCCGCT
223	gb|JX121124|+|0-861|ARO:3001196|SHV-157	ATGCGTTATATTCGCCTGTGTATTATCTCCCTGTTAGCCACCCTGCCGCTGGCG...TAA	861.0	16	822	806	861	ATGCGTTATATTCGCCTGTGTATTATCACCCTGTGAGCCACCCTGCCGCTGGCGGTACACGCCAGCCCGCAGCCGCTTGAGCAAATTAAACAAAGCGAAAGCCAGCTGTCGGGCCGCGTAGGCATGATAGAAATGGATCTGGCCAGCGGCCGCACGCTGACCGCCTGGCGCGCCGATGAACGCTTTCCCATGATGAGCACCTTTAAAGTAGTGCTCTGCGGCGCAGTGCTGGCGCGGGTGGATGCCGGTGACGAACAGCTGGAGCGAAAGATCCACTATCGCCAGCAGGATCTGGTGGACTACTCGCCGGTCAGCGAAAAACACCTTGCCGACGGCATGACGGTCGGCGAACTCTGCGCCGCCGCCATTACCATGAGCGATAACAGCGCCGCCAATCTGCTGCTGGCCACCGTCGGCGGCCCCGCAGGATTGACTGCCTTTTTGCGCCAGATCGGCGACAACGTCACCCGCCTTGACCGCTGGGAAACGGAACTGAATGAGGCGCTTCCCGGCGACGCCCGCGACACCACTACCCCGGCCAGCATGGCCGCGACCCTGCGCAAGCTGCTGACCAGCCAGCGTCTGAGCGCCCGTTCGCAACGGCAGCTGCTGCAGTGGATGGTGGACGATCGGGTCGCCGGACCGTTGATCCGCTCCGTGCTGCCGGCGGGCTGGTTTATCGCCGATAAGACCGGAGCTAGCAAGCGGGGTGCGCGCGGGATTGTCGCCCTGCTTGGCCCGAATAACAAAGCAGAGCGCATTGTGGTGATTTATCTGCGGGATACGCCGGCGAGCATGGCCGAGCG
224	gb|DQ322460|+|15-876|ARO:3001139|SHV-85	ATGCGTTATATTCGCCTGTGTATTATCTCCCTGTTAGCCACCATGCCGCTGGCG...TAA	861.0	16	822	806	861	ATGCGTTATATTCGCCTGTGTATTATCACCCTGTGAGCCACCCTGCCGCTGGCGGTACACGCCAGCCCGCAGCCGCTTGAGCAAATTAAACAAAGCGAAAGCCAGCTGTCGGGCCGCGTAGGCATGATAGAAATGGATCTGGCCAGCGGCCGCACGCTGACCGCCTGGCGCGCCGATGAACGCTTTCCCATGATGAGCACCTTTAAAGTAGTGCTCTGCGGCGCAGTGCTGGCGCGGGTGGATGCCGGTGACGAACAGCTGGAGCGAAAGATCCACTATCGCCAGCAGGATCTGGTGGACTACTCGCCGGTCAGCGAAAAACACCTTGCCGACGGCATGACGGTCGGCGAACTCTGCGCCGCCGCCATTACCATGAGCGATAACAGCGCCGCCAATCTGCTGCTGGCCACCGTCGGCGGCCCCGCAGGATTGACTGCCTTTTTGCGCCAGATCGGCGACAACGTCACCCGCCTTGACCGCTGGGAAACGGAACTGAATGAGGCGCTTCCCGGCGACGCCCGCGACACCACTACCCCGGCCAGCATGGCCGCGACCCTGCGCAAGCTGCTGACCAGCCAGCGTCTGAGCGCCCGTTCGCAACGGCAGCTGCTGCAGTGGATGGTGGACGATCGGGTCGCCGGACCGTTGATCCGCTCCGTGCTGCCGGCGGGCTGGTTTATCGCCGATAAGACCGGAGCTAGCAAGCGGGGTGCGCGCGGGATTGTCGCCCTGCTTGGCCCGAATAACAAAGCAGAGCGCATTGTGGTGATTTATCTGCGGGATACGCCGGCGAGCATGGCCGAGCG
225	gb|KF048915.1|+|0-825|ARO:3001530|OXA-342	ATGAACATTAAAGCACTCTTACTTATAACAAGCGCTATTTTTATTTCAGCCTGC...TAG	825.0	54149	54919	770	825	ATGAACATTAAAGCACTCTTACTTATAACAAGCGCTATTTTTATTTCAGCCTGCTCACCTTATATAGTGACTGCTAATCCAAATCACAGCGCTTCAAAATCTGATGTAAAAGCAGAGAAAATTAAAAATTTATTTAACGAAGCACACACTACGGGTGTTTTAGTTATCCAACAAGGCCAAACTCAACAAAGCTATGGTAATGATCTTGCTCGTGCTTCGACCGAGTATGTACCTGCTTCGACCTTCAAAATGCTTAATGCTTTGATCGGCCTTGAGCACCATAAGGCAACCACCACAGAAGTATTTAAGTGGGATGGTAAAAAAAGGTTATTCCCAGAATGGGAAAAGGACATGACCCTAGGCGATGCCATGAAAGCTTCCGCTATTCCAGTTTATCAAGATTTAGCTCGTCGTATTGGACTTGAGCTCATGTCTAAGGAAGTGAAGCGTGTTGGTTATGGCAATGCAGATATCGGTACCCAAGTCGATAATTTTTGGCTGGTGGGTCCTTTAAAAATTACTCCTCAGCAAGAGGCACAGTTTGCTTACAAGCTAGCTAATAAAACGCTTCCATTTAGCCAAAAAGTCCAAGATGAAGTGCAATCCATGCTATTCATAGAAGAAAAGAATGGAAACAAAATATACGCAAAAAGTGGTTGGGGATGGGATGTAAACCCACAAGTAGGCTGGTTAACTGGATGGGTTGTTCAGCCTCAAGGGAATATTGTAGCGTTCTCCCTTAACTTAGAAATGAAAAAAGGAATACCTAG
226	gb|KR057745.1|+|0-1116|ARO:3004339|PDC-76	GGCGAGGCCCCGGCGGATCGCCTGAAGGCACTGGTCGACGCCGCCGTACAACCG...TGA	1116.0	35594	36652	1058	1116	GAGGCCCCGGCGGATCGCCTGAAGGCACTGGTCGACGCCGCCGTACAACCGGTGATGAAGGCCAATGACATTCCGGGCCTGGCCGTAGCCATCAGCCTGAAAGGAGAACCGCATTACTTCAGCTATGGGCTGGCCTCGAAAGAGGACGGCCGCCGGGTGACGCCGGAGACCCTGTTCGAGATCGGCTCGGTGAGCAAGACCTTCACCGTCACCCTCGCCGGCTATGCCCTGGCCCAGGACAAGATGCGCCTCGACGACCGCGCCAGCCAGCACTGGCCGGCACTGCAGGGCAGCCGCTTCGACGGCATCAGCCTGCTCGACCTCGCGACCTATACCGCCGGCGGCTTGCCGCTGCAGTTCCCCGACTCGGTGCAGAAGGACCAGGCACAGATCCGCGACTACTACCGCCAGTGGCAGCCGACCTACGCGCCGGGCAGCCAGCGCCTCTATTCCAACCCGAGCATCGGCCTGTTCGGCTATCTCGCCGCGCGCAGCCTGGGCCAGCCGTTCGAACGGCTCATGGAGCAGCAATTGTTCCCGGCACTGGGCCTCGAACAGACCCACCTCGACGTGCCCGAGGCGGCGCTGGCGCAGTACGCCCAGGGCTACGGCAAGGACGACCGCCCGCTACGGGTCGGTCCCGGCCCGCTGGATGCCGAAGGCTACGGGGTGAAGACCAGCGCGGCCGACCTGCTGCGCTTCGTCGATGCCAACCTGCATCCGGAGCGCCTGGACAGGCCCTGGGCGCAGGCGCTCGATGCCACCCATCGCGGTTACTACAAGGTCGGCGACATGACCCAGGGCCTGGGCTGGGAAGCCTACGACTGGCCGATCTCCCTGAAGCGCCTGCAGGCCGGCAACTCGACGCCGATGGCGCTGCAACCACACAGGATCGCCAGGCTGCCCGCGCCACAGGCGCTGGAGGGCCAGCGCCTGCTGAACAAGACCGGCTCCACCAACGGCTTCGGCGCCTACGTGGCGTTCGTCCCGGGCCGCGACCTGGGCCTGGTGATCCTGGCCAACCGCAACTATCCCAATGCCGAGCGGGTGAAGATCGC
227	gb|HM113559|+|0-825|ARO:3001657|OXA-173	ATGAACATTAAAGCACTCTTACTTATAACAAGCGCTATTTTTATTTCAGCCTGC...TAG	825.0	54149	54919	770	825	ATGAACATTAAAGCACTCTTACTTATAACAAGCGCTATTTTTATTTCAGCCTGCTCACCTTATATAGTGACTGCTAATCCAAATCACAGCGCTTCAAAATCTGATGTAAAAGCAGAGAAAATTAAAAATTTATTTAACGAAGCACACACTACGGGTGTTTTAGTTATCCAACAAGGCCAAACTCAACAAAGCTATGGTAATGATCTTGCTCGTGCTTCGACCGAGTATGTACCTGCTTCGACCTTCAAAATGCTTAATGCTTTGATCGGCCTTGAGCACCATAAGGCAACCACCACAGAAGTATTTAAGTGGGATGGTAAAAAAAGGTTATTCCCAGAATGGGAAAAGGACATGACCCTAGGCGATGCCATGAAAGCTTCCGCTATTCCAGTTTATCAAGATTTAGCTCGTCGTATTGGACTTGAGCTCATGTCTAAGGAAGTGAAGCGTGTTGGTTATGGCAATGCAGATATCGGTACCCAAGTCGATAATTTTTGGCTGGTGGGTCCTTTAAAAATTACTCCTCAGCAAGAGGCACAGTTTGCTTACAAGCTAGCTAATAAAACGCTTCCATTTAGCCAAAAAGTCCAAGATGAAGTGCAATCCATGCTATTCATAGAAGAAAAGAATGGAAACAAAATATACGCAAAAAGTGGTTGGGGATGGGATGTAAACCCACAAGTAGGCTGGTTAACTGGATGGGTTGTTCAGCCTCAAGGGAATATTGTAGCGTTCTCCCTTAACTTAGAAATGAAAAAAGGAATACCTAG
228	gb|JX121125|+|0-858|ARO:3001197|SHV-158	ATGCGTTATATTCGCCTGTGTATTATCTCCCTGTTAGCCACCCTGCCGCTGGCG...CGC	858.0	16	819	803	858	ATGCGTTATATTCGCCTGTGTATTATCACCCTGTGAGCCACCCTGCCGCTGGCGGTACACGCCAGCCCGCAGCCGCTTGAGCAAATTAAACAAAGCGAAAGCCAGCTGTCGGGCCGCGTAGGCATGATAGAAATGGATCTGGCCAGCGGCCGCACGCTGACCGCCTGGCGCGCCGATGAACGCTTTCCCATGATGAGCACCTTTAAAGTAGTGCTCTGCGGCGCAGTGCTGGCGCGGGTGGATGCCGGTGACGAACAGCTGGAGCGAAAGATCCACTATCGCCAGCAGGATCTGGTGGACTACTCGCCGGTCAGCGAAAAACACCTTGCCGACGGCATGACGGTCGGCGAACTCTGCGCCGCCGCCATTACCATGAGCGATAACAGCGCCGCCAATCTGCTGCTGGCCACCGTCGGCGGCCCCGCAGGATTGACTGCCTTTTTGCGCCAGATCGGCGACAACGTCACCCGCCTTGACCGCTGGGAAACGGAACTGAATGAGGCGCTTCCCGGCGACGCCCGCGACACCACTACCCCGGCCAGCATGGCCGCGACCCTGCGCAAGCTGCTGACCAGCCAGCGTCTGAGCGCCCGTTCGCAACGGCAGCTGCTGCAGTGGATGGTGGACGATCGGGTCGCCGGACCGTTGATCCGCTCCGTGCTGCCGGCGGGCTGGTTTATCGCCGATAAGACCGGAGCTAGCAAGCGGGGTGCGCGCGGGATTGTCGCCCTGCTTGGCCCGAATAACAAAGCAGAGCGCATTGTGGTGATTTATCTGCGGGATACGCCGGCGAGCATGGCCGA
229	gb|LT985229.1|+|36107-36968|ARO:3001063|SHV-4	ATGCGTTATATTCGCCTGTGTATTATCTCCCTGTTAGCCACCCTGCCGCTGGCG...TAA	861.0	16	822	806	861	ATGCGTTATATTCGCCTGTGTATTATCACCCTGTGAGCCACCCTGCCGCTGGCGGTACACGCCAGCCCGCAGCCGCTTGAGCAAATTAAACAAAGCGAAAGCCAGCTGTCGGGCCGCGTAGGCATGATAGAAATGGATCTGGCCAGCGGCCGCACGCTGACCGCCTGGCGCGCCGATGAACGCTTTCCCATGATGAGCACCTTTAAAGTAGTGCTCTGCGGCGCAGTGCTGGCGCGGGTGGATGCCGGTGACGAACAGCTGGAGCGAAAGATCCACTATCGCCAGCAGGATCTGGTGGACTACTCGCCGGTCAGCGAAAAACACCTTGCCGACGGCATGACGGTCGGCGAACTCTGCGCCGCCGCCATTACCATGAGCGATAACAGCGCCGCCAATCTGCTGCTGGCCACCGTCGGCGGCCCCGCAGGATTGACTGCCTTTTTGCGCCAGATCGGCGACAACGTCACCCGCCTTGACCGCTGGGAAACGGAACTGAATGAGGCGCTTCCCGGCGACGCCCGCGACACCACTACCCCGGCCAGCATGGCCGCGACCCTGCGCAAGCTGCTGACCAGCCAGCGTCTGAGCGCCCGTTCGCAACGGCAGCTGCTGCAGTGGATGGTGGACGATCGGGTCGCCGGACCGTTGATCCGCTCCGTGCTGCCGGCGGGCTGGTTTATCGCCGATAAGACCGGAGCTAGCAAGCGGGGTGCGCGCGGGATTGTCGCCCTGCTTGGCCCGAATAACAAAGCAGAGCGCATTGTGGTGATTTATCTGCGGGATACGCCGGCGAGCATGGCCGAGCG
230	gb|NWUK01000007.1|-|12139-12964|ARO:3001531|OXA-343	ATGAACATTAAAGCACTCTTACTTATAACAAGCGCTATTTTTATTTCAGCCTGC...TAG	825.0	54149	54919	770	825	ATGAACATTAAAGCACTCTTACTTATAACAAGCGCTATTTTTATTTCAGCCTGCTCACCTTATATAGTGACTGCTAATCCAAATCACAGCGCTTCAAAATCTGATGTAAAAGCAGAGAAAATTAAAAATTTATTTAACGAAGCACACACTACGGGTGTTTTAGTTATCCAACAAGGCCAAACTCAACAAAGCTATGGTAATGATCTTGCTCGTGCTTCGACCGAGTATGTACCTGCTTCGACCTTCAAAATGCTTAATGCTTTGATCGGCCTTGAGCACCATAAGGCAACCACCACAGAAGTATTTAAGTGGGATGGTAAAAAAAGGTTATTCCCAGAATGGGAAAAGGACATGACCCTAGGCGATGCCATGAAAGCTTCCGCTATTCCAGTTTATCAAGATTTAGCTCGTCGTATTGGACTTGAGCTCATGTCTAAGGAAGTGAAGCGTGTTGGTTATGGCAATGCAGATATCGGTACCCAAGTCGATAATTTTTGGCTGGTGGGTCCTTTAAAAATTACTCCTCAGCAAGAGGCACAGTTTGCTTACAAGCTAGCTAATAAAACGCTTCCATTTAGCCAAAAAGTCCAAGATGAAGTGCAATCCATGCTATTCATAGAAGAAAAGAATGGAAACAAAATATACGCAAAAAGTGGTTGGGGATGGGATGTAAACCCACAAGTAGGCTGGTTAACTGGATGGGTTGTTCAGCCTCAAGGGAATATTGTAGCGTTCTCCCTTAACTTAGAAATGAAAAAAGGAATACCTAG
231	gb|EU652244.1|+|0-1152|ARO:3003871|ADC-39	ATGCGATTTAAAAAAATTTCTTGTCTACTTTTATCCCCGCTTTTTATTTTTAGT...TAA	1152.0	63	1160	1097	1152	ATGCGATTTAAAAAAATTTCTTGTCTACTTTTATCCCCGCTTTTTATTTTTAGTACCTCAATTTATGCGGGCAATACACCAAAAGACCAAGAAATTAAAAAACTGGTAGATCAAAACTTTAAACCGTTATTAGAAAAATATGATGTGCCAGGTATGGCTGTGGGTGTTATTCAAAATAATAAAAAGTATGAAATGTATTATGGTCTTCAATCTGTTCAAGATAAAAAAGCCGTAAATAGCAGTACTATTTTTGAGCTAGGTTCTGTCAGTAAATTATTTACCGCGACAGCAGGTGGATATGCAAAAAATAAAGGAAAAATCTCTTTTGACGATACGCCTGGTAAGTATTGGAAAGAACTAAAAAATACACCGATTGACCAAGTTAACTTACTTCAACTCGCGACGTATACAAGTGGTAACCTTGCCTTGCAATTTCCAGATGAAGTAAAAACAGATCAGCAAGTTTTAACATTTTTTAAAGACTGGAAACCTAAAAACTCAATCGGTGAATATCGACAATATTCAAACCCAAGCATTGGTTTATTTGGAAAAGTTGTAGCTTTGTCTATGAATAAACCTTTCGACCAAGTCTTAGAAAAAACAATTTTTCCGGCCCTTGGCTTAAAACATAGCTATGTAAATGTACCTAAGACCCAGATGCAAAACTATGCTTTTGGCTATAACCAAGAAAATCAGCCGATTCGAGTTAACCCCGGCCCACTCGATGCCCCAGCATATGGCGTCAAATCGACACTACCCGACATGTTGAGTTTTATTCATGCCAACCTAAATCCACAAAAATATCCAGCAGATATTCAACGGGCAATTAATGAAACACATCAGGGTCGCTATCAAGTAAATACCATGTATCAGGCACTCGGTTGGGAAGAGTTTTCTTATCCGGCAACGTTACAAACTTTATTAGACAGTAATTCAGAACAGATTGTGATGAAACCTAATAAAGTGACTGCTATTTCAAAGGAACCTTCAGTTAAGATGTACCATAAAACTGGCTCAACTACCGGTTTCGGAACATATGTGGTGTTTATTCCTAAAGAAAATATTGGTTTAGTCATGTTAACCAATAAACGTATTCC
232	gb|DQ328802|+|0-861|ARO:3001140|SHV-86	ATGCGTTTTATTCGCCTGTGTATTATCTCCCTGTTAGCCACCCTGCCGCTGGCG...TAA	861.0	16	822	806	861	ATGCGTTATATTCGCCTGTGTATTATCACCCTGTGAGCCACCCTGCCGCTGGCGGTACACGCCAGCCCGCAGCCGCTTGAGCAAATTAAACAAAGCGAAAGCCAGCTGTCGGGCCGCGTAGGCATGATAGAAATGGATCTGGCCAGCGGCCGCACGCTGACCGCCTGGCGCGCCGATGAACGCTTTCCCATGATGAGCACCTTTAAAGTAGTGCTCTGCGGCGCAGTGCTGGCGCGGGTGGATGCCGGTGACGAACAGCTGGAGCGAAAGATCCACTATCGCCAGCAGGATCTGGTGGACTACTCGCCGGTCAGCGAAAAACACCTTGCCGACGGCATGACGGTCGGCGAACTCTGCGCCGCCGCCATTACCATGAGCGATAACAGCGCCGCCAATCTGCTGCTGGCCACCGTCGGCGGCCCCGCAGGATTGACTGCCTTTTTGCGCCAGATCGGCGACAACGTCACCCGCCTTGACCGCTGGGAAACGGAACTGAATGAGGCGCTTCCCGGCGACGCCCGCGACACCACTACCCCGGCCAGCATGGCCGCGACCCTGCGCAAGCTGCTGACCAGCCAGCGTCTGAGCGCCCGTTCGCAACGGCAGCTGCTGCAGTGGATGGTGGACGATCGGGTCGCCGGACCGTTGATCCGCTCCGTGCTGCCGGCGGGCTGGTTTATCGCCGATAAGACCGGAGCTAGCAAGCGGGGTGCGCGCGGGATTGTCGCCCTGCTTGGCCCGAATAACAAAGCAGAGCGCATTGTGGTGATTTATCTGCGGGATACGCCGGCGAGCATGGCCGAGCG
233	gb|AF535128|+|0-861|ARO:3001098|SHV-40	ATGCGTTATATTCGCCTGTGTATTATCTCCCTGTTAGCCACCCTGCCGCTGGCG...TAA	861.0	16	822	806	861	ATGCGTTATATTCGCCTGTGTATTATCACCCTGTGAGCCACCCTGCCGCTGGCGGTACACGCCAGCCCGCAGCCGCTTGAGCAAATTAAACAAAGCGAAAGCCAGCTGTCGGGCCGCGTAGGCATGATAGAAATGGATCTGGCCAGCGGCCGCACGCTGACCGCCTGGCGCGCCGATGAACGCTTTCCCATGATGAGCACCTTTAAAGTAGTGCTCTGCGGCGCAGTGCTGGCGCGGGTGGATGCCGGTGACGAACAGCTGGAGCGAAAGATCCACTATCGCCAGCAGGATCTGGTGGACTACTCGCCGGTCAGCGAAAAACACCTTGCCGACGGCATGACGGTCGGCGAACTCTGCGCCGCCGCCATTACCATGAGCGATAACAGCGCCGCCAATCTGCTGCTGGCCACCGTCGGCGGCCCCGCAGGATTGACTGCCTTTTTGCGCCAGATCGGCGACAACGTCACCCGCCTTGACCGCTGGGAAACGGAACTGAATGAGGCGCTTCCCGGCGACGCCCGCGACACCACTACCCCGGCCAGCATGGCCGCGACCCTGCGCAAGCTGCTGACCAGCCAGCGTCTGAGCGCCCGTTCGCAACGGCAGCTGCTGCAGTGGATGGTGGACGATCGGGTCGCCGGACCGTTGATCCGCTCCGTGCTGCCGGCGGGCTGGTTTATCGCCGATAAGACCGGAGCTAGCAAGCGGGGTGCGCGCGGGATTGTCGCCCTGCTTGGCCCGAATAACAAAGCAGAGCGCATTGTGGTGATTTATCTGCGGGATACGCCGGCGAGCATGGCCGAGCG
234	gb|HM113560|+|0-825|ARO:3001658|OXA-174	ATGAACATTAAAGCACTCTTACTTATAACAAGCGCTATTTTTATTTCAGCCTGC...TAG	825.0	54149	54919	770	825	ATGAACATTAAAGCACTCTTACTTATAACAAGCGCTATTTTTATTTCAGCCTGCTCACCTTATATAGTGACTGCTAATCCAAATCACAGCGCTTCAAAATCTGATGTAAAAGCAGAGAAAATTAAAAATTTATTTAACGAAGCACACACTACGGGTGTTTTAGTTATCCAACAAGGCCAAACTCAACAAAGCTATGGTAATGATCTTGCTCGTGCTTCGACCGAGTATGTACCTGCTTCGACCTTCAAAATGCTTAATGCTTTGATCGGCCTTGAGCACCATAAGGCAACCACCACAGAAGTATTTAAGTGGGATGGTAAAAAAAGGTTATTCCCAGAATGGGAAAAGGACATGACCCTAGGCGATGCCATGAAAGCTTCCGCTATTCCAGTTTATCAAGATTTAGCTCGTCGTATTGGACTTGAGCTCATGTCTAAGGAAGTGAAGCGTGTTGGTTATGGCAATGCAGATATCGGTACCCAAGTCGATAATTTTTGGCTGGTGGGTCCTTTAAAAATTACTCCTCAGCAAGAGGCACAGTTTGCTTACAAGCTAGCTAATAAAACGCTTCCATTTAGCCAAAAAGTCCAAGATGAAGTGCAATCCATGCTATTCATAGAAGAAAAGAATGGAAACAAAATATACGCAAAAAGTGGTTGGGGATGGGATGTAAACCCACAAGTAGGCTGGTTAACTGGATGGGTTGTTCAGCCTCAAGGGAATATTGTAGCGTTCTCCCTTAACTTAGAAATGAAAAAAGGAATACCTAG
235	gb|JX121126|+|0-858|ARO:3001198|SHV-159	ATGCGTTATATTCGCCTGTGTATTATCTCCCTGTTAGCCACCCTGCCGCTGGCG...CGC	858.0	16	819	803	858	ATGCGTTATATTCGCCTGTGTATTATCACCCTGTGAGCCACCCTGCCGCTGGCGGTACACGCCAGCCCGCAGCCGCTTGAGCAAATTAAACAAAGCGAAAGCCAGCTGTCGGGCCGCGTAGGCATGATAGAAATGGATCTGGCCAGCGGCCGCACGCTGACCGCCTGGCGCGCCGATGAACGCTTTCCCATGATGAGCACCTTTAAAGTAGTGCTCTGCGGCGCAGTGCTGGCGCGGGTGGATGCCGGTGACGAACAGCTGGAGCGAAAGATCCACTATCGCCAGCAGGATCTGGTGGACTACTCGCCGGTCAGCGAAAAACACCTTGCCGACGGCATGACGGTCGGCGAACTCTGCGCCGCCGCCATTACCATGAGCGATAACAGCGCCGCCAATCTGCTGCTGGCCACCGTCGGCGGCCCCGCAGGATTGACTGCCTTTTTGCGCCAGATCGGCGACAACGTCACCCGCCTTGACCGCTGGGAAACGGAACTGAATGAGGCGCTTCCCGGCGACGCCCGCGACACCACTACCCCGGCCAGCATGGCCGCGACCCTGCGCAAGCTGCTGACCAGCCAGCGTCTGAGCGCCCGTTCGCAACGGCAGCTGCTGCAGTGGATGGTGGACGATCGGGTCGCCGGACCGTTGATCCGCTCCGTGCTGCCGGCGGGCTGGTTTATCGCCGATAAGACCGGAGCTAGCAAGCGGGGTGCGCGCGGGATTGTCGCCCTGCTTGGCCCGAATAACAAAGCAGAGCGCATTGTGGTGATTTATCTGCGGGATACGCCGGCGAGCATGGCCGA
236	gb|KF048917.1|+|0-825|ARO:3001532|OXA-344	ATGAACATTAAAGCACTCTTACTTATAACAAGCGCTATTTTTATTTCAGCCTGC...TAG	825.0	54149	54919	770	825	ATGAACATTAAAGCACTCTTACTTATAACAAGCGCTATTTTTATTTCAGCCTGCTCACCTTATATAGTGACTGCTAATCCAAATCACAGCGCTTCAAAATCTGATGTAAAAGCAGAGAAAATTAAAAATTTATTTAACGAAGCACACACTACGGGTGTTTTAGTTATCCAACAAGGCCAAACTCAACAAAGCTATGGTAATGATCTTGCTCGTGCTTCGACCGAGTATGTACCTGCTTCGACCTTCAAAATGCTTAATGCTTTGATCGGCCTTGAGCACCATAAGGCAACCACCACAGAAGTATTTAAGTGGGATGGTAAAAAAAGGTTATTCCCAGAATGGGAAAAGGACATGACCCTAGGCGATGCCATGAAAGCTTCCGCTATTCCAGTTTATCAAGATTTAGCTCGTCGTATTGGACTTGAGCTCATGTCTAAGGAAGTGAAGCGTGTTGGTTATGGCAATGCAGATATCGGTACCCAAGTCGATAATTTTTGGCTGGTGGGTCCTTTAAAAATTACTCCTCAGCAAGAGGCACAGTTTGCTTACAAGCTAGCTAATAAAACGCTTCCATTTAGCCAAAAAGTCCAAGATGAAGTGCAATCCATGCTATTCATAGAAGAAAAGAATGGAAACAAAATATACGCAAAAAGTGGTTGGGGATGGGATGTAAACCCACAAGTAGGCTGGTTAACTGGATGGGTTGTTCAGCCTCAAGGGAATATTGTAGCGTTCTCCCTTAACTTAGAAATGAAAAAAGGAATACCTAG
237	gb|AF535129|+|0-861|ARO:3001099|SHV-41	ATGCGTTATATTCGCCTGTGTATTATCTCCCTGTTAGCCACCCTGCCGCTGGCG...TAA	861.0	16	822	806	861	ATGCGTTATATTCGCCTGTGTATTATCACCCTGTGAGCCACCCTGCCGCTGGCGGTACACGCCAGCCCGCAGCCGCTTGAGCAAATTAAACAAAGCGAAAGCCAGCTGTCGGGCCGCGTAGGCATGATAGAAATGGATCTGGCCAGCGGCCGCACGCTGACCGCCTGGCGCGCCGATGAACGCTTTCCCATGATGAGCACCTTTAAAGTAGTGCTCTGCGGCGCAGTGCTGGCGCGGGTGGATGCCGGTGACGAACAGCTGGAGCGAAAGATCCACTATCGCCAGCAGGATCTGGTGGACTACTCGCCGGTCAGCGAAAAACACCTTGCCGACGGCATGACGGTCGGCGAACTCTGCGCCGCCGCCATTACCATGAGCGATAACAGCGCCGCCAATCTGCTGCTGGCCACCGTCGGCGGCCCCGCAGGATTGACTGCCTTTTTGCGCCAGATCGGCGACAACGTCACCCGCCTTGACCGCTGGGAAACGGAACTGAATGAGGCGCTTCCCGGCGACGCCCGCGACACCACTACCCCGGCCAGCATGGCCGCGACCCTGCGCAAGCTGCTGACCAGCCAGCGTCTGAGCGCCCGTTCGCAACGGCAGCTGCTGCAGTGGATGGTGGACGATCGGGTCGCCGGACCGTTGATCCGCTCCGTGCTGCCGGCGGGCTGGTTTATCGCCGATAAGACCGGAGCTAGCAAGCGGGGTGCGCGCGGGATTGTCGCCCTGCTTGGCCCGAATAACAAAGCAGAGCGCATTGTGGTGATTTATCTGCGGGATACGCCGGCGAGCATGGCCGAGCG
238	gb|KF048918.1|+|0-825|ARO:3001533|OXA-345	ATGAACATTAAAGCACTCTTACTTATAACAAGCGCTATTTTTATTTCAGCCTGC...TAG	825.0	54149	54919	770	825	ATGAACATTAAAGCACTCTTACTTATAACAAGCGCTATTTTTATTTCAGCCTGCTCACCTTATATAGTGACTGCTAATCCAAATCACAGCGCTTCAAAATCTGATGTAAAAGCAGAGAAAATTAAAAATTTATTTAACGAAGCACACACTACGGGTGTTTTAGTTATCCAACAAGGCCAAACTCAACAAAGCTATGGTAATGATCTTGCTCGTGCTTCGACCGAGTATGTACCTGCTTCGACCTTCAAAATGCTTAATGCTTTGATCGGCCTTGAGCACCATAAGGCAACCACCACAGAAGTATTTAAGTGGGATGGTAAAAAAAGGTTATTCCCAGAATGGGAAAAGGACATGACCCTAGGCGATGCCATGAAAGCTTCCGCTATTCCAGTTTATCAAGATTTAGCTCGTCGTATTGGACTTGAGCTCATGTCTAAGGAAGTGAAGCGTGTTGGTTATGGCAATGCAGATATCGGTACCCAAGTCGATAATTTTTGGCTGGTGGGTCCTTTAAAAATTACTCCTCAGCAAGAGGCACAGTTTGCTTACAAGCTAGCTAATAAAACGCTTCCATTTAGCCAAAAAGTCCAAGATGAAGTGCAATCCATGCTATTCATAGAAGAAAAGAATGGAAACAAAATATACGCAAAAAGTGGTTGGGGATGGGATGTAAACCCACAAGTAGGCTGGTTAACTGGATGGGTTGTTCAGCCTCAAGGGAATATTGTAGCGTTCTCCCTTAACTTAGAAATGAAAAAAGGAATACCTAG
239	gb|HM113561|+|0-825|ARO:3001659|OXA-175	ATGAACATTAAAGCACTCTTACTTATAACAAGCGCTATTTTTATTTCAGCCTGC...TAG	825.0	54149	54919	770	825	ATGAACATTAAAGCACTCTTACTTATAACAAGCGCTATTTTTATTTCAGCCTGCTCACCTTATATAGTGACTGCTAATCCAAATCACAGCGCTTCAAAATCTGATGTAAAAGCAGAGAAAATTAAAAATTTATTTAACGAAGCACACACTACGGGTGTTTTAGTTATCCAACAAGGCCAAACTCAACAAAGCTATGGTAATGATCTTGCTCGTGCTTCGACCGAGTATGTACCTGCTTCGACCTTCAAAATGCTTAATGCTTTGATCGGCCTTGAGCACCATAAGGCAACCACCACAGAAGTATTTAAGTGGGATGGTAAAAAAAGGTTATTCCCAGAATGGGAAAAGGACATGACCCTAGGCGATGCCATGAAAGCTTCCGCTATTCCAGTTTATCAAGATTTAGCTCGTCGTATTGGACTTGAGCTCATGTCTAAGGAAGTGAAGCGTGTTGGTTATGGCAATGCAGATATCGGTACCCAAGTCGATAATTTTTGGCTGGTGGGTCCTTTAAAAATTACTCCTCAGCAAGAGGCACAGTTTGCTTACAAGCTAGCTAATAAAACGCTTCCATTTAGCCAAAAAGTCCAAGATGAAGTGCAATCCATGCTATTCATAGAAGAAAAGAATGGAAACAAAATATACGCAAAAAGTGGTTGGGGATGGGATGTAAACCCACAAGTAGGCTGGTTAACTGGATGGGTTGTTCAGCCTCAAGGGAATATTGTAGCGTTCTCCCTTAACTTAGAAATGAAAAAAGGAATACCTAG
240	gb|AF072684|+|117-993|ARO:3001075|SHV-16	ATGCGTTATATTCGCCTGTGTATTATCTCCCTGTTAGCCACCCTGCCGCTGGCG...TAA	876.0	16	822	806	876	ATGCGTTATATTCGCCTGTGTATTATCACCCTGTGAGCCACCCTGCCGCTGGCGGTACACGCCAGCCCGCAGCCGCTTGAGCAAATTAAACAAAGCGAAAGCCAGCTGTCGGGCCGCGTAGGCATGATAGAAATGGATCTGGCCAGCGGCCGCACGCTGACCGCCTGGCGCGCCGATGAACGCTTTCCCATGATGAGCACCTTTAAAGTAGTGCTCTGCGGCGCAGTGCTGGCGCGGGTGGATGCCGGTGACGAACAGCTGGAGCGAAAGATCCACTATCGCCAGCAGGATCTGGTGGACTACTCGCCGGTCAGCGAAAAACACCTTGCCGACGGCATGACGGTCGGCGAACTCTGCGCCGCCGCCATTACCATGAGCGATAACAGCGCCGCCAATCTGCTGCTGGCCACCGTCGGCGGCCCCGCAGGATTGACTGCCTTTTTGCGCCAGATCGGCGACAACGTCACCCGCCTTGACCGCTGGGAAACGGAACTGAATGAGGCGCTTCCCGGCGACGCCCGCGACACCACTACCCCGGCCAGCATGGCCGCGACCCTGCGCAAGCTGCTGACCAGCCAGCGTCTGAGCGCCCGTTCGCAACGGCAGCTGCTGCAGTGGATGGTGGACGATCGGGTCGCCGGACCGTTGATCCGCTCCGTGCTGCCGGCGGGCTGGTTTATCGCCGATAAGACCGGAGCTAGCAAGCGGGGTGCGCGCGGGATTGTCGCCCTGCTTGGCCCGAATAACAAAGCAGAGCGCATTGTGGTGATTTATCTGCGGGATACGCCGGCGAGCATGGCCGAGCG
241	gb|DQ193536|+|0-861|ARO:3001141|SHV-89	ATGCGTTATATTCGCCTGTGTATTATCTCCCTGTTAGCCACCCTGCCGCTGGCG...TAA	861.0	16	822	806	861	ATGCGTTATATTCGCCTGTGTATTATCACCCTGTGAGCCACCCTGCCGCTGGCGGTACACGCCAGCCCGCAGCCGCTTGAGCAAATTAAACAAAGCGAAAGCCAGCTGTCGGGCCGCGTAGGCATGATAGAAATGGATCTGGCCAGCGGCCGCACGCTGACCGCCTGGCGCGCCGATGAACGCTTTCCCATGATGAGCACCTTTAAAGTAGTGCTCTGCGGCGCAGTGCTGGCGCGGGTGGATGCCGGTGACGAACAGCTGGAGCGAAAGATCCACTATCGCCAGCAGGATCTGGTGGACTACTCGCCGGTCAGCGAAAAACACCTTGCCGACGGCATGACGGTCGGCGAACTCTGCGCCGCCGCCATTACCATGAGCGATAACAGCGCCGCCAATCTGCTGCTGGCCACCGTCGGCGGCCCCGCAGGATTGACTGCCTTTTTGCGCCAGATCGGCGACAACGTCACCCGCCTTGACCGCTGGGAAACGGAACTGAATGAGGCGCTTCCCGGCGACGCCCGCGACACCACTACCCCGGCCAGCATGGCCGCGACCCTGCGCAAGCTGCTGACCAGCCAGCGTCTGAGCGCCCGTTCGCAACGGCAGCTGCTGCAGTGGATGGTGGACGATCGGGTCGCCGGACCGTTGATCCGCTCCGTGCTGCCGGCGGGCTGGTTTATCGCCGATAAGACCGGAGCTAGCAAGCGGGGTGCGCGCGGGATTGTCGCCCTGCTTGGCCCGAATAACAAAGCAGAGCGCATTGTGGTGATTTATCTGCGGGATACGCCGGCGAGCATGGCCGAGCG
242	gb|CU468230.2|+|1959577-1960402|ARO:3001620|OXA-75	ATGAACATTCAAGCACTCTTACTTATAACAAGCGCTATTTTTATTTCAGCCTGC...TAG	825.0	54149	54919	770	825	ATGAACATTAAAGCACTCTTACTTATAACAAGCGCTATTTTTATTTCAGCCTGCTCACCTTATATAGTGACTGCTAATCCAAATCACAGCGCTTCAAAATCTGATGTAAAAGCAGAGAAAATTAAAAATTTATTTAACGAAGCACACACTACGGGTGTTTTAGTTATCCAACAAGGCCAAACTCAACAAAGCTATGGTAATGATCTTGCTCGTGCTTCGACCGAGTATGTACCTGCTTCGACCTTCAAAATGCTTAATGCTTTGATCGGCCTTGAGCACCATAAGGCAACCACCACAGAAGTATTTAAGTGGGATGGTAAAAAAAGGTTATTCCCAGAATGGGAAAAGGACATGACCCTAGGCGATGCCATGAAAGCTTCCGCTATTCCAGTTTATCAAGATTTAGCTCGTCGTATTGGACTTGAGCTCATGTCTAAGGAAGTGAAGCGTGTTGGTTATGGCAATGCAGATATCGGTACCCAAGTCGATAATTTTTGGCTGGTGGGTCCTTTAAAAATTACTCCTCAGCAAGAGGCACAGTTTGCTTACAAGCTAGCTAATAAAACGCTTCCATTTAGCCAAAAAGTCCAAGATGAAGTGCAATCCATGCTATTCATAGAAGAAAAGAATGGAAACAAAATATACGCAAAAAGTGGTTGGGGATGGGATGTAAACCCACAAGTAGGCTGGTTAACTGGATGGGTTGTTCAGCCTCAAGGGAATATTGTAGCGTTCTCCCTTAACTTAGAAATGAAAAAAGGAATACCTAG
243	gb|KF048919.1|+|0-825|ARO:3001534|OXA-346	ATGAACATTAAAGCACTCTTACTTATAACAAGCGCTATTTTTATTTCAGCCTGC...TAG	825.0	54149	54919	770	825	ATGAACATTAAAGCACTCTTACTTATAACAAGCGCTATTTTTATTTCAGCCTGCTCACCTTATATAGTGACTGCTAATCCAAATCACAGCGCTTCAAAATCTGATGTAAAAGCAGAGAAAATTAAAAATTTATTTAACGAAGCACACACTACGGGTGTTTTAGTTATCCAACAAGGCCAAACTCAACAAAGCTATGGTAATGATCTTGCTCGTGCTTCGACCGAGTATGTACCTGCTTCGACCTTCAAAATGCTTAATGCTTTGATCGGCCTTGAGCACCATAAGGCAACCACCACAGAAGTATTTAAGTGGGATGGTAAAAAAAGGTTATTCCCAGAATGGGAAAAGGACATGACCCTAGGCGATGCCATGAAAGCTTCCGCTATTCCAGTTTATCAAGATTTAGCTCGTCGTATTGGACTTGAGCTCATGTCTAAGGAAGTGAAGCGTGTTGGTTATGGCAATGCAGATATCGGTACCCAAGTCGATAATTTTTGGCTGGTGGGTCCTTTAAAAATTACTCCTCAGCAAGAGGCACAGTTTGCTTACAAGCTAGCTAATAAAACGCTTCCATTTAGCCAAAAAGTCCAAGATGAAGTGCAATCCATGCTATTCATAGAAGAAAAGAATGGAAACAAAATATACGCAAAAAGTGGTTGGGGATGGGATGTAAACCCACAAGTAGGCTGGTTAACTGGATGGGTTGTTCAGCCTCAAGGGAATATTGTAGCGTTCTCCCTTAACTTAGAAATGAAAAAAGGAATACCTAG
244	gb|AY178996.1|+|0-1152|ARO:3003850|ADC-4	ATGCGATTTAAAAAAATTTCTTGTCTACTTTTATCCCCGCTTTTTATTTTTAGT...TAA	1152.0	63	1160	1097	1152	ATGCGATTTAAAAAAATTTCTTGTCTACTTTTATCCCCGCTTTTTATTTTTAGTACCTCAATTTATGCGGGCAATACACCAAAAGACCAAGAAATTAAAAAACTGGTAGATCAAAACTTTAAACCGTTATTAGAAAAATATGATGTGCCAGGTATGGCTGTGGGTGTTATTCAAAATAATAAAAAGTATGAAATGTATTATGGTCTTCAATCTGTTCAAGATAAAAAAGCCGTAAATAGCAGTACTATTTTTGAGCTAGGTTCTGTCAGTAAATTATTTACCGCGACAGCAGGTGGATATGCAAAAAATAAAGGAAAAATCTCTTTTGACGATACGCCTGGTAAGTATTGGAAAGAACTAAAAAATACACCGATTGACCAAGTTAACTTACTTCAACTCGCGACGTATACAAGTGGTAACCTTGCCTTGCAATTTCCAGATGAAGTAAAAACAGATCAGCAAGTTTTAACATTTTTTAAAGACTGGAAACCTAAAAACTCAATCGGTGAATATCGACAATATTCAAACCCAAGCATTGGTTTATTTGGAAAAGTTGTAGCTTTGTCTATGAATAAACCTTTCGACCAAGTCTTAGAAAAAACAATTTTTCCGGCCCTTGGCTTAAAACATAGCTATGTAAATGTACCTAAGACCCAGATGCAAAACTATGCTTTTGGCTATAACCAAGAAAATCAGCCGATTCGAGTTAACCCCGGCCCACTCGATGCCCCAGCATATGGCGTCAAATCGACACTACCCGACATGTTGAGTTTTATTCATGCCAACCTAAATCCACAAAAATATCCAGCAGATATTCAACGGGCAATTAATGAAACACATCAGGGTCGCTATCAAGTAAATACCATGTATCAGGCACTCGGTTGGGAAGAGTTTTCTTATCCGGCAACGTTACAAACTTTATTAGACAGTAATTCAGAACAGATTGTGATGAAACCTAATAAAGTGACTGCTATTTCAAAGGAACCTTCAGTTAAGATGTACCATAAAACTGGCTCAACTACCGGTTTCGGAACATATGTGGTGTTTATTCCTAAAGAAAATATTGGTTTAGTCATGTTAACCAATAAACGTATTCC
245	gb|AY949203|+|0-825|ARO:3001621|OXA-76	ATGAACATTAAAGCACTCTTACTTATAACAAGCGCTATTTTTATTTCAGCCTGC...TAG	825.0	54149	54919	770	825	ATGAACATTAAAGCACTCTTACTTATAACAAGCGCTATTTTTATTTCAGCCTGCTCACCTTATATAGTGACTGCTAATCCAAATCACAGCGCTTCAAAATCTGATGTAAAAGCAGAGAAAATTAAAAATTTATTTAACGAAGCACACACTACGGGTGTTTTAGTTATCCAACAAGGCCAAACTCAACAAAGCTATGGTAATGATCTTGCTCGTGCTTCGACCGAGTATGTACCTGCTTCGACCTTCAAAATGCTTAATGCTTTGATCGGCCTTGAGCACCATAAGGCAACCACCACAGAAGTATTTAAGTGGGATGGTAAAAAAAGGTTATTCCCAGAATGGGAAAAGGACATGACCCTAGGCGATGCCATGAAAGCTTCCGCTATTCCAGTTTATCAAGATTTAGCTCGTCGTATTGGACTTGAGCTCATGTCTAAGGAAGTGAAGCGTGTTGGTTATGGCAATGCAGATATCGGTACCCAAGTCGATAATTTTTGGCTGGTGGGTCCTTTAAAAATTACTCCTCAGCAAGAGGCACAGTTTGCTTACAAGCTAGCTAATAAAACGCTTCCATTTAGCCAAAAAGTCCAAGATGAAGTGCAATCCATGCTATTCATAGAAGAAAAGAATGGAAACAAAATATACGCAAAAAGTGGTTGGGGATGGGATGTAAACCCACAAGTAGGCTGGTTAACTGGATGGGTTGTTCAGCCTCAAGGGAATATTGTAGCGTTCTCCCTTAACTTAGAAATGAAAAAAGGAATACCTAG
246	gb|HM113562|+|0-825|ARO:3001660|OXA-176	ATGAACATTAAAGCACTCTTACTTATAACAAGCGCTATTTTTATTTCAGCCTGC...TAG	825.0	54149	54919	770	825	ATGAACATTAAAGCACTCTTACTTATAACAAGCGCTATTTTTATTTCAGCCTGCTCACCTTATATAGTGACTGCTAATCCAAATCACAGCGCTTCAAAATCTGATGTAAAAGCAGAGAAAATTAAAAATTTATTTAACGAAGCACACACTACGGGTGTTTTAGTTATCCAACAAGGCCAAACTCAACAAAGCTATGGTAATGATCTTGCTCGTGCTTCGACCGAGTATGTACCTGCTTCGACCTTCAAAATGCTTAATGCTTTGATCGGCCTTGAGCACCATAAGGCAACCACCACAGAAGTATTTAAGTGGGATGGTAAAAAAAGGTTATTCCCAGAATGGGAAAAGGACATGACCCTAGGCGATGCCATGAAAGCTTCCGCTATTCCAGTTTATCAAGATTTAGCTCGTCGTATTGGACTTGAGCTCATGTCTAAGGAAGTGAAGCGTGTTGGTTATGGCAATGCAGATATCGGTACCCAAGTCGATAATTTTTGGCTGGTGGGTCCTTTAAAAATTACTCCTCAGCAAGAGGCACAGTTTGCTTACAAGCTAGCTAATAAAACGCTTCCATTTAGCCAAAAAGTCCAAGATGAAGTGCAATCCATGCTATTCATAGAAGAAAAGAATGGAAACAAAATATACGCAAAAAGTGGTTGGGGATGGGATGTAAACCCACAAGTAGGCTGGTTAACTGGATGGGTTGTTCAGCCTCAAGGGAATATTGTAGCGTTCTCCCTTAACTTAGAAATGAAAAAAGGAATACCTAG
247	gb|JX121127|+|0-861|ARO:3001199|SHV-160	ATGCGTTATATTCGCCTGTGTATTATCTCCCTGTTAGCCACCCTGCCGCTGGCG...TAA	861.0	16	822	806	861	ATGCGTTATATTCGCCTGTGTATTATCACCCTGTGAGCCACCCTGCCGCTGGCGGTACACGCCAGCCCGCAGCCGCTTGAGCAAATTAAACAAAGCGAAAGCCAGCTGTCGGGCCGCGTAGGCATGATAGAAATGGATCTGGCCAGCGGCCGCACGCTGACCGCCTGGCGCGCCGATGAACGCTTTCCCATGATGAGCACCTTTAAAGTAGTGCTCTGCGGCGCAGTGCTGGCGCGGGTGGATGCCGGTGACGAACAGCTGGAGCGAAAGATCCACTATCGCCAGCAGGATCTGGTGGACTACTCGCCGGTCAGCGAAAAACACCTTGCCGACGGCATGACGGTCGGCGAACTCTGCGCCGCCGCCATTACCATGAGCGATAACAGCGCCGCCAATCTGCTGCTGGCCACCGTCGGCGGCCCCGCAGGATTGACTGCCTTTTTGCGCCAGATCGGCGACAACGTCACCCGCCTTGACCGCTGGGAAACGGAACTGAATGAGGCGCTTCCCGGCGACGCCCGCGACACCACTACCCCGGCCAGCATGGCCGCGACCCTGCGCAAGCTGCTGACCAGCCAGCGTCTGAGCGCCCGTTCGCAACGGCAGCTGCTGCAGTGGATGGTGGACGATCGGGTCGCCGGACCGTTGATCCGCTCCGTGCTGCCGGCGGGCTGGTTTATCGCCGATAAGACCGGAGCTAGCAAGCGGGGTGCGCGCGGGATTGTCGCCCTGCTTGGCCCGAATAACAAAGCAGAGCGCATTGTGGTGATTTATCTGCGGGATACGCCGGCGAGCATGGCCGAGCG
248	gb|AF535130|+|0-861|ARO:3001100|SHV-42	ATGCGTTATATTCGCCTGTGTATTATCTCCCTGTTAGCCACCCTGCCGCTGGCG...TAA	861.0	16	822	806	861	ATGCGTTATATTCGCCTGTGTATTATCACCCTGTGAGCCACCCTGCCGCTGGCGGTACACGCCAGCCCGCAGCCGCTTGAGCAAATTAAACAAAGCGAAAGCCAGCTGTCGGGCCGCGTAGGCATGATAGAAATGGATCTGGCCAGCGGCCGCACGCTGACCGCCTGGCGCGCCGATGAACGCTTTCCCATGATGAGCACCTTTAAAGTAGTGCTCTGCGGCGCAGTGCTGGCGCGGGTGGATGCCGGTGACGAACAGCTGGAGCGAAAGATCCACTATCGCCAGCAGGATCTGGTGGACTACTCGCCGGTCAGCGAAAAACACCTTGCCGACGGCATGACGGTCGGCGAACTCTGCGCCGCCGCCATTACCATGAGCGATAACAGCGCCGCCAATCTGCTGCTGGCCACCGTCGGCGGCCCCGCAGGATTGACTGCCTTTTTGCGCCAGATCGGCGACAACGTCACCCGCCTTGACCGCTGGGAAACGGAACTGAATGAGGCGCTTCCCGGCGACGCCCGCGACACCACTACCCCGGCCAGCATGGCCGCGACCCTGCGCAAGCTGCTGACCAGCCAGCGTCTGAGCGCCCGTTCGCAACGGCAGCTGCTGCAGTGGATGGTGGACGATCGGGTCGCCGGACCGTTGATCCGCTCCGTGCTGCCGGCGGGCTGGTTTATCGCCGATAAGACCGGAGCTAGCAAGCGGGGTGCGCGCGGGATTGTCGCCCTGCTTGGCCCGAATAACAAAGCAGAGCGCATTGTGGTGATTTATCTGCGGGATACGCCGGCGAGCATGGCCGAGCG
249	gb|HM113563|+|0-825|ARO:3001661|OXA-177	ATGAACATTAAAGCACTCTTACTTATAACAAGCGCTATTTTTATTTCAGCCTGC...TAG	825.0	54149	54919	770	825	ATGAACATTAAAGCACTCTTACTTATAACAAGCGCTATTTTTATTTCAGCCTGCTCACCTTATATAGTGACTGCTAATCCAAATCACAGCGCTTCAAAATCTGATGTAAAAGCAGAGAAAATTAAAAATTTATTTAACGAAGCACACACTACGGGTGTTTTAGTTATCCAACAAGGCCAAACTCAACAAAGCTATGGTAATGATCTTGCTCGTGCTTCGACCGAGTATGTACCTGCTTCGACCTTCAAAATGCTTAATGCTTTGATCGGCCTTGAGCACCATAAGGCAACCACCACAGAAGTATTTAAGTGGGATGGTAAAAAAAGGTTATTCCCAGAATGGGAAAAGGACATGACCCTAGGCGATGCCATGAAAGCTTCCGCTATTCCAGTTTATCAAGATTTAGCTCGTCGTATTGGACTTGAGCTCATGTCTAAGGAAGTGAAGCGTGTTGGTTATGGCAATGCAGATATCGGTACCCAAGTCGATAATTTTTGGCTGGTGGGTCCTTTAAAAATTACTCCTCAGCAAGAGGCACAGTTTGCTTACAAGCTAGCTAATAAAACGCTTCCATTTAGCCAAAAAGTCCAAGATGAAGTGCAATCCATGCTATTCATAGAAGAAAAGAATGGAAACAAAATATACGCAAAAAGTGGTTGGGGATGGGATGTAAACCCACAAGTAGGCTGGTTAACTGGATGGGTTGTTCAGCCTCAAGGGAATATTGTAGCGTTCTCCCTTAACTTAGAAATGAAAAAAGGAATACCTAG
250	gb|KR057746.1|+|0-1116|ARO:3004340|PDC-77	GGCGAGGCCCCGGCGGATCGCCTGAAGGCACTGGTCGACGCCGCCGTACAACCG...TGA	1116.0	35594	36652	1058	1116	GAGGCCCCGGCGGATCGCCTGAAGGCACTGGTCGACGCCGCCGTACAACCGGTGATGAAGGCCAATGACATTCCGGGCCTGGCCGTAGCCATCAGCCTGAAAGGAGAACCGCATTACTTCAGCTATGGGCTGGCCTCGAAAGAGGACGGCCGCCGGGTGACGCCGGAGACCCTGTTCGAGATCGGCTCGGTGAGCAAGACCTTCACCGTCACCCTCGCCGGCTATGCCCTGGCCCAGGACAAGATGCGCCTCGACGACCGCGCCAGCCAGCACTGGCCGGCACTGCAGGGCAGCCGCTTCGACGGCATCAGCCTGCTCGACCTCGCGACCTATACCGCCGGCGGCTTGCCGCTGCAGTTCCCCGACTCGGTGCAGAAGGACCAGGCACAGATCCGCGACTACTACCGCCAGTGGCAGCCGACCTACGCGCCGGGCAGCCAGCGCCTCTATTCCAACCCGAGCATCGGCCTGTTCGGCTATCTCGCCGCGCGCAGCCTGGGCCAGCCGTTCGAACGGCTCATGGAGCAGCAATTGTTCCCGGCACTGGGCCTCGAACAGACCCACCTCGACGTGCCCGAGGCGGCGCTGGCGCAGTACGCCCAGGGCTACGGCAAGGACGACCGCCCGCTACGGGTCGGTCCCGGCCCGCTGGATGCCGAAGGCTACGGGGTGAAGACCAGCGCGGCCGACCTGCTGCGCTTCGTCGATGCCAACCTGCATCCGGAGCGCCTGGACAGGCCCTGGGCGCAGGCGCTCGATGCCACCCATCGCGGTTACTACAAGGTCGGCGACATGACCCAGGGCCTGGGCTGGGAAGCCTACGACTGGCCGATCTCCCTGAAGCGCCTGCAGGCCGGCAACTCGACGCCGATGGCGCTGCAACCACACAGGATCGCCAGGCTGCCCGCGCCACAGGCGCTGGAGGGCCAGCGCCTGCTGAACAAGACCGGCTCCACCAACGGCTTCGGCGCCTACGTGGCGTTCGTCCCGGGCCGCGACCTGGGCCTGGTGATCCTGGCCAACCGCAACTATCCCAATGCCGAGCGGGTGAAGATCGC
251	gb|HM113564|+|0-825|ARO:3001472|OXA-178	ATGAACATTAAAGCACTCTTACTTATAACAAGCGCTATTTTTATTTCAGCCTGC...TAG	825.0	54149	54919	770	825	ATGAACATTAAAGCACTCTTACTTATAACAAGCGCTATTTTTATTTCAGCCTGCTCACCTTATATAGTGACTGCTAATCCAAATCACAGCGCTTCAAAATCTGATGTAAAAGCAGAGAAAATTAAAAATTTATTTAACGAAGCACACACTACGGGTGTTTTAGTTATCCAACAAGGCCAAACTCAACAAAGCTATGGTAATGATCTTGCTCGTGCTTCGACCGAGTATGTACCTGCTTCGACCTTCAAAATGCTTAATGCTTTGATCGGCCTTGAGCACCATAAGGCAACCACCACAGAAGTATTTAAGTGGGATGGTAAAAAAAGGTTATTCCCAGAATGGGAAAAGGACATGACCCTAGGCGATGCCATGAAAGCTTCCGCTATTCCAGTTTATCAAGATTTAGCTCGTCGTATTGGACTTGAGCTCATGTCTAAGGAAGTGAAGCGTGTTGGTTATGGCAATGCAGATATCGGTACCCAAGTCGATAATTTTTGGCTGGTGGGTCCTTTAAAAATTACTCCTCAGCAAGAGGCACAGTTTGCTTACAAGCTAGCTAATAAAACGCTTCCATTTAGCCAAAAAGTCCAAGATGAAGTGCAATCCATGCTATTCATAGAAGAAAAGAATGGAAACAAAATATACGCAAAAAGTGGTTGGGGATGGGATGTAAACCCACAAGTAGGCTGGTTAACTGGATGGGTTGTTCAGCCTCAAGGGAATATTGTAGCGTTCTCCCTTAACTTAGAAATGAAAAAAGGAATACCTAG
252	gb|S82452|+|120-978|ARO:3001068|SHV-9	ATGCGTTATATTCGCCTGTGTATTATCTCCCTGTTAGCCACCCTGCCGCTGGCG...TAA	858.0	16	822	806	858	ATGCGTTATATTCGCCTGTGTATTATCACCCTGTGAGCCACCCTGCCGCTGGCGGTACACGCCAGCCCGCAGCCGCTTGAGCAAATTAAACAAAGCGAAAGCCAGCTGTCGGGCCGCGTAGGCATGATAGAAATGGATCTGGCCAGCGGCCGCACGCTGACCGCCTGGCGCGCCGATGAACGCTTTCCCATGATGAGCACCTTTAAAGTAGTGCTCTGCGGCGCAGTGCTGGCGCGGGTGGATGCCGGTGACGAACAGCTGGAGCGAAAGATCCACTATCGCCAGCAGGATCTGGTGGACTACTCGCCGGTCAGCGAAAAACACCTTGCCGACGGCATGACGGTCGGCGAACTCTGCGCCGCCGCCATTACCATGAGCGATAACAGCGCCGCCAATCTGCTGCTGGCCACCGTCGGCGGCCCCGCAGGATTGACTGCCTTTTTGCGCCAGATCGGCGACAACGTCACCCGCCTTGACCGCTGGGAAACGGAACTGAATGAGGCGCTTCCCGGCGACGCCCGCGACACCACTACCCCGGCCAGCATGGCCGCGACCCTGCGCAAGCTGCTGACCAGCCAGCGTCTGAGCGCCCGTTCGCAACGGCAGCTGCTGCAGTGGATGGTGGACGATCGGGTCGCCGGACCGTTGATCCGCTCCGTGCTGCCGGCGGGCTGGTTTATCGCCGATAAGACCGGAGCTAGCAAGCGGGGTGCGCGCGGGATTGTCGCCCTGCTTGGCCCGAATAACAAAGCAGAGCGCATTGTGGTGATTTATCTGCGGGATACGCCGGCGAGCATGGCCGAGCG
253	gb|JX121128|+|0-861|ARO:3001200|SHV-161	ATGCGTTATATTCGCCTGTGTATTATCTCCCTGTTAGCCACCCTGCCGCTGGCG...TAA	861.0	16	822	806	861	ATGCGTTATATTCGCCTGTGTATTATCACCCTGTGAGCCACCCTGCCGCTGGCGGTACACGCCAGCCCGCAGCCGCTTGAGCAAATTAAACAAAGCGAAAGCCAGCTGTCGGGCCGCGTAGGCATGATAGAAATGGATCTGGCCAGCGGCCGCACGCTGACCGCCTGGCGCGCCGATGAACGCTTTCCCATGATGAGCACCTTTAAAGTAGTGCTCTGCGGCGCAGTGCTGGCGCGGGTGGATGCCGGTGACGAACAGCTGGAGCGAAAGATCCACTATCGCCAGCAGGATCTGGTGGACTACTCGCCGGTCAGCGAAAAACACCTTGCCGACGGCATGACGGTCGGCGAACTCTGCGCCGCCGCCATTACCATGAGCGATAACAGCGCCGCCAATCTGCTGCTGGCCACCGTCGGCGGCCCCGCAGGATTGACTGCCTTTTTGCGCCAGATCGGCGACAACGTCACCCGCCTTGACCGCTGGGAAACGGAACTGAATGAGGCGCTTCCCGGCGACGCCCGCGACACCACTACCCCGGCCAGCATGGCCGCGACCCTGCGCAAGCTGCTGACCAGCCAGCGTCTGAGCGCCCGTTCGCAACGGCAGCTGCTGCAGTGGATGGTGGACGATCGGGTCGCCGGACCGTTGATCCGCTCCGTGCTGCCGGCGGGCTGGTTTATCGCCGATAAGACCGGAGCTAGCAAGCGGGGTGCGCGCGGGATTGTCGCCCTGCTTGGCCCGAATAACAAAGCAGAGCGCATTGTGGTGATTTATCTGCGGGATACGCCGGCGAGCATGGCCGAGCG
254	gb|HM570035|+|0-825|ARO:3001473|OXA-179	ATGAACATTAAAGCCCTCTTACTTATAACAAGCGCTATTTTTATTTCAGCCTGC...TAG	825.0	54149	54919	770	825	ATGAACATTAAAGCACTCTTACTTATAACAAGCGCTATTTTTATTTCAGCCTGCTCACCTTATATAGTGACTGCTAATCCAAATCACAGCGCTTCAAAATCTGATGTAAAAGCAGAGAAAATTAAAAATTTATTTAACGAAGCACACACTACGGGTGTTTTAGTTATCCAACAAGGCCAAACTCAACAAAGCTATGGTAATGATCTTGCTCGTGCTTCGACCGAGTATGTACCTGCTTCGACCTTCAAAATGCTTAATGCTTTGATCGGCCTTGAGCACCATAAGGCAACCACCACAGAAGTATTTAAGTGGGATGGTAAAAAAAGGTTATTCCCAGAATGGGAAAAGGACATGACCCTAGGCGATGCCATGAAAGCTTCCGCTATTCCAGTTTATCAAGATTTAGCTCGTCGTATTGGACTTGAGCTCATGTCTAAGGAAGTGAAGCGTGTTGGTTATGGCAATGCAGATATCGGTACCCAAGTCGATAATTTTTGGCTGGTGGGTCCTTTAAAAATTACTCCTCAGCAAGAGGCACAGTTTGCTTACAAGCTAGCTAATAAAACGCTTCCATTTAGCCAAAAAGTCCAAGATGAAGTGCAATCCATGCTATTCATAGAAGAAAAGAATGGAAACAAAATATACGCAAAAAGTGGTTGGGGATGGGATGTAAACCCACAAGTAGGCTGGTTAACTGGATGGGTTGTTCAGCCTCAAGGGAATATTGTAGCGTTCTCCCTTAACTTAGAAATGAAAAAAGGAATACCTAG
255	gb|AF315786|+|1313-2114|ARO:3001429|OXA-35	ATGAAAACATTTGCCGCATATGTAATTACTGCGTGTCTTTCAAGTACGGCATTA...TAA	801.0	659	1405	746	801	ATGAAAACATTTGCCGCATATGTAATTATCGCGTGTCTTTCGAGTACGGCATTAGCTGGTTCAATTACAGAAAATACGTCTTGGAACAAAGAGTTCTCTGCCGAAGCCGTCAATGGTGTCTTCGTGCTTTGTAAAAGTAGCAGTAAATCCTGCGCTACCAATGACTTAGCTCGTGCATCAAAGGAATATCTTCCAGCATCAACATTTAAGATCCCCAACGCAATTATCGGCCTAGAAACTGGTGTCATAAAGAATGAGCATCAGGTTTTCAAATGGGACGGAAAGCCAAGAGCCATGAAGCAATGGGAAAGAGACTTGACCTTAAGAGGGGCAATACAAGTTTCAGCTGTTCCCGTATTTCAACAAATCGCCAGAGAAGTTGGCGAAGTAAGAATGCAGAAATACCTTAAAAAATTTTCCTATGGCAACCAGAATATCAGTGGTGGCATTGACAAATTCTGGTTGGAAGGCCAGCTTAGAATTTCCGCAGTTAATCAAGTGGAGTTTCTAGAGTCTCTATATTTAAATAAATTGTCAGCATCTAAAGAAAACCAGCTAATAGTAAAAGAGGCTTTGGTAACGGAGGCGGCACCTGAATATCTAGTGCATTCAAAAACTGGTTTTTCTGGTGTGGGAACTGAGTCAAATCCTGGTGTCGCATGGTGGGTTGGGTGGGTTGAGAAGGAGACAGAGGTTTACTTTTTCGCCTTTAACATGGATATAGACAACGAAAGTAAGTTGCCGCT
256	gb|AY065991|+|6-867|ARO:3001101|SHV-43	ATGCGTTATATTCGCCTGTGTATTATCTCCCTGTTAGCCACCCTGCCGCTGGCG...TAA	861.0	16	822	806	861	ATGCGTTATATTCGCCTGTGTATTATCACCCTGTGAGCCACCCTGCCGCTGGCGGTACACGCCAGCCCGCAGCCGCTTGAGCAAATTAAACAAAGCGAAAGCCAGCTGTCGGGCCGCGTAGGCATGATAGAAATGGATCTGGCCAGCGGCCGCACGCTGACCGCCTGGCGCGCCGATGAACGCTTTCCCATGATGAGCACCTTTAAAGTAGTGCTCTGCGGCGCAGTGCTGGCGCGGGTGGATGCCGGTGACGAACAGCTGGAGCGAAAGATCCACTATCGCCAGCAGGATCTGGTGGACTACTCGCCGGTCAGCGAAAAACACCTTGCCGACGGCATGACGGTCGGCGAACTCTGCGCCGCCGCCATTACCATGAGCGATAACAGCGCCGCCAATCTGCTGCTGGCCACCGTCGGCGGCCCCGCAGGATTGACTGCCTTTTTGCGCCAGATCGGCGACAACGTCACCCGCCTTGACCGCTGGGAAACGGAACTGAATGAGGCGCTTCCCGGCGACGCCCGCGACACCACTACCCCGGCCAGCATGGCCGCGACCCTGCGCAAGCTGCTGACCAGCCAGCGTCTGAGCGCCCGTTCGCAACGGCAGCTGCTGCAGTGGATGGTGGACGATCGGGTCGCCGGACCGTTGATCCGCTCCGTGCTGCCGGCGGGCTGGTTTATCGCCGATAAGACCGGAGCTAGCAAGCGGGGTGCGCGCGGGATTGTCGCCCTGCTTGGCCCGAATAACAAAGCAGAGCGCATTGTGGTGATTTATCTGCGGGATACGCCGGCGAGCATGGCCGAGCG
257	gb|AJ575184.1|+|0-1152|ARO:3003851|ADC-5	ATGCGATTTAAAAAAATTTCTTGTCTACTTTTATCCCCGCTTTTTATTTTTAGT...TAA	1152.0	63	1160	1097	1152	ATGCGATTTAAAAAAATTTCTTGTCTACTTTTATCCCCGCTTTTTATTTTTAGTACCTCAATTTATGCGGGCAATACACCAAAAGACCAAGAAATTAAAAAACTGGTAGATCAAAACTTTAAACCGTTATTAGAAAAATATGATGTGCCAGGTATGGCTGTGGGTGTTATTCAAAATAATAAAAAGTATGAAATGTATTATGGTCTTCAATCTGTTCAAGATAAAAAAGCCGTAAATAGCAGTACTATTTTTGAGCTAGGTTCTGTCAGTAAATTATTTACCGCGACAGCAGGTGGATATGCAAAAAATAAAGGAAAAATCTCTTTTGACGATACGCCTGGTAAGTATTGGAAAGAACTAAAAAATACACCGATTGACCAAGTTAACTTACTTCAACTCGCGACGTATACAAGTGGTAACCTTGCCTTGCAATTTCCAGATGAAGTAAAAACAGATCAGCAAGTTTTAACATTTTTTAAAGACTGGAAACCTAAAAACTCAATCGGTGAATATCGACAATATTCAAACCCAAGCATTGGTTTATTTGGAAAAGTTGTAGCTTTGTCTATGAATAAACCTTTCGACCAAGTCTTAGAAAAAACAATTTTTCCGGCCCTTGGCTTAAAACATAGCTATGTAAATGTACCTAAGACCCAGATGCAAAACTATGCTTTTGGCTATAACCAAGAAAATCAGCCGATTCGAGTTAACCCCGGCCCACTCGATGCCCCAGCATATGGCGTCAAATCGACACTACCCGACATGTTGAGTTTTATTCATGCCAACCTAAATCCACAAAAATATCCAGCAGATATTCAACGGGCAATTAATGAAACACATCAGGGTCGCTATCAAGTAAATACCATGTATCAGGCACTCGGTTGGGAAGAGTTTTCTTATCCGGCAACGTTACAAACTTTATTAGACAGTAATTCAGAACAGATTGTGATGAAACCTAATAAAGTGACTGCTATTTCAAAGGAACCTTCAGTTAAGATGTACCATAAAACTGGCTCAACTACCGGTTTCGGAACATATGTGGTGTTTATTCCTAAAGAAAATATTGGTTTAGTCATGTTAACCAATAAACGTATTCC
258	gb|DQ836922|+|0-861|ARO:3001144|SHV-92	ATGCGTTATATTCGCCTGTGTATTATCTCCCTGTTAGCCACCCTGCCGCTGGCG...TAA	861.0	16	822	806	861	ATGCGTTATATTCGCCTGTGTATTATCACCCTGTGAGCCACCCTGCCGCTGGCGGTACACGCCAGCCCGCAGCCGCTTGAGCAAATTAAACAAAGCGAAAGCCAGCTGTCGGGCCGCGTAGGCATGATAGAAATGGATCTGGCCAGCGGCCGCACGCTGACCGCCTGGCGCGCCGATGAACGCTTTCCCATGATGAGCACCTTTAAAGTAGTGCTCTGCGGCGCAGTGCTGGCGCGGGTGGATGCCGGTGACGAACAGCTGGAGCGAAAGATCCACTATCGCCAGCAGGATCTGGTGGACTACTCGCCGGTCAGCGAAAAACACCTTGCCGACGGCATGACGGTCGGCGAACTCTGCGCCGCCGCCATTACCATGAGCGATAACAGCGCCGCCAATCTGCTGCTGGCCACCGTCGGCGGCCCCGCAGGATTGACTGCCTTTTTGCGCCAGATCGGCGACAACGTCACCCGCCTTGACCGCTGGGAAACGGAACTGAATGAGGCGCTTCCCGGCGACGCCCGCGACACCACTACCCCGGCCAGCATGGCCGCGACCCTGCGCAAGCTGCTGACCAGCCAGCGTCTGAGCGCCCGTTCGCAACGGCAGCTGCTGCAGTGGATGGTGGACGATCGGGTCGCCGGACCGTTGATCCGCTCCGTGCTGCCGGCGGGCTGGTTTATCGCCGATAAGACCGGAGCTAGCAAGCGGGGTGCGCGCGGGATTGTCGCCCTGCTTGGCCCGAATAACAAAGCAGAGCGCATTGTGGTGATTTATCTGCGGGATACGCCGGCGAGCATGGCCGAGCG
259	gb|HM570036|+|0-825|ARO:3001474|OXA-180	ATGAACATTAAAGCACTCTTACTTATAACAAGCGCTATTTTTATTTCAGCCTGC...TAG	825.0	54149	54919	770	825	ATGAACATTAAAGCACTCTTACTTATAACAAGCGCTATTTTTATTTCAGCCTGCTCACCTTATATAGTGACTGCTAATCCAAATCACAGCGCTTCAAAATCTGATGTAAAAGCAGAGAAAATTAAAAATTTATTTAACGAAGCACACACTACGGGTGTTTTAGTTATCCAACAAGGCCAAACTCAACAAAGCTATGGTAATGATCTTGCTCGTGCTTCGACCGAGTATGTACCTGCTTCGACCTTCAAAATGCTTAATGCTTTGATCGGCCTTGAGCACCATAAGGCAACCACCACAGAAGTATTTAAGTGGGATGGTAAAAAAAGGTTATTCCCAGAATGGGAAAAGGACATGACCCTAGGCGATGCCATGAAAGCTTCCGCTATTCCAGTTTATCAAGATTTAGCTCGTCGTATTGGACTTGAGCTCATGTCTAAGGAAGTGAAGCGTGTTGGTTATGGCAATGCAGATATCGGTACCCAAGTCGATAATTTTTGGCTGGTGGGTCCTTTAAAAATTACTCCTCAGCAAGAGGCACAGTTTGCTTACAAGCTAGCTAATAAAACGCTTCCATTTAGCCAAAAAGTCCAAGATGAAGTGCAATCCATGCTATTCATAGAAGAAAAGAATGGAAACAAAATATACGCAAAAAGTGGTTGGGGATGGGATGTAAACCCACAAGTAGGCTGGTTAACTGGATGGGTTGTTCAGCCTCAAGGGAATATTGTAGCGTTCTCCCTTAACTTAGAAATGAAAAAAGGAATACCTAG
260	gb|KR057747.1|+|0-1116|ARO:3004341|PDC-78	GGCGAGGCCCCGGCGGATCGCCTGAAGGCACTGGTCGACGCCGCCGTACAACCG...TGA	1116.0	35594	36652	1058	1116	GAGGCCCCGGCGGATCGCCTGAAGGCACTGGTCGACGCCGCCGTACAACCGGTGATGAAGGCCAATGACATTCCGGGCCTGGCCGTAGCCATCAGCCTGAAAGGAGAACCGCATTACTTCAGCTATGGGCTGGCCTCGAAAGAGGACGGCCGCCGGGTGACGCCGGAGACCCTGTTCGAGATCGGCTCGGTGAGCAAGACCTTCACCGTCACCCTCGCCGGCTATGCCCTGGCCCAGGACAAGATGCGCCTCGACGACCGCGCCAGCCAGCACTGGCCGGCACTGCAGGGCAGCCGCTTCGACGGCATCAGCCTGCTCGACCTCGCGACCTATACCGCCGGCGGCTTGCCGCTGCAGTTCCCCGACTCGGTGCAGAAGGACCAGGCACAGATCCGCGACTACTACCGCCAGTGGCAGCCGACCTACGCGCCGGGCAGCCAGCGCCTCTATTCCAACCCGAGCATCGGCCTGTTCGGCTATCTCGCCGCGCGCAGCCTGGGCCAGCCGTTCGAACGGCTCATGGAGCAGCAATTGTTCCCGGCACTGGGCCTCGAACAGACCCACCTCGACGTGCCCGAGGCGGCGCTGGCGCAGTACGCCCAGGGCTACGGCAAGGACGACCGCCCGCTACGGGTCGGTCCCGGCCCGCTGGATGCCGAAGGCTACGGGGTGAAGACCAGCGCGGCCGACCTGCTGCGCTTCGTCGATGCCAACCTGCATCCGGAGCGCCTGGACAGGCCCTGGGCGCAGGCGCTCGATGCCACCCATCGCGGTTACTACAAGGTCGGCGACATGACCCAGGGCCTGGGCTGGGAAGCCTACGACTGGCCGATCTCCCTGAAGCGCCTGCAGGCCGGCAACTCGACGCCGATGGCGCTGCAACCACACAGGATCGCCAGGCTGCCCGCGCCACAGGCGCTGGAGGGCCAGCGCCTGCTGAACAAGACCGGCTCCACCAACGGCTTCGGCGCCTACGTGGCGTTCGTCCCGGGCCGCGACCTGGGCCTGGTGATCCTGGCCAACCGCAACTATCCCAATGCCGAGCGGGTGAAGATCGC
261	gb|HQ662682.1|+|0-1152|ARO:3003878|ADC-56	ATGCGATTTAAAAAAATTTCTTGTCTACTTTTATCCCCGCTTTTTATTTTTAGT...TAA	1152.0	63	1160	1097	1152	ATGCGATTTAAAAAAATTTCTTGTCTACTTTTATCCCCGCTTTTTATTTTTAGTACCTCAATTTATGCGGGCAATACACCAAAAGACCAAGAAATTAAAAAACTGGTAGATCAAAACTTTAAACCGTTATTAGAAAAATATGATGTGCCAGGTATGGCTGTGGGTGTTATTCAAAATAATAAAAAGTATGAAATGTATTATGGTCTTCAATCTGTTCAAGATAAAAAAGCCGTAAATAGCAGTACTATTTTTGAGCTAGGTTCTGTCAGTAAATTATTTACCGCGACAGCAGGTGGATATGCAAAAAATAAAGGAAAAATCTCTTTTGACGATACGCCTGGTAAGTATTGGAAAGAACTAAAAAATACACCGATTGACCAAGTTAACTTACTTCAACTCGCGACGTATACAAGTGGTAACCTTGCCTTGCAATTTCCAGATGAAGTAAAAACAGATCAGCAAGTTTTAACATTTTTTAAAGACTGGAAACCTAAAAACTCAATCGGTGAATATCGACAATATTCAAACCCAAGCATTGGTTTATTTGGAAAAGTTGTAGCTTTGTCTATGAATAAACCTTTCGACCAAGTCTTAGAAAAAACAATTTTTCCGGCCCTTGGCTTAAAACATAGCTATGTAAATGTACCTAAGACCCAGATGCAAAACTATGCTTTTGGCTATAACCAAGAAAATCAGCCGATTCGAGTTAACCCCGGCCCACTCGATGCCCCAGCATATGGCGTCAAATCGACACTACCCGACATGTTGAGTTTTATTCATGCCAACCTAAATCCACAAAAATATCCAGCAGATATTCAACGGGCAATTAATGAAACACATCAGGGTCGCTATCAAGTAAATACCATGTATCAGGCACTCGGTTGGGAAGAGTTTTCTTATCCGGCAACGTTACAAACTTTATTAGACAGTAATTCAGAACAGATTGTGATGAAACCTAATAAAGTGACTGCTATTTCAAAGGAACCTTCAGTTAAGATGTACCATAAAACTGGCTCAACTACCGGTTTCGGAACATATGTGGTGTTTATTCCTAAAGAAAATATTGGTTTAGTCATGTTAACCAATAAACGTATTCC
262	gb|EF373969|+|0-861|ARO:3001145|SHV-93	ATGCGTTATATTCGCCTGTGTATTATCTCCCTGTTAGCCACCCTGCCGCTGGCG...TAA	861.0	16	822	806	861	ATGCGTTATATTCGCCTGTGTATTATCACCCTGTGAGCCACCCTGCCGCTGGCGGTACACGCCAGCCCGCAGCCGCTTGAGCAAATTAAACAAAGCGAAAGCCAGCTGTCGGGCCGCGTAGGCATGATAGAAATGGATCTGGCCAGCGGCCGCACGCTGACCGCCTGGCGCGCCGATGAACGCTTTCCCATGATGAGCACCTTTAAAGTAGTGCTCTGCGGCGCAGTGCTGGCGCGGGTGGATGCCGGTGACGAACAGCTGGAGCGAAAGATCCACTATCGCCAGCAGGATCTGGTGGACTACTCGCCGGTCAGCGAAAAACACCTTGCCGACGGCATGACGGTCGGCGAACTCTGCGCCGCCGCCATTACCATGAGCGATAACAGCGCCGCCAATCTGCTGCTGGCCACCGTCGGCGGCCCCGCAGGATTGACTGCCTTTTTGCGCCAGATCGGCGACAACGTCACCCGCCTTGACCGCTGGGAAACGGAACTGAATGAGGCGCTTCCCGGCGACGCCCGCGACACCACTACCCCGGCCAGCATGGCCGCGACCCTGCGCAAGCTGCTGACCAGCCAGCGTCTGAGCGCCCGTTCGCAACGGCAGCTGCTGCAGTGGATGGTGGACGATCGGGTCGCCGGACCGTTGATCCGCTCCGTGCTGCCGGCGGGCTGGTTTATCGCCGATAAGACCGGAGCTAGCAAGCGGGGTGCGCGCGGGATTGTCGCCCTGCTTGGCCCGAATAACAAAGCAGAGCGCATTGTGGTGATTTATCTGCGGGATACGCCGGCGAGCATGGCCGAGCG
263	gb|HQ111474|+|1056-1857|ARO:3001475|OXA-183	ATGAAAACATTTGCCGCATATGTAATTACTGCGTGTCTTTCAAGTACGGCATTA...TAA	801.0	659	1405	746	801	ATGAAAACATTTGCCGCATATGTAATTATCGCGTGTCTTTCGAGTACGGCATTAGCTGGTTCAATTACAGAAAATACGTCTTGGAACAAAGAGTTCTCTGCCGAAGCCGTCAATGGTGTCTTCGTGCTTTGTAAAAGTAGCAGTAAATCCTGCGCTACCAATGACTTAGCTCGTGCATCAAAGGAATATCTTCCAGCATCAACATTTAAGATCCCCAACGCAATTATCGGCCTAGAAACTGGTGTCATAAAGAATGAGCATCAGGTTTTCAAATGGGACGGAAAGCCAAGAGCCATGAAGCAATGGGAAAGAGACTTGACCTTAAGAGGGGCAATACAAGTTTCAGCTGTTCCCGTATTTCAACAAATCGCCAGAGAAGTTGGCGAAGTAAGAATGCAGAAATACCTTAAAAAATTTTCCTATGGCAACCAGAATATCAGTGGTGGCATTGACAAATTCTGGTTGGAAGGCCAGCTTAGAATTTCCGCAGTTAATCAAGTGGAGTTTCTAGAGTCTCTATATTTAAATAAATTGTCAGCATCTAAAGAAAACCAGCTAATAGTAAAAGAGGCTTTGGTAACGGAGGCGGCACCTGAATATCTAGTGCATTCAAAAACTGGTTTTTCTGGTGTGGGAACTGAGTCAAATCCTGGTGTCGCATGGTGGGTTGGGTGGGTTGAGAAGGAGACAGAGGTTTACTTTTTCGCCTTTAACATGGATATAGACAACGAAAGTAAGTTGCCGCT
264	gb|KF885217|+|0-825|ARO:3001552|OXA-365	ATGAACATTAAAACACTCTTACTTATAACAAGCGCTATTTTTATTTCAGCCTGC...TAG	825.0	54149	54919	770	825	ATGAACATTAAAGCACTCTTACTTATAACAAGCGCTATTTTTATTTCAGCCTGCTCACCTTATATAGTGACTGCTAATCCAAATCACAGCGCTTCAAAATCTGATGTAAAAGCAGAGAAAATTAAAAATTTATTTAACGAAGCACACACTACGGGTGTTTTAGTTATCCAACAAGGCCAAACTCAACAAAGCTATGGTAATGATCTTGCTCGTGCTTCGACCGAGTATGTACCTGCTTCGACCTTCAAAATGCTTAATGCTTTGATCGGCCTTGAGCACCATAAGGCAACCACCACAGAAGTATTTAAGTGGGATGGTAAAAAAAGGTTATTCCCAGAATGGGAAAAGGACATGACCCTAGGCGATGCCATGAAAGCTTCCGCTATTCCAGTTTATCAAGATTTAGCTCGTCGTATTGGACTTGAGCTCATGTCTAAGGAAGTGAAGCGTGTTGGTTATGGCAATGCAGATATCGGTACCCAAGTCGATAATTTTTGGCTGGTGGGTCCTTTAAAAATTACTCCTCAGCAAGAGGCACAGTTTGCTTACAAGCTAGCTAATAAAACGCTTCCATTTAGCCAAAAAGTCCAAGATGAAGTGCAATCCATGCTATTCATAGAAGAAAAGAATGGAAACAAAATATACGCAAAAAGTGGTTGGGGATGGGATGTAAACCCACAAGTAGGCTGGTTAACTGGATGGGTTGTTCAGCCTCAAGGGAATATTGTAGCGTTCTCCCTTAACTTAGAAATGAAAAAAGGAATACCTAG
265	gb|KR057748.1|+|0-1116|ARO:3004342|PDC-79	GGCGAGGCCCCGGCGGATCGCCTGAAGGCACTGGTCGACGCCGCCGTACAACCG...TGA	1116.0	35594	36652	1058	1116	GAGGCCCCGGCGGATCGCCTGAAGGCACTGGTCGACGCCGCCGTACAACCGGTGATGAAGGCCAATGACATTCCGGGCCTGGCCGTAGCCATCAGCCTGAAAGGAGAACCGCATTACTTCAGCTATGGGCTGGCCTCGAAAGAGGACGGCCGCCGGGTGACGCCGGAGACCCTGTTCGAGATCGGCTCGGTGAGCAAGACCTTCACCGTCACCCTCGCCGGCTATGCCCTGGCCCAGGACAAGATGCGCCTCGACGACCGCGCCAGCCAGCACTGGCCGGCACTGCAGGGCAGCCGCTTCGACGGCATCAGCCTGCTCGACCTCGCGACCTATACCGCCGGCGGCTTGCCGCTGCAGTTCCCCGACTCGGTGCAGAAGGACCAGGCACAGATCCGCGACTACTACCGCCAGTGGCAGCCGACCTACGCGCCGGGCAGCCAGCGCCTCTATTCCAACCCGAGCATCGGCCTGTTCGGCTATCTCGCCGCGCGCAGCCTGGGCCAGCCGTTCGAACGGCTCATGGAGCAGCAATTGTTCCCGGCACTGGGCCTCGAACAGACCCACCTCGACGTGCCCGAGGCGGCGCTGGCGCAGTACGCCCAGGGCTACGGCAAGGACGACCGCCCGCTACGGGTCGGTCCCGGCCCGCTGGATGCCGAAGGCTACGGGGTGAAGACCAGCGCGGCCGACCTGCTGCGCTTCGTCGATGCCAACCTGCATCCGGAGCGCCTGGACAGGCCCTGGGCGCAGGCGCTCGATGCCACCCATCGCGGTTACTACAAGGTCGGCGACATGACCCAGGGCCTGGGCTGGGAAGCCTACGACTGGCCGATCTCCCTGAAGCGCCTGCAGGCCGGCAACTCGACGCCGATGGCGCTGCAACCACACAGGATCGCCAGGCTGCCCGCGCCACAGGCGCTGGAGGGCCAGCGCCTGCTGAACAAGACCGGCTCCACCAACGGCTTCGGCGCCTACGTGGCGTTCGTCCCGGGCCGCGACCTGGGCCTGGTGATCCTGGCCAACCGCAACTATCCCAATGCCGAGCGGGTGAAGATCGC
266	gb|EF373970|+|0-861|ARO:3001146|SHV-94	ATGCGTTATATTCGCCTGTGTATTATCTCCCTGTTAGCCACCCTGCCGCTGGCG...TAA	861.0	16	822	806	861	ATGCGTTATATTCGCCTGTGTATTATCACCCTGTGAGCCACCCTGCCGCTGGCGGTACACGCCAGCCCGCAGCCGCTTGAGCAAATTAAACAAAGCGAAAGCCAGCTGTCGGGCCGCGTAGGCATGATAGAAATGGATCTGGCCAGCGGCCGCACGCTGACCGCCTGGCGCGCCGATGAACGCTTTCCCATGATGAGCACCTTTAAAGTAGTGCTCTGCGGCGCAGTGCTGGCGCGGGTGGATGCCGGTGACGAACAGCTGGAGCGAAAGATCCACTATCGCCAGCAGGATCTGGTGGACTACTCGCCGGTCAGCGAAAAACACCTTGCCGACGGCATGACGGTCGGCGAACTCTGCGCCGCCGCCATTACCATGAGCGATAACAGCGCCGCCAATCTGCTGCTGGCCACCGTCGGCGGCCCCGCAGGATTGACTGCCTTTTTGCGCCAGATCGGCGACAACGTCACCCGCCTTGACCGCTGGGAAACGGAACTGAATGAGGCGCTTCCCGGCGACGCCCGCGACACCACTACCCCGGCCAGCATGGCCGCGACCCTGCGCAAGCTGCTGACCAGCCAGCGTCTGAGCGCCCGTTCGCAACGGCAGCTGCTGCAGTGGATGGTGGACGATCGGGTCGCCGGACCGTTGATCCGCTCCGTGCTGCCGGCGGGCTGGTTTATCGCCGATAAGACCGGAGCTAGCAAGCGGGGTGCGCGCGGGATTGTCGCCCTGCTTGGCCCGAATAACAAAGCAGAGCGCATTGTGGTGATTTATCTGCGGGATACGCCGGCGAGCATGGCCGAGCG
267	gb|AY949202|+|0-825|ARO:3001622|OXA-77	ATGAACATTAAAGCACTCTTACTTATCACAAGCGCTATTTTTATTTCAGCCTGC...TAG	825.0	54149	54919	770	825	ATGAACATTAAAGCACTCTTACTTATAACAAGCGCTATTTTTATTTCAGCCTGCTCACCTTATATAGTGACTGCTAATCCAAATCACAGCGCTTCAAAATCTGATGTAAAAGCAGAGAAAATTAAAAATTTATTTAACGAAGCACACACTACGGGTGTTTTAGTTATCCAACAAGGCCAAACTCAACAAAGCTATGGTAATGATCTTGCTCGTGCTTCGACCGAGTATGTACCTGCTTCGACCTTCAAAATGCTTAATGCTTTGATCGGCCTTGAGCACCATAAGGCAACCACCACAGAAGTATTTAAGTGGGATGGTAAAAAAAGGTTATTCCCAGAATGGGAAAAGGACATGACCCTAGGCGATGCCATGAAAGCTTCCGCTATTCCAGTTTATCAAGATTTAGCTCGTCGTATTGGACTTGAGCTCATGTCTAAGGAAGTGAAGCGTGTTGGTTATGGCAATGCAGATATCGGTACCCAAGTCGATAATTTTTGGCTGGTGGGTCCTTTAAAAATTACTCCTCAGCAAGAGGCACAGTTTGCTTACAAGCTAGCTAATAAAACGCTTCCATTTAGCCAAAAAGTCCAAGATGAAGTGCAATCCATGCTATTCATAGAAGAAAAGAATGGAAACAAAATATACGCAAAAAGTGGTTGGGGATGGGATGTAAACCCACAAGTAGGCTGGTTAACTGGATGGGTTGTTCAGCCTCAAGGGAATATTGTAGCGTTCTCCCTTAACTTAGAAATGAAAAAAGGAATACCTAG
268	gb|JX121129|+|0-858|ARO:3001201|SHV-162	ATGCGTTATATTCGCCTGTGTATTATCTCCCTGTTAGCCACCCTGCCGCTGGCG...CGC	858.0	16	819	803	858	ATGCGTTATATTCGCCTGTGTATTATCACCCTGTGAGCCACCCTGCCGCTGGCGGTACACGCCAGCCCGCAGCCGCTTGAGCAAATTAAACAAAGCGAAAGCCAGCTGTCGGGCCGCGTAGGCATGATAGAAATGGATCTGGCCAGCGGCCGCACGCTGACCGCCTGGCGCGCCGATGAACGCTTTCCCATGATGAGCACCTTTAAAGTAGTGCTCTGCGGCGCAGTGCTGGCGCGGGTGGATGCCGGTGACGAACAGCTGGAGCGAAAGATCCACTATCGCCAGCAGGATCTGGTGGACTACTCGCCGGTCAGCGAAAAACACCTTGCCGACGGCATGACGGTCGGCGAACTCTGCGCCGCCGCCATTACCATGAGCGATAACAGCGCCGCCAATCTGCTGCTGGCCACCGTCGGCGGCCCCGCAGGATTGACTGCCTTTTTGCGCCAGATCGGCGACAACGTCACCCGCCTTGACCGCTGGGAAACGGAACTGAATGAGGCGCTTCCCGGCGACGCCCGCGACACCACTACCCCGGCCAGCATGGCCGCGACCCTGCGCAAGCTGCTGACCAGCCAGCGTCTGAGCGCCCGTTCGCAACGGCAGCTGCTGCAGTGGATGGTGGACGATCGGGTCGCCGGACCGTTGATCCGCTCCGTGCTGCCGGCGGGCTGGTTTATCGCCGATAAGACCGGAGCTAGCAAGCGGGGTGCGCGCGGGATTGTCGCCCTGCTTGGCCCGAATAACAAAGCAGAGCGCATTGTGGTGATTTATCTGCGGGATACGCCGGCGAGCATGGCCGA
269	gb|AF043381|+|943-1744|ARO:3001414|OXA-19	ATGAAAACATTTGCCGCATATGTAATTACTGCGTGTCTTTCAAGTACGGCATTA...TAA	801.0	659	1405	746	801	ATGAAAACATTTGCCGCATATGTAATTATCGCGTGTCTTTCGAGTACGGCATTAGCTGGTTCAATTACAGAAAATACGTCTTGGAACAAAGAGTTCTCTGCCGAAGCCGTCAATGGTGTCTTCGTGCTTTGTAAAAGTAGCAGTAAATCCTGCGCTACCAATGACTTAGCTCGTGCATCAAAGGAATATCTTCCAGCATCAACATTTAAGATCCCCAACGCAATTATCGGCCTAGAAACTGGTGTCATAAAGAATGAGCATCAGGTTTTCAAATGGGACGGAAAGCCAAGAGCCATGAAGCAATGGGAAAGAGACTTGACCTTAAGAGGGGCAATACAAGTTTCAGCTGTTCCCGTATTTCAACAAATCGCCAGAGAAGTTGGCGAAGTAAGAATGCAGAAATACCTTAAAAAATTTTCCTATGGCAACCAGAATATCAGTGGTGGCATTGACAAATTCTGGTTGGAAGGCCAGCTTAGAATTTCCGCAGTTAATCAAGTGGAGTTTCTAGAGTCTCTATATTTAAATAAATTGTCAGCATCTAAAGAAAACCAGCTAATAGTAAAAGAGGCTTTGGTAACGGAGGCGGCACCTGAATATCTAGTGCATTCAAAAACTGGTTTTTCTGGTGTGGGAACTGAGTCAAATCCTGGTGTCGCATGGTGGGTTGGGTGGGTTGAGAAGGAGACAGAGGTTTACTTTTTCGCCTTTAACATGGATATAGACAACGAAAGTAAGTTGCCGCT
270	gb|AY259119|+|116-977|ARO:3001102|SHV-44	ATGCGTTATATTCGCCTGTGTATTATCTCCCTGTTAGCCACCCTGCCGCTGGCG...TAA	861.0	16	822	806	861	ATGCGTTATATTCGCCTGTGTATTATCACCCTGTGAGCCACCCTGCCGCTGGCGGTACACGCCAGCCCGCAGCCGCTTGAGCAAATTAAACAAAGCGAAAGCCAGCTGTCGGGCCGCGTAGGCATGATAGAAATGGATCTGGCCAGCGGCCGCACGCTGACCGCCTGGCGCGCCGATGAACGCTTTCCCATGATGAGCACCTTTAAAGTAGTGCTCTGCGGCGCAGTGCTGGCGCGGGTGGATGCCGGTGACGAACAGCTGGAGCGAAAGATCCACTATCGCCAGCAGGATCTGGTGGACTACTCGCCGGTCAGCGAAAAACACCTTGCCGACGGCATGACGGTCGGCGAACTCTGCGCCGCCGCCATTACCATGAGCGATAACAGCGCCGCCAATCTGCTGCTGGCCACCGTCGGCGGCCCCGCAGGATTGACTGCCTTTTTGCGCCAGATCGGCGACAACGTCACCCGCCTTGACCGCTGGGAAACGGAACTGAATGAGGCGCTTCCCGGCGACGCCCGCGACACCACTACCCCGGCCAGCATGGCCGCGACCCTGCGCAAGCTGCTGACCAGCCAGCGTCTGAGCGCCCGTTCGCAACGGCAGCTGCTGCAGTGGATGGTGGACGATCGGGTCGCCGGACCGTTGATCCGCTCCGTGCTGCCGGCGGGCTGGTTTATCGCCGATAAGACCGGAGCTAGCAAGCGGGGTGCGCGCGGGATTGTCGCCCTGCTTGGCCCGAATAACAAAGCAGAGCGCATTGTGGTGATTTATCTGCGGGATACGCCGGCGAGCATGGCCGAGCG
271	gb|JQ319653.1|+|0-1152|ARO:3004618|ADC-58	ATGCGATTTAAAAAAATTTCTTGTTTACTTTTATCCCCGCTTTTTATTTTTAGT...TAA	1152.0	63	1160	1097	1152	ATGCGATTTAAAAAAATTTCTTGTCTACTTTTATCCCCGCTTTTTATTTTTAGTACCTCAATTTATGCGGGCAATACACCAAAAGACCAAGAAATTAAAAAACTGGTAGATCAAAACTTTAAACCGTTATTAGAAAAATATGATGTGCCAGGTATGGCTGTGGGTGTTATTCAAAATAATAAAAAGTATGAAATGTATTATGGTCTTCAATCTGTTCAAGATAAAAAAGCCGTAAATAGCAGTACTATTTTTGAGCTAGGTTCTGTCAGTAAATTATTTACCGCGACAGCAGGTGGATATGCAAAAAATAAAGGAAAAATCTCTTTTGACGATACGCCTGGTAAGTATTGGAAAGAACTAAAAAATACACCGATTGACCAAGTTAACTTACTTCAACTCGCGACGTATACAAGTGGTAACCTTGCCTTGCAATTTCCAGATGAAGTAAAAACAGATCAGCAAGTTTTAACATTTTTTAAAGACTGGAAACCTAAAAACTCAATCGGTGAATATCGACAATATTCAAACCCAAGCATTGGTTTATTTGGAAAAGTTGTAGCTTTGTCTATGAATAAACCTTTCGACCAAGTCTTAGAAAAAACAATTTTTCCGGCCCTTGGCTTAAAACATAGCTATGTAAATGTACCTAAGACCCAGATGCAAAACTATGCTTTTGGCTATAACCAAGAAAATCAGCCGATTCGAGTTAACCCCGGCCCACTCGATGCCCCAGCATATGGCGTCAAATCGACACTACCCGACATGTTGAGTTTTATTCATGCCAACCTAAATCCACAAAAATATCCAGCAGATATTCAACGGGCAATTAATGAAACACATCAGGGTCGCTATCAAGTAAATACCATGTATCAGGCACTCGGTTGGGAAGAGTTTTCTTATCCGGCAACGTTACAAACTTTATTAGACAGTAATTCAGAACAGATTGTGATGAAACCTAATAAAGTGACTGCTATTTCAAAGGAACCTTCAGTTAAGATGTACCATAAAACTGGCTCAACTACCGGTTTCGGAACATATGTGGTGTTTATTCCTAAAGAAAATATTGGTTTAGTCATGTTAACCAATAAACGTATTCC
272	gb|KP050485|+|0-822|ARO:3001553|OXA-366	ATGAATAAATATTTTACTTGCTATGTGGTTGCTTCTCTTTTTCTTTCTGGTTGT...TAA	822.0	80	847	767	822	ATGAATAAATATTTTACTTGCTATGTGGTTGCTTCTCTTTTTCTTTCTGGTTGTACGGTTCAGCATAATTTAATAAATGAAACCCCGAGTCAGATTGTTCAAGGACATAATCAGGTGATTCATCAATACTTTGATGAAAAAAACACCTCAGGTGTGCTGGTTATTCAAACAGATAAAAAAATTAATCTATATGGTAATGCTCTAAGCCGCGCAAATACAGAATATGTGCCAGCCTCTACATTTAAAATGTTGAATGCCCTGATCGGATTGGAGAACCAGAAAACGGATATTAATGAAATATTTAAATGGAAGGGCGAGAAAAGGTCATTTACCGCTTGGGAAAAAGACATGACACTAGGAGAAGCCATGAAGCTTTCTGCAGTCCCAGTCTATCAGGAACTTGCGCGACGTATCGGTCTTGATCTCATGCAAAAAGAAGTAAAACGTATTGGTTTCGGTAATGCTGAAATTGGACAGCAGGTTGATAATTTCTGGTTGGTAGGACCATTAAAGGTTACGCCTATTCAAGAGGTAGAGTTTGTTTCCCAATTAGCACATACACAGCTTCCATTTAGTGAAAAAGTGCAGGCTAATGTAAAAAATATGCTTCTTTTAGAAGAGAGTAATGGCTACAAAATTTTTGGAAAGACTGGTTGGGCAATGGATATAAAACCACAAGTGGGCTGGTTGACCGGCTGGGTTGAGCAGCCAGATGGAAAAATTGTCGCTTTTGCATTAAATATGGAAATGCGGTCAGAAATGCCGGC
273	gb|JX121130|+|0-858|ARO:3001202|SHV-163	ATGCGTTATATTCGCCTGTGTATTATCTCCCTGTTAGCCACCCTGCCGCTGGCG...CAA	858.0	16	817	801	858	ATGCGTTATATTCGCCTGTGTATTATCACCCTGTGAGCCACCCTGCCGCTGGCGGTACACGCCAGCCCGCAGCCGCTTGAGCAAATTAAACAAAGCGAAAGCCAGCTGTCGGGCCGCGTAGGCATGATAGAAATGGATCTGGCCAGCGGCCGCACGCTGACCGCCTGGCGCGCCGATGAACGCTTTCCCATGATGAGCACCTTTAAAGTAGTGCTCTGCGGCGCAGTGCTGGCGCGGGTGGATGCCGGTGACGAACAGCTGGAGCGAAAGATCCACTATCGCCAGCAGGATCTGGTGGACTACTCGCCGGTCAGCGAAAAACACCTTGCCGACGGCATGACGGTCGGCGAACTCTGCGCCGCCGCCATTACCATGAGCGATAACAGCGCCGCCAATCTGCTGCTGGCCACCGTCGGCGGCCCCGCAGGATTGACTGCCTTTTTGCGCCAGATCGGCGACAACGTCACCCGCCTTGACCGCTGGGAAACGGAACTGAATGAGGCGCTTCCCGGCGACGCCCGCGACACCACTACCCCGGCCAGCATGGCCGCGACCCTGCGCAAGCTGCTGACCAGCCAGCGTCTGAGCGCCCGTTCGCAACGGCAGCTGCTGCAGTGGATGGTGGACGATCGGGTCGCCGGACCGTTGATCCGCTCCGTGCTGCCGGCGGGCTGGTTTATCGCCGATAAGACCGGAGCTAGCAAGCGGGGTGCGCGCGGGATTGTCGCCCTGCTTGGCCCGAATAACAAAGCAGAGCGCATTGTGGTGATTTATCTGCGGGATACGCCGGCGAGCATGGCC
274	gb|EF373972|+|0-861|ARO:3001147|SHV-95	ATGCGTTATATTCGCCTGTGTATTATCTCCCTGTTAGCCACCCTGCCGCTGGCG...TAA	861.0	16	822	806	861	ATGCGTTATATTCGCCTGTGTATTATCACCCTGTGAGCCACCCTGCCGCTGGCGGTACACGCCAGCCCGCAGCCGCTTGAGCAAATTAAACAAAGCGAAAGCCAGCTGTCGGGCCGCGTAGGCATGATAGAAATGGATCTGGCCAGCGGCCGCACGCTGACCGCCTGGCGCGCCGATGAACGCTTTCCCATGATGAGCACCTTTAAAGTAGTGCTCTGCGGCGCAGTGCTGGCGCGGGTGGATGCCGGTGACGAACAGCTGGAGCGAAAGATCCACTATCGCCAGCAGGATCTGGTGGACTACTCGCCGGTCAGCGAAAAACACCTTGCCGACGGCATGACGGTCGGCGAACTCTGCGCCGCCGCCATTACCATGAGCGATAACAGCGCCGCCAATCTGCTGCTGGCCACCGTCGGCGGCCCCGCAGGATTGACTGCCTTTTTGCGCCAGATCGGCGACAACGTCACCCGCCTTGACCGCTGGGAAACGGAACTGAATGAGGCGCTTCCCGGCGACGCCCGCGACACCACTACCCCGGCCAGCATGGCCGCGACCCTGCGCAAGCTGCTGACCAGCCAGCGTCTGAGCGCCCGTTCGCAACGGCAGCTGCTGCAGTGGATGGTGGACGATCGGGTCGCCGGACCGTTGATCCGCTCCGTGCTGCCGGCGGGCTGGTTTATCGCCGATAAGACCGGAGCTAGCAAGCGGGGTGCGCGCGGGATTGTCGCCCTGCTTGGCCCGAATAACAAAGCAGAGCGCATTGTGGTGATTTATCTGCGGGATACGCCGGCGAGCATGGCCGAGCG
275	gb|AF547625|+|0-861|ARO:3001103|SHV-45	ATGCGTTATATTCGCCTGTGTATTATCTCCCTGTTAGCCACCCTGCCGCTGGCG...TAA	861.0	16	822	806	861	ATGCGTTATATTCGCCTGTGTATTATCACCCTGTGAGCCACCCTGCCGCTGGCGGTACACGCCAGCCCGCAGCCGCTTGAGCAAATTAAACAAAGCGAAAGCCAGCTGTCGGGCCGCGTAGGCATGATAGAAATGGATCTGGCCAGCGGCCGCACGCTGACCGCCTGGCGCGCCGATGAACGCTTTCCCATGATGAGCACCTTTAAAGTAGTGCTCTGCGGCGCAGTGCTGGCGCGGGTGGATGCCGGTGACGAACAGCTGGAGCGAAAGATCCACTATCGCCAGCAGGATCTGGTGGACTACTCGCCGGTCAGCGAAAAACACCTTGCCGACGGCATGACGGTCGGCGAACTCTGCGCCGCCGCCATTACCATGAGCGATAACAGCGCCGCCAATCTGCTGCTGGCCACCGTCGGCGGCCCCGCAGGATTGACTGCCTTTTTGCGCCAGATCGGCGACAACGTCACCCGCCTTGACCGCTGGGAAACGGAACTGAATGAGGCGCTTCCCGGCGACGCCCGCGACACCACTACCCCGGCCAGCATGGCCGCGACCCTGCGCAAGCTGCTGACCAGCCAGCGTCTGAGCGCCCGTTCGCAACGGCAGCTGCTGCAGTGGATGGTGGACGATCGGGTCGCCGGACCGTTGATCCGCTCCGTGCTGCCGGCGGGCTGGTTTATCGCCGATAAGACCGGAGCTAGCAAGCGGGGTGCGCGCGGGATTGTCGCCCTGCTTGGCCCGAATAACAAAGCAGAGCGCATTGTGGTGATTTATCTGCGGGATACGCCGGCGAGCATGGCCGAGCG
276	gb|HQ425492|+|0-822|ARO:3001479|OXA-194	ATGAACATTAAAGCCCTCTTCCTTATAACAAGCGCTATTTTTATTTCAGCCTGC...TTA	822.0	54149	54916	767	822	ATGAACATTAAAGCACTCTTACTTATAACAAGCGCTATTTTTATTTCAGCCTGCTCACCTTATATAGTGACTGCTAATCCAAATCACAGCGCTTCAAAATCTGATGTAAAAGCAGAGAAAATTAAAAATTTATTTAACGAAGCACACACTACGGGTGTTTTAGTTATCCAACAAGGCCAAACTCAACAAAGCTATGGTAATGATCTTGCTCGTGCTTCGACCGAGTATGTACCTGCTTCGACCTTCAAAATGCTTAATGCTTTGATCGGCCTTGAGCACCATAAGGCAACCACCACAGAAGTATTTAAGTGGGATGGTAAAAAAAGGTTATTCCCAGAATGGGAAAAGGACATGACCCTAGGCGATGCCATGAAAGCTTCCGCTATTCCAGTTTATCAAGATTTAGCTCGTCGTATTGGACTTGAGCTCATGTCTAAGGAAGTGAAGCGTGTTGGTTATGGCAATGCAGATATCGGTACCCAAGTCGATAATTTTTGGCTGGTGGGTCCTTTAAAAATTACTCCTCAGCAAGAGGCACAGTTTGCTTACAAGCTAGCTAATAAAACGCTTCCATTTAGCCAAAAAGTCCAAGATGAAGTGCAATCCATGCTATTCATAGAAGAAAAGAATGGAAACAAAATATACGCAAAAAGTGGTTGGGGATGGGATGTAAACCCACAAGTAGGCTGGTTAACTGGATGGGTTGTTCAGCCTCAAGGGAATATTGTAGCGTTCTCCCTTAACTTAGAAATGAAAAAAGGAATACC
277	gb|AY862132|+|0-825|ARO:3001645|OXA-78	ATGAACATTAAAGCACTCTTACTTATAACAAGCGCTATTTTTATTTCAGCCTGC...TAG	825.0	54149	54919	770	825	ATGAACATTAAAGCACTCTTACTTATAACAAGCGCTATTTTTATTTCAGCCTGCTCACCTTATATAGTGACTGCTAATCCAAATCACAGCGCTTCAAAATCTGATGTAAAAGCAGAGAAAATTAAAAATTTATTTAACGAAGCACACACTACGGGTGTTTTAGTTATCCAACAAGGCCAAACTCAACAAAGCTATGGTAATGATCTTGCTCGTGCTTCGACCGAGTATGTACCTGCTTCGACCTTCAAAATGCTTAATGCTTTGATCGGCCTTGAGCACCATAAGGCAACCACCACAGAAGTATTTAAGTGGGATGGTAAAAAAAGGTTATTCCCAGAATGGGAAAAGGACATGACCCTAGGCGATGCCATGAAAGCTTCCGCTATTCCAGTTTATCAAGATTTAGCTCGTCGTATTGGACTTGAGCTCATGTCTAAGGAAGTGAAGCGTGTTGGTTATGGCAATGCAGATATCGGTACCCAAGTCGATAATTTTTGGCTGGTGGGTCCTTTAAAAATTACTCCTCAGCAAGAGGCACAGTTTGCTTACAAGCTAGCTAATAAAACGCTTCCATTTAGCCAAAAAGTCCAAGATGAAGTGCAATCCATGCTATTCATAGAAGAAAAGAATGGAAACAAAATATACGCAAAAAGTGGTTGGGGATGGGATGTAAACCCACAAGTAGGCTGGTTAACTGGATGGGTTGTTCAGCCTCAAGGGAATATTGTAGCGTTCTCCCTTAACTTAGAAATGAAAAAAGGAATACCTAG
278	gb|KT736121.1|+|1176-1977|ARO:3001555|OXA-368	ATGAAAACATTTGCCGCATATGTAATTATCGCGTGTCTTTCGAGTACGGCATTA...TAA	801.0	659	1405	746	801	ATGAAAACATTTGCCGCATATGTAATTATCGCGTGTCTTTCGAGTACGGCATTAGCTGGTTCAATTACAGAAAATACGTCTTGGAACAAAGAGTTCTCTGCCGAAGCCGTCAATGGTGTCTTCGTGCTTTGTAAAAGTAGCAGTAAATCCTGCGCTACCAATGACTTAGCTCGTGCATCAAAGGAATATCTTCCAGCATCAACATTTAAGATCCCCAACGCAATTATCGGCCTAGAAACTGGTGTCATAAAGAATGAGCATCAGGTTTTCAAATGGGACGGAAAGCCAAGAGCCATGAAGCAATGGGAAAGAGACTTGACCTTAAGAGGGGCAATACAAGTTTCAGCTGTTCCCGTATTTCAACAAATCGCCAGAGAAGTTGGCGAAGTAAGAATGCAGAAATACCTTAAAAAATTTTCCTATGGCAACCAGAATATCAGTGGTGGCATTGACAAATTCTGGTTGGAAGGCCAGCTTAGAATTTCCGCAGTTAATCAAGTGGAGTTTCTAGAGTCTCTATATTTAAATAAATTGTCAGCATCTAAAGAAAACCAGCTAATAGTAAAAGAGGCTTTGGTAACGGAGGCGGCACCTGAATATCTAGTGCATTCAAAAACTGGTTTTTCTGGTGTGGGAACTGAGTCAAATCCTGGTGTCGCATGGTGGGTTGGGTGGGTTGAGAAGGAGACAGAGGTTTACTTTTTCGCCTTTAACATGGATATAGACAACGAAAGTAAGTTGCCGCT
279	gb|HE981194|+|0-861|ARO:3001347|SHV-164	ATGCGTTATATTCGCCTGTGTATTATCTCCCTGTTAGCCACCCTGCCGCTGGCG...TAA	861.0	16	822	806	861	ATGCGTTATATTCGCCTGTGTATTATCACCCTGTGAGCCACCCTGCCGCTGGCGGTACACGCCAGCCCGCAGCCGCTTGAGCAAATTAAACAAAGCGAAAGCCAGCTGTCGGGCCGCGTAGGCATGATAGAAATGGATCTGGCCAGCGGCCGCACGCTGACCGCCTGGCGCGCCGATGAACGCTTTCCCATGATGAGCACCTTTAAAGTAGTGCTCTGCGGCGCAGTGCTGGCGCGGGTGGATGCCGGTGACGAACAGCTGGAGCGAAAGATCCACTATCGCCAGCAGGATCTGGTGGACTACTCGCCGGTCAGCGAAAAACACCTTGCCGACGGCATGACGGTCGGCGAACTCTGCGCCGCCGCCATTACCATGAGCGATAACAGCGCCGCCAATCTGCTGCTGGCCACCGTCGGCGGCCCCGCAGGATTGACTGCCTTTTTGCGCCAGATCGGCGACAACGTCACCCGCCTTGACCGCTGGGAAACGGAACTGAATGAGGCGCTTCCCGGCGACGCCCGCGACACCACTACCCCGGCCAGCATGGCCGCGACCCTGCGCAAGCTGCTGACCAGCCAGCGTCTGAGCGCCCGTTCGCAACGGCAGCTGCTGCAGTGGATGGTGGACGATCGGGTCGCCGGACCGTTGATCCGCTCCGTGCTGCCGGCGGGCTGGTTTATCGCCGATAAGACCGGAGCTAGCAAGCGGGGTGCGCGCGGGATTGTCGCCCTGCTTGGCCCGAATAACAAAGCAGAGCGCATTGTGGTGATTTATCTGCGGGATACGCCGGCGAGCATGGCCGAGCG
280	gb|EF373971|+|0-861|ARO:3001148|SHV-96	ATGCGTTATATTCGCCTGTGTATTATCTCCCTGTTAGCCACCCTGCCGCTGGCG...TAA	861.0	16	822	806	861	ATGCGTTATATTCGCCTGTGTATTATCACCCTGTGAGCCACCCTGCCGCTGGCGGTACACGCCAGCCCGCAGCCGCTTGAGCAAATTAAACAAAGCGAAAGCCAGCTGTCGGGCCGCGTAGGCATGATAGAAATGGATCTGGCCAGCGGCCGCACGCTGACCGCCTGGCGCGCCGATGAACGCTTTCCCATGATGAGCACCTTTAAAGTAGTGCTCTGCGGCGCAGTGCTGGCGCGGGTGGATGCCGGTGACGAACAGCTGGAGCGAAAGATCCACTATCGCCAGCAGGATCTGGTGGACTACTCGCCGGTCAGCGAAAAACACCTTGCCGACGGCATGACGGTCGGCGAACTCTGCGCCGCCGCCATTACCATGAGCGATAACAGCGCCGCCAATCTGCTGCTGGCCACCGTCGGCGGCCCCGCAGGATTGACTGCCTTTTTGCGCCAGATCGGCGACAACGTCACCCGCCTTGACCGCTGGGAAACGGAACTGAATGAGGCGCTTCCCGGCGACGCCCGCGACACCACTACCCCGGCCAGCATGGCCGCGACCCTGCGCAAGCTGCTGACCAGCCAGCGTCTGAGCGCCCGTTCGCAACGGCAGCTGCTGCAGTGGATGGTGGACGATCGGGTCGCCGGACCGTTGATCCGCTCCGTGCTGCCGGCGGGCTGGTTTATCGCCGATAAGACCGGAGCTAGCAAGCGGGGTGCGCGCGGGATTGTCGCCCTGCTTGGCCCGAATAACAAAGCAGAGCGCATTGTGGTGATTTATCTGCGGGATACGCCGGCGAGCATGGCCGAGCG
281	gb|AY210887|+|111-972|ARO:3001104|SHV-46	ATGCGTTATATTCGCCTGTGTATTATCTCCCTGTTAGCCACCCTGCCGCTGGCG...TAA	861.0	16	822	806	861	ATGCGTTATATTCGCCTGTGTATTATCACCCTGTGAGCCACCCTGCCGCTGGCGGTACACGCCAGCCCGCAGCCGCTTGAGCAAATTAAACAAAGCGAAAGCCAGCTGTCGGGCCGCGTAGGCATGATAGAAATGGATCTGGCCAGCGGCCGCACGCTGACCGCCTGGCGCGCCGATGAACGCTTTCCCATGATGAGCACCTTTAAAGTAGTGCTCTGCGGCGCAGTGCTGGCGCGGGTGGATGCCGGTGACGAACAGCTGGAGCGAAAGATCCACTATCGCCAGCAGGATCTGGTGGACTACTCGCCGGTCAGCGAAAAACACCTTGCCGACGGCATGACGGTCGGCGAACTCTGCGCCGCCGCCATTACCATGAGCGATAACAGCGCCGCCAATCTGCTGCTGGCCACCGTCGGCGGCCCCGCAGGATTGACTGCCTTTTTGCGCCAGATCGGCGACAACGTCACCCGCCTTGACCGCTGGGAAACGGAACTGAATGAGGCGCTTCCCGGCGACGCCCGCGACACCACTACCCCGGCCAGCATGGCCGCGACCCTGCGCAAGCTGCTGACCAGCCAGCGTCTGAGCGCCCGTTCGCAACGGCAGCTGCTGCAGTGGATGGTGGACGATCGGGTCGCCGGACCGTTGATCCGCTCCGTGCTGCCGGCGGGCTGGTTTATCGCCGATAAGACCGGAGCTAGCAAGCGGGGTGCGCGCGGGATTGTCGCCCTGCTTGGCCCGAATAACAAAGCAGAGCGCATTGTGGTGATTTATCTGCGGGATACGCCGGCGAGCATGGCCGAGCG
282	gb|FJ666071|+|0-1194|ARO:3002507|PDC-8	ATGCGCGATACCAGATTCCCCTGCCTGTGCGGCATCGCCGCTTCCACACTGCTG...TGA	1194.0	35513	36652	1139	1194	ATGCGCGATACCAGATTCCCCTGCCTGTGCGGCATCGCCGCTTCCACACTGCTGTTCGCCACCACCCCGGCCATTGCCGATGAGGCCCCGGCGGATCGCCTGAAGGCACTGGTCGACGCCGCCGTACAACCGGTGATGAAGGCCAATGACATTCCGGGCCTGGCCGTAGCCATCAGCCTGAAAGGAGAACCGCATTACTTCAGCTATGGGCTGGCCTCGAAAGAGGACGGCCGCCGGGTGACGCCGGAGACCCTGTTCGAGATCGGCTCGGTGAGCAAGACCTTCACCGTCACCCTCGCCGGCTATGCCCTGGCCCAGGACAAGATGCGCCTCGACGACCGCGCCAGCCAGCACTGGCCGGCACTGCAGGGCAGCCGCTTCGACGGCATCAGCCTGCTCGACCTCGCGACCTATACCGCCGGCGGCTTGCCGCTGCAGTTCCCCGACTCGGTGCAGAAGGACCAGGCACAGATCCGCGACTACTACCGCCAGTGGCAGCCGACCTACGCGCCGGGCAGCCAGCGCCTCTATTCCAACCCGAGCATCGGCCTGTTCGGCTATCTCGCCGCGCGCAGCCTGGGCCAGCCGTTCGAACGGCTCATGGAGCAGCAATTGTTCCCGGCACTGGGCCTCGAACAGACCCACCTCGACGTGCCCGAGGCGGCGCTGGCGCAGTACGCCCAGGGCTACGGCAAGGACGACCGCCCGCTACGGGTCGGTCCCGGCCCGCTGGATGCCGAAGGCTACGGGGTGAAGACCAGCGCGGCCGACCTGCTGCGCTTCGTCGATGCCAACCTGCATCCGGAGCGCCTGGACAGGCCCTGGGCGCAGGCGCTCGATGCCACCCATCGCGGTTACTACAAGGTCGGCGACATGACCCAGGGCCTGGGCTGGGAAGCCTACGACTGGCCGATCTCCCTGAAGCGCCTGCAGGCCGGCAACTCGACGCCGATGGCGCTGCAACCACACAGGATCGCCAGGCTGCCCGCGCCACAGGCGCTGGAGGGCCAGCGCCTGCTGAACAAGACCGGCTCCACCAACGGCTTCGGCGCCTACGTGGCGTTCGTCCCGGGCCGCGACCTGGGCCTGGTGATCCTGGCCAACCGCAACTATCCCAATGCCGAGCGGGTGAAGATCGC
283	gb|HQ425493|+|0-822|ARO:3001480|OXA-195	ATGAACATTAAAGCACTCTTCCTTATAACAAGCGCTATTTTTATTTCAGCCTGC...TTA	822.0	54149	54916	767	822	ATGAACATTAAAGCACTCTTACTTATAACAAGCGCTATTTTTATTTCAGCCTGCTCACCTTATATAGTGACTGCTAATCCAAATCACAGCGCTTCAAAATCTGATGTAAAAGCAGAGAAAATTAAAAATTTATTTAACGAAGCACACACTACGGGTGTTTTAGTTATCCAACAAGGCCAAACTCAACAAAGCTATGGTAATGATCTTGCTCGTGCTTCGACCGAGTATGTACCTGCTTCGACCTTCAAAATGCTTAATGCTTTGATCGGCCTTGAGCACCATAAGGCAACCACCACAGAAGTATTTAAGTGGGATGGTAAAAAAAGGTTATTCCCAGAATGGGAAAAGGACATGACCCTAGGCGATGCCATGAAAGCTTCCGCTATTCCAGTTTATCAAGATTTAGCTCGTCGTATTGGACTTGAGCTCATGTCTAAGGAAGTGAAGCGTGTTGGTTATGGCAATGCAGATATCGGTACCCAAGTCGATAATTTTTGGCTGGTGGGTCCTTTAAAAATTACTCCTCAGCAAGAGGCACAGTTTGCTTACAAGCTAGCTAATAAAACGCTTCCATTTAGCCAAAAAGTCCAAGATGAAGTGCAATCCATGCTATTCATAGAAGAAAAGAATGGAAACAAAATATACGCAAAAAGTGGTTGGGGATGGGATGTAAACCCACAAGTAGGCTGGTTAACTGGATGGGTTGTTCAGCCTCAAGGGAATATTGTAGCGTTCTCCCTTAACTTAGAAATGAAAAAAGGAATACC
284	gb|EF373973|+|0-861|ARO:3001149|SHV-97	ATGCGTTATATTCGCCTGTGTATTATCTCCCTGTTAGCCACCCTGCCGCTGGCG...TAA	861.0	16	822	806	861	ATGCGTTATATTCGCCTGTGTATTATCACCCTGTGAGCCACCCTGCCGCTGGCGGTACACGCCAGCCCGCAGCCGCTTGAGCAAATTAAACAAAGCGAAAGCCAGCTGTCGGGCCGCGTAGGCATGATAGAAATGGATCTGGCCAGCGGCCGCACGCTGACCGCCTGGCGCGCCGATGAACGCTTTCCCATGATGAGCACCTTTAAAGTAGTGCTCTGCGGCGCAGTGCTGGCGCGGGTGGATGCCGGTGACGAACAGCTGGAGCGAAAGATCCACTATCGCCAGCAGGATCTGGTGGACTACTCGCCGGTCAGCGAAAAACACCTTGCCGACGGCATGACGGTCGGCGAACTCTGCGCCGCCGCCATTACCATGAGCGATAACAGCGCCGCCAATCTGCTGCTGGCCACCGTCGGCGGCCCCGCAGGATTGACTGCCTTTTTGCGCCAGATCGGCGACAACGTCACCCGCCTTGACCGCTGGGAAACGGAACTGAATGAGGCGCTTCCCGGCGACGCCCGCGACACCACTACCCCGGCCAGCATGGCCGCGACCCTGCGCAAGCTGCTGACCAGCCAGCGTCTGAGCGCCCGTTCGCAACGGCAGCTGCTGCAGTGGATGGTGGACGATCGGGTCGCCGGACCGTTGATCCGCTCCGTGCTGCCGGCGGGCTGGTTTATCGCCGATAAGACCGGAGCTAGCAAGCGGGGTGCGCGCGGGATTGTCGCCCTGCTTGGCCCGAATAACAAAGCAGAGCGCATTGTGGTGATTTATCTGCGGGATACGCCGGCGAGCATGGCCGAGCG
285	gb|EU019534|+|0-825|ARO:3001633|OXA-79	ATGAACATTAAAGCACTCTTACTTATAACAAGCGCTATTTTTATTTCAGCCTGC...TAG	825.0	54149	54919	770	825	ATGAACATTAAAGCACTCTTACTTATAACAAGCGCTATTTTTATTTCAGCCTGCTCACCTTATATAGTGACTGCTAATCCAAATCACAGCGCTTCAAAATCTGATGTAAAAGCAGAGAAAATTAAAAATTTATTTAACGAAGCACACACTACGGGTGTTTTAGTTATCCAACAAGGCCAAACTCAACAAAGCTATGGTAATGATCTTGCTCGTGCTTCGACCGAGTATGTACCTGCTTCGACCTTCAAAATGCTTAATGCTTTGATCGGCCTTGAGCACCATAAGGCAACCACCACAGAAGTATTTAAGTGGGATGGTAAAAAAAGGTTATTCCCAGAATGGGAAAAGGACATGACCCTAGGCGATGCCATGAAAGCTTCCGCTATTCCAGTTTATCAAGATTTAGCTCGTCGTATTGGACTTGAGCTCATGTCTAAGGAAGTGAAGCGTGTTGGTTATGGCAATGCAGATATCGGTACCCAAGTCGATAATTTTTGGCTGGTGGGTCCTTTAAAAATTACTCCTCAGCAAGAGGCACAGTTTGCTTACAAGCTAGCTAATAAAACGCTTCCATTTAGCCAAAAAGTCCAAGATGAAGTGCAATCCATGCTATTCATAGAAGAAAAGAATGGAAACAAAATATACGCAAAAAGTGGTTGGGGATGGGATGTAAACCCACAAGTAGGCTGGTTAACTGGATGGGTTGTTCAGCCTCAAGGGAATATTGTAGCGTTCTCCCTTAACTTAGAAATGAAAAAAGGAATACCTAG
286	gb|JQ319654.1|+|0-1152|ARO:3004619|ADC-59	ATGCGATTTAAAAAAATTTCTTGTTTACTTTTATCCCCGCTTTTTATTTTTAGT...TAA	1152.0	63	1160	1097	1152	ATGCGATTTAAAAAAATTTCTTGTCTACTTTTATCCCCGCTTTTTATTTTTAGTACCTCAATTTATGCGGGCAATACACCAAAAGACCAAGAAATTAAAAAACTGGTAGATCAAAACTTTAAACCGTTATTAGAAAAATATGATGTGCCAGGTATGGCTGTGGGTGTTATTCAAAATAATAAAAAGTATGAAATGTATTATGGTCTTCAATCTGTTCAAGATAAAAAAGCCGTAAATAGCAGTACTATTTTTGAGCTAGGTTCTGTCAGTAAATTATTTACCGCGACAGCAGGTGGATATGCAAAAAATAAAGGAAAAATCTCTTTTGACGATACGCCTGGTAAGTATTGGAAAGAACTAAAAAATACACCGATTGACCAAGTTAACTTACTTCAACTCGCGACGTATACAAGTGGTAACCTTGCCTTGCAATTTCCAGATGAAGTAAAAACAGATCAGCAAGTTTTAACATTTTTTAAAGACTGGAAACCTAAAAACTCAATCGGTGAATATCGACAATATTCAAACCCAAGCATTGGTTTATTTGGAAAAGTTGTAGCTTTGTCTATGAATAAACCTTTCGACCAAGTCTTAGAAAAAACAATTTTTCCGGCCCTTGGCTTAAAACATAGCTATGTAAATGTACCTAAGACCCAGATGCAAAACTATGCTTTTGGCTATAACCAAGAAAATCAGCCGATTCGAGTTAACCCCGGCCCACTCGATGCCCCAGCATATGGCGTCAAATCGACACTACCCGACATGTTGAGTTTTATTCATGCCAACCTAAATCCACAAAAATATCCAGCAGATATTCAACGGGCAATTAATGAAACACATCAGGGTCGCTATCAAGTAAATACCATGTATCAGGCACTCGGTTGGGAAGAGTTTTCTTATCCGGCAACGTTACAAACTTTATTAGACAGTAATTCAGAACAGATTGTGATGAAACCTAATAAAGTGACTGCTATTTCAAAGGAACCTTCAGTTAAGATGTACCATAAAACTGGCTCAACTACCGGTTTCGGAACATATGTGGTGTTTATTCCTAAAGAAAATATTGGTTTAGTCATGTTAACCAATAAACGTATTCC
287	gb|JX121131|+|0-858|ARO:3001203|SHV-165	ATGCGTTATATTCGCCTGTGTATTATCTCCCTGTTAGCCCCCCTGCCGCTGGCG...CGC	858.0	16	819	803	858	ATGCGTTATATTCGCCTGTGTATTATCACCCTGTGAGCCACCCTGCCGCTGGCGGTACACGCCAGCCCGCAGCCGCTTGAGCAAATTAAACAAAGCGAAAGCCAGCTGTCGGGCCGCGTAGGCATGATAGAAATGGATCTGGCCAGCGGCCGCACGCTGACCGCCTGGCGCGCCGATGAACGCTTTCCCATGATGAGCACCTTTAAAGTAGTGCTCTGCGGCGCAGTGCTGGCGCGGGTGGATGCCGGTGACGAACAGCTGGAGCGAAAGATCCACTATCGCCAGCAGGATCTGGTGGACTACTCGCCGGTCAGCGAAAAACACCTTGCCGACGGCATGACGGTCGGCGAACTCTGCGCCGCCGCCATTACCATGAGCGATAACAGCGCCGCCAATCTGCTGCTGGCCACCGTCGGCGGCCCCGCAGGATTGACTGCCTTTTTGCGCCAGATCGGCGACAACGTCACCCGCCTTGACCGCTGGGAAACGGAACTGAATGAGGCGCTTCCCGGCGACGCCCGCGACACCACTACCCCGGCCAGCATGGCCGCGACCCTGCGCAAGCTGCTGACCAGCCAGCGTCTGAGCGCCCGTTCGCAACGGCAGCTGCTGCAGTGGATGGTGGACGATCGGGTCGCCGGACCGTTGATCCGCTCCGTGCTGCCGGCGGGCTGGTTTATCGCCGATAAGACCGGAGCTAGCAAGCGGGGTGCGCGCGGGATTGTCGCCCTGCTTGGCCCGAATAACAAAGCAGAGCGCATTGTGGTGATTTATCTGCGGGATACGCCGGCGAGCATGGCCGA
288	gb|AY263404|+|0-861|ARO:3001105|SHV-48	ATGCGTTATATTCGCCTGTGTATTATCTCCCTGTTAGCCACCCTGCCGCTGGCG...TAA	861.0	16	822	806	861	ATGCGTTATATTCGCCTGTGTATTATCACCCTGTGAGCCACCCTGCCGCTGGCGGTACACGCCAGCCCGCAGCCGCTTGAGCAAATTAAACAAAGCGAAAGCCAGCTGTCGGGCCGCGTAGGCATGATAGAAATGGATCTGGCCAGCGGCCGCACGCTGACCGCCTGGCGCGCCGATGAACGCTTTCCCATGATGAGCACCTTTAAAGTAGTGCTCTGCGGCGCAGTGCTGGCGCGGGTGGATGCCGGTGACGAACAGCTGGAGCGAAAGATCCACTATCGCCAGCAGGATCTGGTGGACTACTCGCCGGTCAGCGAAAAACACCTTGCCGACGGCATGACGGTCGGCGAACTCTGCGCCGCCGCCATTACCATGAGCGATAACAGCGCCGCCAATCTGCTGCTGGCCACCGTCGGCGGCCCCGCAGGATTGACTGCCTTTTTGCGCCAGATCGGCGACAACGTCACCCGCCTTGACCGCTGGGAAACGGAACTGAATGAGGCGCTTCCCGGCGACGCCCGCGACACCACTACCCCGGCCAGCATGGCCGCGACCCTGCGCAAGCTGCTGACCAGCCAGCGTCTGAGCGCCCGTTCGCAACGGCAGCTGCTGCAGTGGATGGTGGACGATCGGGTCGCCGGACCGTTGATCCGCTCCGTGCTGCCGGCGGGCTGGTTTATCGCCGATAAGACCGGAGCTAGCAAGCGGGGTGCGCGCGGGATTGTCGCCCTGCTTGGCCCGAATAACAAAGCAGAGCGCATTGTGGTGATTTATCTGCGGGATACGCCGGCGAGCATGGCCGAGCG
289	gb|EU019535|+|0-825|ARO:3001634|OXA-80	ATGAACATTAAAGCACTCTTACTTATAACAAGCGCTATTTTTATTTCAGCCTGC...TAG	825.0	54149	54919	770	825	ATGAACATTAAAGCACTCTTACTTATAACAAGCGCTATTTTTATTTCAGCCTGCTCACCTTATATAGTGACTGCTAATCCAAATCACAGCGCTTCAAAATCTGATGTAAAAGCAGAGAAAATTAAAAATTTATTTAACGAAGCACACACTACGGGTGTTTTAGTTATCCAACAAGGCCAAACTCAACAAAGCTATGGTAATGATCTTGCTCGTGCTTCGACCGAGTATGTACCTGCTTCGACCTTCAAAATGCTTAATGCTTTGATCGGCCTTGAGCACCATAAGGCAACCACCACAGAAGTATTTAAGTGGGATGGTAAAAAAAGGTTATTCCCAGAATGGGAAAAGGACATGACCCTAGGCGATGCCATGAAAGCTTCCGCTATTCCAGTTTATCAAGATTTAGCTCGTCGTATTGGACTTGAGCTCATGTCTAAGGAAGTGAAGCGTGTTGGTTATGGCAATGCAGATATCGGTACCCAAGTCGATAATTTTTGGCTGGTGGGTCCTTTAAAAATTACTCCTCAGCAAGAGGCACAGTTTGCTTACAAGCTAGCTAATAAAACGCTTCCATTTAGCCAAAAAGTCCAAGATGAAGTGCAATCCATGCTATTCATAGAAGAAAAGAATGGAAACAAAATATACGCAAAAAGTGGTTGGGGATGGGATGTAAACCCACAAGTAGGCTGGTTAACTGGATGGGTTGTTCAGCCTCAAGGGAATATTGTAGCGTTCTCCCTTAACTTAGAAATGAAAAAAGGAATACCTAG
290	gb|AM941844|+|0-861|ARO:3001336|SHV-98	ATGCGTTATATTCGCCTGTGTATTATCTCCCTGTTAGCCACCCTGCCGCTGGCG...TAA	861.0	16	822	806	861	ATGCGTTATATTCGCCTGTGTATTATCACCCTGTGAGCCACCCTGCCGCTGGCGGTACACGCCAGCCCGCAGCCGCTTGAGCAAATTAAACAAAGCGAAAGCCAGCTGTCGGGCCGCGTAGGCATGATAGAAATGGATCTGGCCAGCGGCCGCACGCTGACCGCCTGGCGCGCCGATGAACGCTTTCCCATGATGAGCACCTTTAAAGTAGTGCTCTGCGGCGCAGTGCTGGCGCGGGTGGATGCCGGTGACGAACAGCTGGAGCGAAAGATCCACTATCGCCAGCAGGATCTGGTGGACTACTCGCCGGTCAGCGAAAAACACCTTGCCGACGGCATGACGGTCGGCGAACTCTGCGCCGCCGCCATTACCATGAGCGATAACAGCGCCGCCAATCTGCTGCTGGCCACCGTCGGCGGCCCCGCAGGATTGACTGCCTTTTTGCGCCAGATCGGCGACAACGTCACCCGCCTTGACCGCTGGGAAACGGAACTGAATGAGGCGCTTCCCGGCGACGCCCGCGACACCACTACCCCGGCCAGCATGGCCGCGACCCTGCGCAAGCTGCTGACCAGCCAGCGTCTGAGCGCCCGTTCGCAACGGCAGCTGCTGCAGTGGATGGTGGACGATCGGGTCGCCGGACCGTTGATCCGCTCCGTGCTGCCGGCGGGCTGGTTTATCGCCGATAAGACCGGAGCTAGCAAGCGGGGTGCGCGCGGGATTGTCGCCCTGCTTGGCCCGAATAACAAAGCAGAGCGCATTGTGGTGATTTATCTGCGGGATACGCCGGCGAGCATGGCCGAGCG
291	gb|EU019536|+|0-825|ARO:3001635|OXA-82	ATGAACATTAAAGCACTCTTACTTATAACAAGCGCTATTTTTATTTCAGCCTGC...TAG	825.0	54149	54919	770	825	ATGAACATTAAAGCACTCTTACTTATAACAAGCGCTATTTTTATTTCAGCCTGCTCACCTTATATAGTGACTGCTAATCCAAATCACAGCGCTTCAAAATCTGATGTAAAAGCAGAGAAAATTAAAAATTTATTTAACGAAGCACACACTACGGGTGTTTTAGTTATCCAACAAGGCCAAACTCAACAAAGCTATGGTAATGATCTTGCTCGTGCTTCGACCGAGTATGTACCTGCTTCGACCTTCAAAATGCTTAATGCTTTGATCGGCCTTGAGCACCATAAGGCAACCACCACAGAAGTATTTAAGTGGGATGGTAAAAAAAGGTTATTCCCAGAATGGGAAAAGGACATGACCCTAGGCGATGCCATGAAAGCTTCCGCTATTCCAGTTTATCAAGATTTAGCTCGTCGTATTGGACTTGAGCTCATGTCTAAGGAAGTGAAGCGTGTTGGTTATGGCAATGCAGATATCGGTACCCAAGTCGATAATTTTTGGCTGGTGGGTCCTTTAAAAATTACTCCTCAGCAAGAGGCACAGTTTGCTTACAAGCTAGCTAATAAAACGCTTCCATTTAGCCAAAAAGTCCAAGATGAAGTGCAATCCATGCTATTCATAGAAGAAAAGAATGGAAACAAAATATACGCAAAAAGTGGTTGGGGATGGGATGTAAACCCACAAGTAGGCTGGTTAACTGGATGGGTTGTTCAGCCTCAAGGGAATATTGTAGCGTTCTCCCTTAACTTAGAAATGAAAAAAGGAATACCTAG
292	gb|AY528718|+|413-1274|ARO:3001106|SHV-49	ATGCGTTATATTCGCCTGTGTATTATCTCCCTGTTAGCCACCCTGCCGCTGGCG...TAA	861.0	16	822	806	861	ATGCGTTATATTCGCCTGTGTATTATCACCCTGTGAGCCACCCTGCCGCTGGCGGTACACGCCAGCCCGCAGCCGCTTGAGCAAATTAAACAAAGCGAAAGCCAGCTGTCGGGCCGCGTAGGCATGATAGAAATGGATCTGGCCAGCGGCCGCACGCTGACCGCCTGGCGCGCCGATGAACGCTTTCCCATGATGAGCACCTTTAAAGTAGTGCTCTGCGGCGCAGTGCTGGCGCGGGTGGATGCCGGTGACGAACAGCTGGAGCGAAAGATCCACTATCGCCAGCAGGATCTGGTGGACTACTCGCCGGTCAGCGAAAAACACCTTGCCGACGGCATGACGGTCGGCGAACTCTGCGCCGCCGCCATTACCATGAGCGATAACAGCGCCGCCAATCTGCTGCTGGCCACCGTCGGCGGCCCCGCAGGATTGACTGCCTTTTTGCGCCAGATCGGCGACAACGTCACCCGCCTTGACCGCTGGGAAACGGAACTGAATGAGGCGCTTCCCGGCGACGCCCGCGACACCACTACCCCGGCCAGCATGGCCGCGACCCTGCGCAAGCTGCTGACCAGCCAGCGTCTGAGCGCCCGTTCGCAACGGCAGCTGCTGCAGTGGATGGTGGACGATCGGGTCGCCGGACCGTTGATCCGCTCCGTGCTGCCGGCGGGCTGGTTTATCGCCGATAAGACCGGAGCTAGCAAGCGGGGTGCGCGCGGGATTGTCGCCCTGCTTGGCCCGAATAACAAAGCAGAGCGCATTGTGGTGATTTATCTGCGGGATACGCCGGCGAGCATGGCCGAGCG
293	gb|HQ425494|+|0-822|ARO:3001481|OXA-196	ATGAACATTCAAGCACTCTTACTTATAACAAGCGCTATTTTTATTTCAGCCTGC...TTA	822.0	54149	54916	767	822	ATGAACATTAAAGCACTCTTACTTATAACAAGCGCTATTTTTATTTCAGCCTGCTCACCTTATATAGTGACTGCTAATCCAAATCACAGCGCTTCAAAATCTGATGTAAAAGCAGAGAAAATTAAAAATTTATTTAACGAAGCACACACTACGGGTGTTTTAGTTATCCAACAAGGCCAAACTCAACAAAGCTATGGTAATGATCTTGCTCGTGCTTCGACCGAGTATGTACCTGCTTCGACCTTCAAAATGCTTAATGCTTTGATCGGCCTTGAGCACCATAAGGCAACCACCACAGAAGTATTTAAGTGGGATGGTAAAAAAAGGTTATTCCCAGAATGGGAAAAGGACATGACCCTAGGCGATGCCATGAAAGCTTCCGCTATTCCAGTTTATCAAGATTTAGCTCGTCGTATTGGACTTGAGCTCATGTCTAAGGAAGTGAAGCGTGTTGGTTATGGCAATGCAGATATCGGTACCCAAGTCGATAATTTTTGGCTGGTGGGTCCTTTAAAAATTACTCCTCAGCAAGAGGCACAGTTTGCTTACAAGCTAGCTAATAAAACGCTTCCATTTAGCCAAAAAGTCCAAGATGAAGTGCAATCCATGCTATTCATAGAAGAAAAGAATGGAAACAAAATATACGCAAAAAGTGGTTGGGGATGGGATGTAAACCCACAAGTAGGCTGGTTAACTGGATGGGTTGTTCAGCCTCAAGGGAATATTGTAGCGTTCTCCCTTAACTTAGAAATGAAAAAAGGAATACC
294	gb|AB733453|+|3-849|ARO:3001204|SHV-167	ATGCGTTATATTCGCCTGTGTATTATCTCCCTGTTAGCCACCCTGCCGCTGGCG...GAG	846.0	16	807	791	846	ATGCGTTATATTCGCCTGTGTATTATCACCCTGTGAGCCACCCTGCCGCTGGCGGTACACGCCAGCCCGCAGCCGCTTGAGCAAATTAAACAAAGCGAAAGCCAGCTGTCGGGCCGCGTAGGCATGATAGAAATGGATCTGGCCAGCGGCCGCACGCTGACCGCCTGGCGCGCCGATGAACGCTTTCCCATGATGAGCACCTTTAAAGTAGTGCTCTGCGGCGCAGTGCTGGCGCGGGTGGATGCCGGTGACGAACAGCTGGAGCGAAAGATCCACTATCGCCAGCAGGATCTGGTGGACTACTCGCCGGTCAGCGAAAAACACCTTGCCGACGGCATGACGGTCGGCGAACTCTGCGCCGCCGCCATTACCATGAGCGATAACAGCGCCGCCAATCTGCTGCTGGCCACCGTCGGCGGCCCCGCAGGATTGACTGCCTTTTTGCGCCAGATCGGCGACAACGTCACCCGCCTTGACCGCTGGGAAACGGAACTGAATGAGGCGCTTCCCGGCGACGCCCGCGACACCACTACCCCGGCCAGCATGGCCGCGACCCTGCGCAAGCTGCTGACCAGCCAGCGTCTGAGCGCCCGTTCGCAACGGCAGCTGCTGCAGTGGATGGTGGACGATCGGGTCGCCGGACCGTTGATCCGCTCCGTGCTGCCGGCGGGCTGGTTTATCGCCGATAAGACCGGAGCTAGCAAGCGGGGTGCGCGCGGGATTGTCGCCCTGCTTGGCCCGAATAACAAAGCAGAGCGCATTGTGGTGATTTATCTGCGGGATACGCCGGC
295	gb|DQ309277|+|0-825|ARO:3001623|OXA-83	ATGAACATTAAAGCACTCTTACTTATAACAAGCGCTATTTTTATTTCAGCCTGC...TAG	825.0	54149	54919	770	825	ATGAACATTAAAGCACTCTTACTTATAACAAGCGCTATTTTTATTTCAGCCTGCTCACCTTATATAGTGACTGCTAATCCAAATCACAGCGCTTCAAAATCTGATGTAAAAGCAGAGAAAATTAAAAATTTATTTAACGAAGCACACACTACGGGTGTTTTAGTTATCCAACAAGGCCAAACTCAACAAAGCTATGGTAATGATCTTGCTCGTGCTTCGACCGAGTATGTACCTGCTTCGACCTTCAAAATGCTTAATGCTTTGATCGGCCTTGAGCACCATAAGGCAACCACCACAGAAGTATTTAAGTGGGATGGTAAAAAAAGGTTATTCCCAGAATGGGAAAAGGACATGACCCTAGGCGATGCCATGAAAGCTTCCGCTATTCCAGTTTATCAAGATTTAGCTCGTCGTATTGGACTTGAGCTCATGTCTAAGGAAGTGAAGCGTGTTGGTTATGGCAATGCAGATATCGGTACCCAAGTCGATAATTTTTGGCTGGTGGGTCCTTTAAAAATTACTCCTCAGCAAGAGGCACAGTTTGCTTACAAGCTAGCTAATAAAACGCTTCCATTTAGCCAAAAAGTCCAAGATGAAGTGCAATCCATGCTATTCATAGAAGAAAAGAATGGAAACAAAATATACGCAAAAAGTGGTTGGGGATGGGATGTAAACCCACAAGTAGGCTGGTTAACTGGATGGGTTGTTCAGCCTCAAGGGAATATTGTAGCGTTCTCCCTTAACTTAGAAATGAAAAAAGGAATACCTAG
296	gb|AM941845|+|0-861|ARO:3001337|SHV-99	ATGCGTTATATTCGCCTGTGTATTATCTCCCTGTTAGCCACCCTGCCGCTGGCG...TAA	861.0	16	822	806	861	ATGCGTTATATTCGCCTGTGTATTATCACCCTGTGAGCCACCCTGCCGCTGGCGGTACACGCCAGCCCGCAGCCGCTTGAGCAAATTAAACAAAGCGAAAGCCAGCTGTCGGGCCGCGTAGGCATGATAGAAATGGATCTGGCCAGCGGCCGCACGCTGACCGCCTGGCGCGCCGATGAACGCTTTCCCATGATGAGCACCTTTAAAGTAGTGCTCTGCGGCGCAGTGCTGGCGCGGGTGGATGCCGGTGACGAACAGCTGGAGCGAAAGATCCACTATCGCCAGCAGGATCTGGTGGACTACTCGCCGGTCAGCGAAAAACACCTTGCCGACGGCATGACGGTCGGCGAACTCTGCGCCGCCGCCATTACCATGAGCGATAACAGCGCCGCCAATCTGCTGCTGGCCACCGTCGGCGGCCCCGCAGGATTGACTGCCTTTTTGCGCCAGATCGGCGACAACGTCACCCGCCTTGACCGCTGGGAAACGGAACTGAATGAGGCGCTTCCCGGCGACGCCCGCGACACCACTACCCCGGCCAGCATGGCCGCGACCCTGCGCAAGCTGCTGACCAGCCAGCGTCTGAGCGCCCGTTCGCAACGGCAGCTGCTGCAGTGGATGGTGGACGATCGGGTCGCCGGACCGTTGATCCGCTCCGTGCTGCCGGCGGGCTGGTTTATCGCCGATAAGACCGGAGCTAGCAAGCGGGGTGCGCGCGGGATTGTCGCCCTGCTTGGCCCGAATAACAAAGCAGAGCGCATTGTGGTGATTTATCTGCGGGATACGCCGGCGAGCATGGCCGAGCG
297	gb|DQ309276|+|0-825|ARO:3001624|OXA-84	ATGAACATTAAAGCACTCTTACTTATAACAAGCGCTATTTTTATTTCAGCCTGC...TAG	825.0	54149	54919	770	825	ATGAACATTAAAGCACTCTTACTTATAACAAGCGCTATTTTTATTTCAGCCTGCTCACCTTATATAGTGACTGCTAATCCAAATCACAGCGCTTCAAAATCTGATGTAAAAGCAGAGAAAATTAAAAATTTATTTAACGAAGCACACACTACGGGTGTTTTAGTTATCCAACAAGGCCAAACTCAACAAAGCTATGGTAATGATCTTGCTCGTGCTTCGACCGAGTATGTACCTGCTTCGACCTTCAAAATGCTTAATGCTTTGATCGGCCTTGAGCACCATAAGGCAACCACCACAGAAGTATTTAAGTGGGATGGTAAAAAAAGGTTATTCCCAGAATGGGAAAAGGACATGACCCTAGGCGATGCCATGAAAGCTTCCGCTATTCCAGTTTATCAAGATTTAGCTCGTCGTATTGGACTTGAGCTCATGTCTAAGGAAGTGAAGCGTGTTGGTTATGGCAATGCAGATATCGGTACCCAAGTCGATAATTTTTGGCTGGTGGGTCCTTTAAAAATTACTCCTCAGCAAGAGGCACAGTTTGCTTACAAGCTAGCTAATAAAACGCTTCCATTTAGCCAAAAAGTCCAAGATGAAGTGCAATCCATGCTATTCATAGAAGAAAAGAATGGAAACAAAATATACGCAAAAAGTGGTTGGGGATGGGATGTAAACCCACAAGTAGGCTGGTTAACTGGATGGGTTGTTCAGCCTCAAGGGAATATTGTAGCGTTCTCCCTTAACTTAGAAATGAAAAAAGGAATACCTAG
298	gb|AE016879.1|+|2933334-2933889|ARO:3005045|SatA	ATGAGCCTTTTAATTAGAGAGTTAGAAACAAATGATTTAGATAATTTCCCGGAG...TAA	555.0	0	466	466	555	ATTTAGATAATTTCCCGGAGATTGATGACAGTTTTATAGTGAATGCTCGGTTAATGCTTTCTCTTTCAAAAGTAAATAGACGCATAGAATATACAGTAGAAGACGTTCCGAGTTATGAAAAAAGTTATTTACAAAATGATAATGAAGAACTGGTGTACAATGAATATATAAATAAGCCAAATCAAATAATTTACATAGCACTGTTACATAACCAAATTATTGGATTCATAGTATTGAAAAAGAATTGGAATAACTATGCTTACATAGAAGATATAACGGTGGATAAAAAATATCGTACACTCGGGGTTGGTAAAAGATTAATTGCTCAAGCAAAACAGTGGGCAAAAGAAGGCAACATGCCAGGTATCATGCTTGAAACGCAAAATAATAATGTCGCAGCATGTAAGTTCTATGAAAAATGCGGATTTGTAATTGGTGGATTTGATTTTCTTGTTTATAAAGGCTT
299	gb|JX870080|+|0-861|ARO:3001352|SHV-168	ATGCGTTATTTTCGCCTGTGTATTATCTCTCTGTTAGCCACCCTGCCGCTGGCG...TAA	861.0	16	822	806	861	ATGCGTTATATTCGCCTGTGTATTATCACCCTGTGAGCCACCCTGCCGCTGGCGGTACACGCCAGCCCGCAGCCGCTTGAGCAAATTAAACAAAGCGAAAGCCAGCTGTCGGGCCGCGTAGGCATGATAGAAATGGATCTGGCCAGCGGCCGCACGCTGACCGCCTGGCGCGCCGATGAACGCTTTCCCATGATGAGCACCTTTAAAGTAGTGCTCTGCGGCGCAGTGCTGGCGCGGGTGGATGCCGGTGACGAACAGCTGGAGCGAAAGATCCACTATCGCCAGCAGGATCTGGTGGACTACTCGCCGGTCAGCGAAAAACACCTTGCCGACGGCATGACGGTCGGCGAACTCTGCGCCGCCGCCATTACCATGAGCGATAACAGCGCCGCCAATCTGCTGCTGGCCACCGTCGGCGGCCCCGCAGGATTGACTGCCTTTTTGCGCCAGATCGGCGACAACGTCACCCGCCTTGACCGCTGGGAAACGGAACTGAATGAGGCGCTTCCCGGCGACGCCCGCGACACCACTACCCCGGCCAGCATGGCCGCGACCCTGCGCAAGCTGCTGACCAGCCAGCGTCTGAGCGCCCGTTCGCAACGGCAGCTGCTGCAGTGGATGGTGGACGATCGGGTCGCCGGACCGTTGATCCGCTCCGTGCTGCCGGCGGGCTGGTTTATCGCCGATAAGACCGGAGCTAGCAAGCGGGGTGCGCGCGGGATTGTCGCCCTGCTTGGCCCGAATAACAAAGCAGAGCGCATTGTGGTGATTTATCTGCGGGATACGCCGGCGAGCATGGCCGAGCG
300	gb|HQ425495|+|0-822|ARO:3001482|OXA-197	ATGAACATTAAAGCCCTCTTCCTTATAACAAGCGCTATTTTTATTTCAGCCTGC...TTA	822.0	54149	54916	767	822	ATGAACATTAAAGCACTCTTACTTATAACAAGCGCTATTTTTATTTCAGCCTGCTCACCTTATATAGTGACTGCTAATCCAAATCACAGCGCTTCAAAATCTGATGTAAAAGCAGAGAAAATTAAAAATTTATTTAACGAAGCACACACTACGGGTGTTTTAGTTATCCAACAAGGCCAAACTCAACAAAGCTATGGTAATGATCTTGCTCGTGCTTCGACCGAGTATGTACCTGCTTCGACCTTCAAAATGCTTAATGCTTTGATCGGCCTTGAGCACCATAAGGCAACCACCACAGAAGTATTTAAGTGGGATGGTAAAAAAAGGTTATTCCCAGAATGGGAAAAGGACATGACCCTAGGCGATGCCATGAAAGCTTCCGCTATTCCAGTTTATCAAGATTTAGCTCGTCGTATTGGACTTGAGCTCATGTCTAAGGAAGTGAAGCGTGTTGGTTATGGCAATGCAGATATCGGTACCCAAGTCGATAATTTTTGGCTGGTGGGTCCTTTAAAAATTACTCCTCAGCAAGAGGCACAGTTTGCTTACAAGCTAGCTAATAAAACGCTTCCATTTAGCCAAAAAGTCCAAGATGAAGTGCAATCCATGCTATTCATAGAAGAAAAGAATGGAAACAAAATATACGCAAAAAGTGGTTGGGGATGGGATGTAAACCCACAAGTAGGCTGGTTAACTGGATGGGTTGTTCAGCCTCAAGGGAATATTGTAGCGTTCTCCCTTAACTTAGAAATGAAAAAAGGAATACC
301	gb|X55640|+|111-972|ARO:3001064|SHV-5	ATGCGTTATATTCGCCTGTGTATTATCTCCCTGTTAGCCACCCTGCCGCTGGCG...TAA	861.0	16	822	806	861	ATGCGTTATATTCGCCTGTGTATTATCACCCTGTGAGCCACCCTGCCGCTGGCGGTACACGCCAGCCCGCAGCCGCTTGAGCAAATTAAACAAAGCGAAAGCCAGCTGTCGGGCCGCGTAGGCATGATAGAAATGGATCTGGCCAGCGGCCGCACGCTGACCGCCTGGCGCGCCGATGAACGCTTTCCCATGATGAGCACCTTTAAAGTAGTGCTCTGCGGCGCAGTGCTGGCGCGGGTGGATGCCGGTGACGAACAGCTGGAGCGAAAGATCCACTATCGCCAGCAGGATCTGGTGGACTACTCGCCGGTCAGCGAAAAACACCTTGCCGACGGCATGACGGTCGGCGAACTCTGCGCCGCCGCCATTACCATGAGCGATAACAGCGCCGCCAATCTGCTGCTGGCCACCGTCGGCGGCCCCGCAGGATTGACTGCCTTTTTGCGCCAGATCGGCGACAACGTCACCCGCCTTGACCGCTGGGAAACGGAACTGAATGAGGCGCTTCCCGGCGACGCCCGCGACACCACTACCCCGGCCAGCATGGCCGCGACCCTGCGCAAGCTGCTGACCAGCCAGCGTCTGAGCGCCCGTTCGCAACGGCAGCTGCTGCAGTGGATGGTGGACGATCGGGTCGCCGGACCGTTGATCCGCTCCGTGCTGCCGGCGGGCTGGTTTATCGCCGATAAGACCGGAGCTAGCAAGCGGGGTGCGCGCGGGATTGTCGCCCTGCTTGGCCCGAATAACAAAGCAGAGCGCATTGTGGTGATTTATCTGCGGGATACGCCGGCGAGCATGGCCGAGCG
302	gb|DQ149247|+|0-825|ARO:3001703|OXA-86	ATGAACATTAAAACACTCTTACTTATAACAAGCACTATTTTTATTTCAGCCTGC...TAG	825.0	54149	54919	770	825	ATGAACATTAAAGCACTCTTACTTATAACAAGCGCTATTTTTATTTCAGCCTGCTCACCTTATATAGTGACTGCTAATCCAAATCACAGCGCTTCAAAATCTGATGTAAAAGCAGAGAAAATTAAAAATTTATTTAACGAAGCACACACTACGGGTGTTTTAGTTATCCAACAAGGCCAAACTCAACAAAGCTATGGTAATGATCTTGCTCGTGCTTCGACCGAGTATGTACCTGCTTCGACCTTCAAAATGCTTAATGCTTTGATCGGCCTTGAGCACCATAAGGCAACCACCACAGAAGTATTTAAGTGGGATGGTAAAAAAAGGTTATTCCCAGAATGGGAAAAGGACATGACCCTAGGCGATGCCATGAAAGCTTCCGCTATTCCAGTTTATCAAGATTTAGCTCGTCGTATTGGACTTGAGCTCATGTCTAAGGAAGTGAAGCGTGTTGGTTATGGCAATGCAGATATCGGTACCCAAGTCGATAATTTTTGGCTGGTGGGTCCTTTAAAAATTACTCCTCAGCAAGAGGCACAGTTTGCTTACAAGCTAGCTAATAAAACGCTTCCATTTAGCCAAAAAGTCCAAGATGAAGTGCAATCCATGCTATTCATAGAAGAAAAGAATGGAAACAAAATATACGCAAAAAGTGGTTGGGGATGGGATGTAAACCCACAAGTAGGCTGGTTAACTGGATGGGTTGTTCAGCCTCAAGGGAATATTGTAGCGTTCTCCCTTAACTTAGAAATGAAAAAAGGAATACCTAG
303	gb|KX354370.1|+|0-1194|ARO:3004343|PDC-80	ATGCGCGATACCAGATTCCCCTGCCTGTGCGGCATCGCCGCTTCCACACTGCTG...TGA	1194.0	35513	36652	1139	1194	ATGCGCGATACCAGATTCCCCTGCCTGTGCGGCATCGCCGCTTCCACACTGCTGTTCGCCACCACCCCGGCCATTGCCGATGAGGCCCCGGCGGATCGCCTGAAGGCACTGGTCGACGCCGCCGTACAACCGGTGATGAAGGCCAATGACATTCCGGGCCTGGCCGTAGCCATCAGCCTGAAAGGAGAACCGCATTACTTCAGCTATGGGCTGGCCTCGAAAGAGGACGGCCGCCGGGTGACGCCGGAGACCCTGTTCGAGATCGGCTCGGTGAGCAAGACCTTCACCGTCACCCTCGCCGGCTATGCCCTGGCCCAGGACAAGATGCGCCTCGACGACCGCGCCAGCCAGCACTGGCCGGCACTGCAGGGCAGCCGCTTCGACGGCATCAGCCTGCTCGACCTCGCGACCTATACCGCCGGCGGCTTGCCGCTGCAGTTCCCCGACTCGGTGCAGAAGGACCAGGCACAGATCCGCGACTACTACCGCCAGTGGCAGCCGACCTACGCGCCGGGCAGCCAGCGCCTCTATTCCAACCCGAGCATCGGCCTGTTCGGCTATCTCGCCGCGCGCAGCCTGGGCCAGCCGTTCGAACGGCTCATGGAGCAGCAATTGTTCCCGGCACTGGGCCTCGAACAGACCCACCTCGACGTGCCCGAGGCGGCGCTGGCGCAGTACGCCCAGGGCTACGGCAAGGACGACCGCCCGCTACGGGTCGGTCCCGGCCCGCTGGATGCCGAAGGCTACGGGGTGAAGACCAGCGCGGCCGACCTGCTGCGCTTCGTCGATGCCAACCTGCATCCGGAGCGCCTGGACAGGCCCTGGGCGCAGGCGCTCGATGCCACCCATCGCGGTTACTACAAGGTCGGCGACATGACCCAGGGCCTGGGCTGGGAAGCCTACGACTGGCCGATCTCCCTGAAGCGCCTGCAGGCCGGCAACTCGACGCCGATGGCGCTGCAACCACACAGGATCGCCAGGCTGCCCGCGCCACAGGCGCTGGAGGGCCAGCGCCTGCTGAACAAGACCGGCTCCACCAACGGCTTCGGCGCCTACGTGGCGTTCGTCCCGGGCCGCGACCTGGGCCTGGTGATCCTGGCCAACCGCAACTATCCCAATGCCGAGCGGGTGAAGATCGC
304	gb|HQ734811|+|0-825|ARO:3001665|OXA-200	ATGAACATTAAAGCCCTCTTACTTATAACAAGCGCTATTTTTATTTCAGCCTGC...TAG	825.0	54149	54919	770	825	ATGAACATTAAAGCACTCTTACTTATAACAAGCGCTATTTTTATTTCAGCCTGCTCACCTTATATAGTGACTGCTAATCCAAATCACAGCGCTTCAAAATCTGATGTAAAAGCAGAGAAAATTAAAAATTTATTTAACGAAGCACACACTACGGGTGTTTTAGTTATCCAACAAGGCCAAACTCAACAAAGCTATGGTAATGATCTTGCTCGTGCTTCGACCGAGTATGTACCTGCTTCGACCTTCAAAATGCTTAATGCTTTGATCGGCCTTGAGCACCATAAGGCAACCACCACAGAAGTATTTAAGTGGGATGGTAAAAAAAGGTTATTCCCAGAATGGGAAAAGGACATGACCCTAGGCGATGCCATGAAAGCTTCCGCTATTCCAGTTTATCAAGATTTAGCTCGTCGTATTGGACTTGAGCTCATGTCTAAGGAAGTGAAGCGTGTTGGTTATGGCAATGCAGATATCGGTACCCAAGTCGATAATTTTTGGCTGGTGGGTCCTTTAAAAATTACTCCTCAGCAAGAGGCACAGTTTGCTTACAAGCTAGCTAATAAAACGCTTCCATTTAGCCAAAAAGTCCAAGATGAAGTGCAATCCATGCTATTCATAGAAGAAAAGAATGGAAACAAAATATACGCAAAAAGTGGTTGGGGATGGGATGTAAACCCACAAGTAGGCTGGTTAACTGGATGGGTTGTTCAGCCTCAAGGGAATATTGTAGCGTTCTCCCTTAACTTAGAAATGAAAAAAGGAATACCTAG
305	gb|MG601730.1|+|0-1152|ARO:3003852|ADC-6	ATGCGATTTAAAAAAATTTCTTGTCTACTTTTATCCCCGCTTTTTATTTTTAGT...TAA	1152.0	63	1160	1097	1152	ATGCGATTTAAAAAAATTTCTTGTCTACTTTTATCCCCGCTTTTTATTTTTAGTACCTCAATTTATGCGGGCAATACACCAAAAGACCAAGAAATTAAAAAACTGGTAGATCAAAACTTTAAACCGTTATTAGAAAAATATGATGTGCCAGGTATGGCTGTGGGTGTTATTCAAAATAATAAAAAGTATGAAATGTATTATGGTCTTCAATCTGTTCAAGATAAAAAAGCCGTAAATAGCAGTACTATTTTTGAGCTAGGTTCTGTCAGTAAATTATTTACCGCGACAGCAGGTGGATATGCAAAAAATAAAGGAAAAATCTCTTTTGACGATACGCCTGGTAAGTATTGGAAAGAACTAAAAAATACACCGATTGACCAAGTTAACTTACTTCAACTCGCGACGTATACAAGTGGTAACCTTGCCTTGCAATTTCCAGATGAAGTAAAAACAGATCAGCAAGTTTTAACATTTTTTAAAGACTGGAAACCTAAAAACTCAATCGGTGAATATCGACAATATTCAAACCCAAGCATTGGTTTATTTGGAAAAGTTGTAGCTTTGTCTATGAATAAACCTTTCGACCAAGTCTTAGAAAAAACAATTTTTCCGGCCCTTGGCTTAAAACATAGCTATGTAAATGTACCTAAGACCCAGATGCAAAACTATGCTTTTGGCTATAACCAAGAAAATCAGCCGATTCGAGTTAACCCCGGCCCACTCGATGCCCCAGCATATGGCGTCAAATCGACACTACCCGACATGTTGAGTTTTATTCATGCCAACCTAAATCCACAAAAATATCCAGCAGATATTCAACGGGCAATTAATGAAACACATCAGGGTCGCTATCAAGTAAATACCATGTATCAGGCACTCGGTTGGGAAGAGTTTTCTTATCCGGCAACGTTACAAACTTTATTAGACAGTAATTCAGAACAGATTGTGATGAAACCTAATAAAGTGACTGCTATTTCAAAGGAACCTTCAGTTAAGATGTACCATAAAACTGGCTCAACTACCGGTTTCGGAACATATGTGGTGTTTATTCCTAAAGAAAATATTGGTTTAGTCATGTTAACCAATAAACGTATTCC
306	gb|AB871653|+|11870-12695|ARO:3001557|OXA-371	ATGAACATTAAAGCACTCTTACTTATAACAAGCGCTATTTTTATTTCAGCCTGC...TAG	825.0	54149	54919	770	825	ATGAACATTAAAGCACTCTTACTTATAACAAGCGCTATTTTTATTTCAGCCTGCTCACCTTATATAGTGACTGCTAATCCAAATCACAGCGCTTCAAAATCTGATGTAAAAGCAGAGAAAATTAAAAATTTATTTAACGAAGCACACACTACGGGTGTTTTAGTTATCCAACAAGGCCAAACTCAACAAAGCTATGGTAATGATCTTGCTCGTGCTTCGACCGAGTATGTACCTGCTTCGACCTTCAAAATGCTTAATGCTTTGATCGGCCTTGAGCACCATAAGGCAACCACCACAGAAGTATTTAAGTGGGATGGTAAAAAAAGGTTATTCCCAGAATGGGAAAAGGACATGACCCTAGGCGATGCCATGAAAGCTTCCGCTATTCCAGTTTATCAAGATTTAGCTCGTCGTATTGGACTTGAGCTCATGTCTAAGGAAGTGAAGCGTGTTGGTTATGGCAATGCAGATATCGGTACCCAAGTCGATAATTTTTGGCTGGTGGGTCCTTTAAAAATTACTCCTCAGCAAGAGGCACAGTTTGCTTACAAGCTAGCTAATAAAACGCTTCCATTTAGCCAAAAAGTCCAAGATGAAGTGCAATCCATGCTATTCATAGAAGAAAAGAATGGAAACAAAATATACGCAAAAAGTGGTTGGGGATGGGATGTAAACCCACAAGTAGGCTGGTTAACTGGATGGGTTGTTCAGCCTCAAGGGAATATTGTAGCGTTCTCCCTTAACTTAGAAATGAAAAAAGGAATACCTAG
307	gb|AL513383|+|161910-162771|ARO:3000873|TEM-1	ATGAGTATTCAACATTTTCGTGTCGCCCTTATTCCCTTTTTTGCGGCATTTTGC...TAA	861.0	46	852	806	861	ATGAGTATTCAACATTTCCGTGTCGCCCTTATTCCCTTTTTTGCGGCATTTTGCCTTCCTGTTTTTGCTCACCCAGAAACGCTGGTGAAAGTAAAAGATGCTGAAGATCAGTTGGGTGCACGAGTGGGTTACATCGAGCTGGATCTCAACAGCGGTAAGATCCTTGAGAGTTTTCGCCCCGAAGAACGTTTTCCAATGATGAGCACTTTTAAAGTTCTGCTATGTGGTGCGGTATTATCCCGTGTTGACGCCGGGCAAGAGCAACTCGGTCGCCGCATACACTATTCTCAGAATGACTTGGTTGAGTACTCACCAGTCACAGAAAAGCATCTTACGGATGGCATGACAGTAAGAGAATTATGCAGTGCTGCCATAACCATGAGTGATAACACTGCGGCCAACTTACTTCTGACAACGATCGGAGGACCGAAGGAGCTAACCGCTTTTTTGCACAACATGGGGGATCATGTAACCCGCCTTGATCGTTGGGAACCGGAGCTGAATGAAGCCATACCAAACGACGAGCGTGACACCACGATGCCTGCAGCAATGGCAACAACGTTGCGCAAACTATTAACTGGCGAACTACTTACTCTAGCTTCCCGGCAACAATTAATAGACTGGATGGAGGCGGATAAAGTTGCAGGACCACTTCTGCGCTCGGCCCTTCCGGCTGGCTGGTTTATTGCTGATAAATCTGGAGCCGGTGAGCGTGGATCTCGCGGTATCATTGCAGCACTGGGGCCAGATGGTAAGCCCTCCCGTATCGTAGTTATCTACACGACGGGGAGTCAGGCAACTATGGA
308	gb|HQ734812|+|0-825|ARO:3001666|OXA-201	ATGAACATTAAAGCACTCTTACTTATAACAAGCGCTATTTTTATTTCAGCCTGC...TAG	825.0	54149	54919	770	825	ATGAACATTAAAGCACTCTTACTTATAACAAGCGCTATTTTTATTTCAGCCTGCTCACCTTATATAGTGACTGCTAATCCAAATCACAGCGCTTCAAAATCTGATGTAAAAGCAGAGAAAATTAAAAATTTATTTAACGAAGCACACACTACGGGTGTTTTAGTTATCCAACAAGGCCAAACTCAACAAAGCTATGGTAATGATCTTGCTCGTGCTTCGACCGAGTATGTACCTGCTTCGACCTTCAAAATGCTTAATGCTTTGATCGGCCTTGAGCACCATAAGGCAACCACCACAGAAGTATTTAAGTGGGATGGTAAAAAAAGGTTATTCCCAGAATGGGAAAAGGACATGACCCTAGGCGATGCCATGAAAGCTTCCGCTATTCCAGTTTATCAAGATTTAGCTCGTCGTATTGGACTTGAGCTCATGTCTAAGGAAGTGAAGCGTGTTGGTTATGGCAATGCAGATATCGGTACCCAAGTCGATAATTTTTGGCTGGTGGGTCCTTTAAAAATTACTCCTCAGCAAGAGGCACAGTTTGCTTACAAGCTAGCTAATAAAACGCTTCCATTTAGCCAAAAAGTCCAAGATGAAGTGCAATCCATGCTATTCATAGAAGAAAAGAATGGAAACAAAATATACGCAAAAAGTGGTTGGGGATGGGATGTAAACCCACAAGTAGGCTGGTTAACTGGATGGGTTGTTCAGCCTCAAGGGAATATTGTAGCGTTCTCCCTTAACTTAGAAATGAAAAAAGGAATACCTAG
309	gb|DQ348075|+|0-825|ARO:3001704|OXA-87	ATGAACATTAAAACACTCTTACTTATAACAAGCACTATTTTTATTTCAGCCTGC...TAG	825.0	54149	54919	770	825	ATGAACATTAAAGCACTCTTACTTATAACAAGCGCTATTTTTATTTCAGCCTGCTCACCTTATATAGTGACTGCTAATCCAAATCACAGCGCTTCAAAATCTGATGTAAAAGCAGAGAAAATTAAAAATTTATTTAACGAAGCACACACTACGGGTGTTTTAGTTATCCAACAAGGCCAAACTCAACAAAGCTATGGTAATGATCTTGCTCGTGCTTCGACCGAGTATGTACCTGCTTCGACCTTCAAAATGCTTAATGCTTTGATCGGCCTTGAGCACCATAAGGCAACCACCACAGAAGTATTTAAGTGGGATGGTAAAAAAAGGTTATTCCCAGAATGGGAAAAGGACATGACCCTAGGCGATGCCATGAAAGCTTCCGCTATTCCAGTTTATCAAGATTTAGCTCGTCGTATTGGACTTGAGCTCATGTCTAAGGAAGTGAAGCGTGTTGGTTATGGCAATGCAGATATCGGTACCCAAGTCGATAATTTTTGGCTGGTGGGTCCTTTAAAAATTACTCCTCAGCAAGAGGCACAGTTTGCTTACAAGCTAGCTAATAAAACGCTTCCATTTAGCCAAAAAGTCCAAGATGAAGTGCAATCCATGCTATTCATAGAAGAAAAGAATGGAAACAAAATATACGCAAAAAGTGGTTGGGGATGGGATGTAAACCCACAAGTAGGCTGGTTAACTGGATGGGTTGTTCAGCCTCAAGGGAATATTGTAGCGTTCTCCCTTAACTTAGAAATGAAAAAAGGAATACCTAG
310	gb|AY288915|+|0-861|ARO:3001107|SHV-50	ATGCGTTATATTCGCCTGTGTATTATCTCCCTGTTAGCCACCCTGCCGCTGGCG...TAA	861.0	16	822	806	861	ATGCGTTATATTCGCCTGTGTATTATCACCCTGTGAGCCACCCTGCCGCTGGCGGTACACGCCAGCCCGCAGCCGCTTGAGCAAATTAAACAAAGCGAAAGCCAGCTGTCGGGCCGCGTAGGCATGATAGAAATGGATCTGGCCAGCGGCCGCACGCTGACCGCCTGGCGCGCCGATGAACGCTTTCCCATGATGAGCACCTTTAAAGTAGTGCTCTGCGGCGCAGTGCTGGCGCGGGTGGATGCCGGTGACGAACAGCTGGAGCGAAAGATCCACTATCGCCAGCAGGATCTGGTGGACTACTCGCCGGTCAGCGAAAAACACCTTGCCGACGGCATGACGGTCGGCGAACTCTGCGCCGCCGCCATTACCATGAGCGATAACAGCGCCGCCAATCTGCTGCTGGCCACCGTCGGCGGCCCCGCAGGATTGACTGCCTTTTTGCGCCAGATCGGCGACAACGTCACCCGCCTTGACCGCTGGGAAACGGAACTGAATGAGGCGCTTCCCGGCGACGCCCGCGACACCACTACCCCGGCCAGCATGGCCGCGACCCTGCGCAAGCTGCTGACCAGCCAGCGTCTGAGCGCCCGTTCGCAACGGCAGCTGCTGCAGTGGATGGTGGACGATCGGGTCGCCGGACCGTTGATCCGCTCCGTGCTGCCGGCGGGCTGGTTTATCGCCGATAAGACCGGAGCTAGCAAGCGGGGTGCGCGCGGGATTGTCGCCCTGCTTGGCCCGAATAACAAAGCAGAGCGCATTGTGGTGATTTATCTGCGGGATACGCCGGCGAGCATGGCCGAGCG
311	gb|KF513177|+|0-861|ARO:3001356|SHV-172	ATGCGTTATATTCGCCTGTGTATTATCTCCCTGTTAGCCACCCTGCCGCTGGCG...TAA	861.0	16	822	806	861	ATGCGTTATATTCGCCTGTGTATTATCACCCTGTGAGCCACCCTGCCGCTGGCGGTACACGCCAGCCCGCAGCCGCTTGAGCAAATTAAACAAAGCGAAAGCCAGCTGTCGGGCCGCGTAGGCATGATAGAAATGGATCTGGCCAGCGGCCGCACGCTGACCGCCTGGCGCGCCGATGAACGCTTTCCCATGATGAGCACCTTTAAAGTAGTGCTCTGCGGCGCAGTGCTGGCGCGGGTGGATGCCGGTGACGAACAGCTGGAGCGAAAGATCCACTATCGCCAGCAGGATCTGGTGGACTACTCGCCGGTCAGCGAAAAACACCTTGCCGACGGCATGACGGTCGGCGAACTCTGCGCCGCCGCCATTACCATGAGCGATAACAGCGCCGCCAATCTGCTGCTGGCCACCGTCGGCGGCCCCGCAGGATTGACTGCCTTTTTGCGCCAGATCGGCGACAACGTCACCCGCCTTGACCGCTGGGAAACGGAACTGAATGAGGCGCTTCCCGGCGACGCCCGCGACACCACTACCCCGGCCAGCATGGCCGCGACCCTGCGCAAGCTGCTGACCAGCCAGCGTCTGAGCGCCCGTTCGCAACGGCAGCTGCTGCAGTGGATGGTGGACGATCGGGTCGCCGGACCGTTGATCCGCTCCGTGCTGCCGGCGGGCTGGTTTATCGCCGATAAGACCGGAGCTAGCAAGCGGGGTGCGCGCGGGATTGTCGCCCTGCTTGGCCCGAATAACAAAGCAGAGCGCATTGTGGTGATTTATCTGCGGGATACGCCGGCGAGCATGGCCGAGCG
312	gb|HQ734813|+|0-825|ARO:3001667|OXA-202	ATGAACATTAAAGCACTCTTACTTATAACAAGCGCTATTTTTATTTCAGCCTGC...TAG	825.0	54149	54919	770	825	ATGAACATTAAAGCACTCTTACTTATAACAAGCGCTATTTTTATTTCAGCCTGCTCACCTTATATAGTGACTGCTAATCCAAATCACAGCGCTTCAAAATCTGATGTAAAAGCAGAGAAAATTAAAAATTTATTTAACGAAGCACACACTACGGGTGTTTTAGTTATCCAACAAGGCCAAACTCAACAAAGCTATGGTAATGATCTTGCTCGTGCTTCGACCGAGTATGTACCTGCTTCGACCTTCAAAATGCTTAATGCTTTGATCGGCCTTGAGCACCATAAGGCAACCACCACAGAAGTATTTAAGTGGGATGGTAAAAAAAGGTTATTCCCAGAATGGGAAAAGGACATGACCCTAGGCGATGCCATGAAAGCTTCCGCTATTCCAGTTTATCAAGATTTAGCTCGTCGTATTGGACTTGAGCTCATGTCTAAGGAAGTGAAGCGTGTTGGTTATGGCAATGCAGATATCGGTACCCAAGTCGATAATTTTTGGCTGGTGGGTCCTTTAAAAATTACTCCTCAGCAAGAGGCACAGTTTGCTTACAAGCTAGCTAATAAAACGCTTCCATTTAGCCAAAAAGTCCAAGATGAAGTGCAATCCATGCTATTCATAGAAGAAAAGAATGGAAACAAAATATACGCAAAAAGTGGTTGGGGATGGGATGTAAACCCACAAGTAGGCTGGTTAACTGGATGGGTTGTTCAGCCTCAAGGGAATATTGTAGCGTTCTCCCTTAACTTAGAAATGAAAAAAGGAATACCTAG
313	gb|DQ392963|+|8-833|ARO:3001626|OXA-88	ATGAACATTAAAGCACTCTTACTTATAACAAGCGCTATTTTTATTTCAGCCTGC...TAG	825.0	54149	54919	770	825	ATGAACATTAAAGCACTCTTACTTATAACAAGCGCTATTTTTATTTCAGCCTGCTCACCTTATATAGTGACTGCTAATCCAAATCACAGCGCTTCAAAATCTGATGTAAAAGCAGAGAAAATTAAAAATTTATTTAACGAAGCACACACTACGGGTGTTTTAGTTATCCAACAAGGCCAAACTCAACAAAGCTATGGTAATGATCTTGCTCGTGCTTCGACCGAGTATGTACCTGCTTCGACCTTCAAAATGCTTAATGCTTTGATCGGCCTTGAGCACCATAAGGCAACCACCACAGAAGTATTTAAGTGGGATGGTAAAAAAAGGTTATTCCCAGAATGGGAAAAGGACATGACCCTAGGCGATGCCATGAAAGCTTCCGCTATTCCAGTTTATCAAGATTTAGCTCGTCGTATTGGACTTGAGCTCATGTCTAAGGAAGTGAAGCGTGTTGGTTATGGCAATGCAGATATCGGTACCCAAGTCGATAATTTTTGGCTGGTGGGTCCTTTAAAAATTACTCCTCAGCAAGAGGCACAGTTTGCTTACAAGCTAGCTAATAAAACGCTTCCATTTAGCCAAAAAGTCCAAGATGAAGTGCAATCCATGCTATTCATAGAAGAAAAGAATGGAAACAAAATATACGCAAAAAGTGGTTGGGGATGGGATGTAAACCCACAAGTAGGCTGGTTAACTGGATGGGTTGTTCAGCCTCAAGGGAATATTGTAGCGTTCTCCCTTAACTTAGAAATGAAAAAAGGAATACCTAG
314	gb|JQ692087.1|+|0-1152|ARO:3004620|ADC-60	ATGCGATTTAAAAAAATTTCTTGTTTACTTTTATCCCCGCTTTTTATTTTTAGT...TAA	1152.0	63	1160	1097	1152	ATGCGATTTAAAAAAATTTCTTGTCTACTTTTATCCCCGCTTTTTATTTTTAGTACCTCAATTTATGCGGGCAATACACCAAAAGACCAAGAAATTAAAAAACTGGTAGATCAAAACTTTAAACCGTTATTAGAAAAATATGATGTGCCAGGTATGGCTGTGGGTGTTATTCAAAATAATAAAAAGTATGAAATGTATTATGGTCTTCAATCTGTTCAAGATAAAAAAGCCGTAAATAGCAGTACTATTTTTGAGCTAGGTTCTGTCAGTAAATTATTTACCGCGACAGCAGGTGGATATGCAAAAAATAAAGGAAAAATCTCTTTTGACGATACGCCTGGTAAGTATTGGAAAGAACTAAAAAATACACCGATTGACCAAGTTAACTTACTTCAACTCGCGACGTATACAAGTGGTAACCTTGCCTTGCAATTTCCAGATGAAGTAAAAACAGATCAGCAAGTTTTAACATTTTTTAAAGACTGGAAACCTAAAAACTCAATCGGTGAATATCGACAATATTCAAACCCAAGCATTGGTTTATTTGGAAAAGTTGTAGCTTTGTCTATGAATAAACCTTTCGACCAAGTCTTAGAAAAAACAATTTTTCCGGCCCTTGGCTTAAAACATAGCTATGTAAATGTACCTAAGACCCAGATGCAAAACTATGCTTTTGGCTATAACCAAGAAAATCAGCCGATTCGAGTTAACCCCGGCCCACTCGATGCCCCAGCATATGGCGTCAAATCGACACTACCCGACATGTTGAGTTTTATTCATGCCAACCTAAATCCACAAAAATATCCAGCAGATATTCAACGGGCAATTAATGAAACACATCAGGGTCGCTATCAAGTAAATACCATGTATCAGGCACTCGGTTGGGAAGAGTTTTCTTATCCGGCAACGTTACAAACTTTATTAGACAGTAATTCAGAACAGATTGTGATGAAACCTAATAAAGTGACTGCTATTTCAAAGGAACCTTCAGTTAAGATGTACCATAAAACTGGCTCAACTACCGGTTTCGGAACATATGTGGTGTTTATTCCTAAAGAAAATATTGGTTTAGTCATGTTAACCAATAAACGTATTCC
315	gb|AF093512|+|197-1058|ARO:3000882|TEM-10	ATGAGTATTCAACATTTTCGTGTCGCCCTTATTCCCTTTTTTGCGGCATTTTGC...TAA	861.0	46	852	806	861	ATGAGTATTCAACATTTCCGTGTCGCCCTTATTCCCTTTTTTGCGGCATTTTGCCTTCCTGTTTTTGCTCACCCAGAAACGCTGGTGAAAGTAAAAGATGCTGAAGATCAGTTGGGTGCACGAGTGGGTTACATCGAGCTGGATCTCAACAGCGGTAAGATCCTTGAGAGTTTTCGCCCCGAAGAACGTTTTCCAATGATGAGCACTTTTAAAGTTCTGCTATGTGGTGCGGTATTATCCCGTGTTGACGCCGGGCAAGAGCAACTCGGTCGCCGCATACACTATTCTCAGAATGACTTGGTTGAGTACTCACCAGTCACAGAAAAGCATCTTACGGATGGCATGACAGTAAGAGAATTATGCAGTGCTGCCATAACCATGAGTGATAACACTGCGGCCAACTTACTTCTGACAACGATCGGAGGACCGAAGGAGCTAACCGCTTTTTTGCACAACATGGGGGATCATGTAACCCGCCTTGATCGTTGGGAACCGGAGCTGAATGAAGCCATACCAAACGACGAGCGTGACACCACGATGCCTGCAGCAATGGCAACAACGTTGCGCAAACTATTAACTGGCGAACTACTTACTCTAGCTTCCCGGCAACAATTAATAGACTGGATGGAGGCGGATAAAGTTGCAGGACCACTTCTGCGCTCGGCCCTTCCGGCTGGCTGGTTTATTGCTGATAAATCTGGAGCCGGTGAGCGTGGATCTCGCGGTATCATTGCAGCACTGGGGCCAGATGGTAAGCCCTCCCGTATCGTAGTTATCTACACGACGGGGAGTCAGGCAACTATGGA
316	gb|HQ998857|+|0-825|ARO:3001664|OXA-203	ATGAACATTAAAGCACTCTTACTTATAACAAGCGCTATTTTTATTTCAGCCTGT...TAG	825.0	54149	54919	770	825	ATGAACATTAAAGCACTCTTACTTATAACAAGCGCTATTTTTATTTCAGCCTGCTCACCTTATATAGTGACTGCTAATCCAAATCACAGCGCTTCAAAATCTGATGTAAAAGCAGAGAAAATTAAAAATTTATTTAACGAAGCACACACTACGGGTGTTTTAGTTATCCAACAAGGCCAAACTCAACAAAGCTATGGTAATGATCTTGCTCGTGCTTCGACCGAGTATGTACCTGCTTCGACCTTCAAAATGCTTAATGCTTTGATCGGCCTTGAGCACCATAAGGCAACCACCACAGAAGTATTTAAGTGGGATGGTAAAAAAAGGTTATTCCCAGAATGGGAAAAGGACATGACCCTAGGCGATGCCATGAAAGCTTCCGCTATTCCAGTTTATCAAGATTTAGCTCGTCGTATTGGACTTGAGCTCATGTCTAAGGAAGTGAAGCGTGTTGGTTATGGCAATGCAGATATCGGTACCCAAGTCGATAATTTTTGGCTGGTGGGTCCTTTAAAAATTACTCCTCAGCAAGAGGCACAGTTTGCTTACAAGCTAGCTAATAAAACGCTTCCATTTAGCCAAAAAGTCCAAGATGAAGTGCAATCCATGCTATTCATAGAAGAAAAGAATGGAAACAAAATATACGCAAAAAGTGGTTGGGGATGGGATGTAAACCCACAAGTAGGCTGGTTAACTGGATGGGTTGTTCAGCCTCAAGGGAATATTGTAGCGTTCTCCCTTAACTTAGAAATGAAAAAAGGAATACCTAG
317	gb|DQ445683|+|0-825|ARO:3001625|OXA-89	ATGAACATTAAAACACTCTTACTTATAACAAGCGCTATTTTTATTTCAGCCTGC...TAG	825.0	54149	54919	770	825	ATGAACATTAAAGCACTCTTACTTATAACAAGCGCTATTTTTATTTCAGCCTGCTCACCTTATATAGTGACTGCTAATCCAAATCACAGCGCTTCAAAATCTGATGTAAAAGCAGAGAAAATTAAAAATTTATTTAACGAAGCACACACTACGGGTGTTTTAGTTATCCAACAAGGCCAAACTCAACAAAGCTATGGTAATGATCTTGCTCGTGCTTCGACCGAGTATGTACCTGCTTCGACCTTCAAAATGCTTAATGCTTTGATCGGCCTTGAGCACCATAAGGCAACCACCACAGAAGTATTTAAGTGGGATGGTAAAAAAAGGTTATTCCCAGAATGGGAAAAGGACATGACCCTAGGCGATGCCATGAAAGCTTCCGCTATTCCAGTTTATCAAGATTTAGCTCGTCGTATTGGACTTGAGCTCATGTCTAAGGAAGTGAAGCGTGTTGGTTATGGCAATGCAGATATCGGTACCCAAGTCGATAATTTTTGGCTGGTGGGTCCTTTAAAAATTACTCCTCAGCAAGAGGCACAGTTTGCTTACAAGCTAGCTAATAAAACGCTTCCATTTAGCCAAAAAGTCCAAGATGAAGTGCAATCCATGCTATTCATAGAAGAAAAGAATGGAAACAAAATATACGCAAAAAGTGGTTGGGGATGGGATGTAAACCCACAAGTAGGCTGGTTAACTGGATGGGTTGTTCAGCCTCAAGGGAATATTGTAGCGTTCTCCCTTAACTTAGAAATGAAAAAAGGAATACCTAG
318	gb|AY289548|+|0-861|ARO:3001108|SHV-51	ATGCGTTATATTCGCCTGTGTATTATCTCCCTGTTAGCCACCCTGCCGCTGGCG...TAA	861.0	16	822	806	861	ATGCGTTATATTCGCCTGTGTATTATCACCCTGTGAGCCACCCTGCCGCTGGCGGTACACGCCAGCCCGCAGCCGCTTGAGCAAATTAAACAAAGCGAAAGCCAGCTGTCGGGCCGCGTAGGCATGATAGAAATGGATCTGGCCAGCGGCCGCACGCTGACCGCCTGGCGCGCCGATGAACGCTTTCCCATGATGAGCACCTTTAAAGTAGTGCTCTGCGGCGCAGTGCTGGCGCGGGTGGATGCCGGTGACGAACAGCTGGAGCGAAAGATCCACTATCGCCAGCAGGATCTGGTGGACTACTCGCCGGTCAGCGAAAAACACCTTGCCGACGGCATGACGGTCGGCGAACTCTGCGCCGCCGCCATTACCATGAGCGATAACAGCGCCGCCAATCTGCTGCTGGCCACCGTCGGCGGCCCCGCAGGATTGACTGCCTTTTTGCGCCAGATCGGCGACAACGTCACCCGCCTTGACCGCTGGGAAACGGAACTGAATGAGGCGCTTCCCGGCGACGCCCGCGACACCACTACCCCGGCCAGCATGGCCGCGACCCTGCGCAAGCTGCTGACCAGCCAGCGTCTGAGCGCCCGTTCGCAACGGCAGCTGCTGCAGTGGATGGTGGACGATCGGGTCGCCGGACCGTTGATCCGCTCCGTGCTGCCGGCGGGCTGGTTTATCGCCGATAAGACCGGAGCTAGCAAGCGGGGTGCGCGCGGGATTGTCGCCCTGCTTGGCCCGAATAACAAAGCAGAGCGCATTGTGGTGATTTATCTGCGGGATACGCCGGCGAGCATGGCCGAGCG
319	gb|JQ753702.1|+|0-1152|ARO:3003879|ADC-61	ATGCGATTTAAAAAAATTTCTTGTCTACTTTTATCCCCGCTTTTTATTTTTAGT...TAA	1152.0	63	1160	1097	1152	ATGCGATTTAAAAAAATTTCTTGTCTACTTTTATCCCCGCTTTTTATTTTTAGTACCTCAATTTATGCGGGCAATACACCAAAAGACCAAGAAATTAAAAAACTGGTAGATCAAAACTTTAAACCGTTATTAGAAAAATATGATGTGCCAGGTATGGCTGTGGGTGTTATTCAAAATAATAAAAAGTATGAAATGTATTATGGTCTTCAATCTGTTCAAGATAAAAAAGCCGTAAATAGCAGTACTATTTTTGAGCTAGGTTCTGTCAGTAAATTATTTACCGCGACAGCAGGTGGATATGCAAAAAATAAAGGAAAAATCTCTTTTGACGATACGCCTGGTAAGTATTGGAAAGAACTAAAAAATACACCGATTGACCAAGTTAACTTACTTCAACTCGCGACGTATACAAGTGGTAACCTTGCCTTGCAATTTCCAGATGAAGTAAAAACAGATCAGCAAGTTTTAACATTTTTTAAAGACTGGAAACCTAAAAACTCAATCGGTGAATATCGACAATATTCAAACCCAAGCATTGGTTTATTTGGAAAAGTTGTAGCTTTGTCTATGAATAAACCTTTCGACCAAGTCTTAGAAAAAACAATTTTTCCGGCCCTTGGCTTAAAACATAGCTATGTAAATGTACCTAAGACCCAGATGCAAAACTATGCTTTTGGCTATAACCAAGAAAATCAGCCGATTCGAGTTAACCCCGGCCCACTCGATGCCCCAGCATATGGCGTCAAATCGACACTACCCGACATGTTGAGTTTTATTCATGCCAACCTAAATCCACAAAAATATCCAGCAGATATTCAACGGGCAATTAATGAAACACATCAGGGTCGCTATCAAGTAAATACCATGTATCAGGCACTCGGTTGGGAAGAGTTTTCTTATCCGGCAACGTTACAAACTTTATTAGACAGTAATTCAGAACAGATTGTGATGAAACCTAATAAAGTGACTGCTATTTCAAAGGAACCTTCAGTTAAGATGTACCATAAAACTGGCTCAACTACCGGTTTCGGAACATATGTGGTGTTTATTCCTAAAGAAAATATTGGTTTAGTCATGTTAACCAATAAACGTATTCC
320	gb|AB634250|+|0-825|ARO:3001484|OXA-206	ATGAACATTAAAGCACTCTTACTTATAACAAGCGCTATTTTTATTTCAGCCTGC...TAG	825.0	54149	54919	770	825	ATGAACATTAAAGCACTCTTACTTATAACAAGCGCTATTTTTATTTCAGCCTGCTCACCTTATATAGTGACTGCTAATCCAAATCACAGCGCTTCAAAATCTGATGTAAAAGCAGAGAAAATTAAAAATTTATTTAACGAAGCACACACTACGGGTGTTTTAGTTATCCAACAAGGCCAAACTCAACAAAGCTATGGTAATGATCTTGCTCGTGCTTCGACCGAGTATGTACCTGCTTCGACCTTCAAAATGCTTAATGCTTTGATCGGCCTTGAGCACCATAAGGCAACCACCACAGAAGTATTTAAGTGGGATGGTAAAAAAAGGTTATTCCCAGAATGGGAAAAGGACATGACCCTAGGCGATGCCATGAAAGCTTCCGCTATTCCAGTTTATCAAGATTTAGCTCGTCGTATTGGACTTGAGCTCATGTCTAAGGAAGTGAAGCGTGTTGGTTATGGCAATGCAGATATCGGTACCCAAGTCGATAATTTTTGGCTGGTGGGTCCTTTAAAAATTACTCCTCAGCAAGAGGCACAGTTTGCTTACAAGCTAGCTAATAAAACGCTTCCATTTAGCCAAAAAGTCCAAGATGAAGTGCAATCCATGCTATTCATAGAAGAAAAGAATGGAAACAAAATATACGCAAAAAGTGGTTGGGGATGGGATGTAAACCCACAAGTAGGCTGGTTAACTGGATGGGTTGTTCAGCCTCAAGGGAATATTGTAGCGTTCTCCCTTAACTTAGAAATGAAAAAAGGAATACCTAG
321	gb|KF513178|+|0-861|ARO:3001357|SHV-173	ATGCGTTATATTCGCCTGTGTATTATCTCCCTGTTAGCCACCCTGCCGCTGGCG...TAA	861.0	16	822	806	861	ATGCGTTATATTCGCCTGTGTATTATCACCCTGTGAGCCACCCTGCCGCTGGCGGTACACGCCAGCCCGCAGCCGCTTGAGCAAATTAAACAAAGCGAAAGCCAGCTGTCGGGCCGCGTAGGCATGATAGAAATGGATCTGGCCAGCGGCCGCACGCTGACCGCCTGGCGCGCCGATGAACGCTTTCCCATGATGAGCACCTTTAAAGTAGTGCTCTGCGGCGCAGTGCTGGCGCGGGTGGATGCCGGTGACGAACAGCTGGAGCGAAAGATCCACTATCGCCAGCAGGATCTGGTGGACTACTCGCCGGTCAGCGAAAAACACCTTGCCGACGGCATGACGGTCGGCGAACTCTGCGCCGCCGCCATTACCATGAGCGATAACAGCGCCGCCAATCTGCTGCTGGCCACCGTCGGCGGCCCCGCAGGATTGACTGCCTTTTTGCGCCAGATCGGCGACAACGTCACCCGCCTTGACCGCTGGGAAACGGAACTGAATGAGGCGCTTCCCGGCGACGCCCGCGACACCACTACCCCGGCCAGCATGGCCGCGACCCTGCGCAAGCTGCTGACCAGCCAGCGTCTGAGCGCCCGTTCGCAACGGCAGCTGCTGCAGTGGATGGTGGACGATCGGGTCGCCGGACCGTTGATCCGCTCCGTGCTGCCGGCGGGCTGGTTTATCGCCGATAAGACCGGAGCTAGCAAGCGGGGTGCGCGCGGGATTGTCGCCCTGCTTGGCCCGAATAACAAAGCAGAGCGCATTGTGGTGATTTATCTGCGGGATACGCCGGCGAGCATGGCCGAGCG
322	gb|M55547|+|0-825|ARO:3001404|OXA-9	ATGAAAAAAATTTTGCTGCTGCATATGTTGGTGTTCGTTTCCGCCACTCTCCCA...TGA	825.0	39	809	770	825	ATGAAAAAAATTTTGCTGCTGCATATGTTGGTGTTCGTTTCCGCCACTCTCCCAATCAGTTCCGTGGCTTCTGATGAGGTTGAAACGCTTAAATGCACCATCATCGCAGACGCCATTACCGGAAATACCTTATATGAGACCGGAGAATGTGCCCGTCGTGTGTCTCCGTGCTCGTCTTTTAAACTTCCATTGGCAATCATGGGGTTTTATAGTGGAATCTTGCAGTCGCCAAAATCACCTACGTGGGAATTGAAGCCGGAATACAACCCGTCTCCGAGAGATCGCACATACAAACAAGTCTATCCGGCGCTATGGCAAAGCGACTCTGTTGTCTGGTTCTCGCAGCAATTAACAAGCCGTCTGGGAGTTGATCGGTTCACGGAATACGTAAAGAAATTTGAGTACGGTAATCAAGATGTTTCCGGTGACTCGGGGAAGCATAACGGCTTGACCCAGTCATGGCTGATGTCGTCGCTCACCATATCTCCCAAGGAGCAAATTCAGTTTCTTCTACGCTTTGTCGCGCATAAGCTGCCTGTATCCGAAGCGGCTTATGACATGGCGTATGCCACAATCCCGCAGTACCAGGCAGCCGAAGGATGGGCTGTACATGGAAAAAGCGGCAGCGGCTGGCTTCGGGACAATAACGGCAAGATAAATGAAAGTCGTCCGCAGGGCTGGTTCGTGGGCTGGGCTGAAAAAAACGGACGGCAAGTTGTTTTCGCCCGATTGGAAATAGGAAAGGAAAAGTCCGATATTCCCGGCGGGTC
323	gb|AF495873|+|0-861|ARO:3000964|TEM-101	ATGAGTATTCAACATTTCCGTGTCGCCCTTATTCCCTTTTTTGCGGCATTTTGC...TAA	861.0	46	852	806	861	ATGAGTATTCAACATTTCCGTGTCGCCCTTATTCCCTTTTTTGCGGCATTTTGCCTTCCTGTTTTTGCTCACCCAGAAACGCTGGTGAAAGTAAAAGATGCTGAAGATCAGTTGGGTGCACGAGTGGGTTACATCGAGCTGGATCTCAACAGCGGTAAGATCCTTGAGAGTTTTCGCCCCGAAGAACGTTTTCCAATGATGAGCACTTTTAAAGTTCTGCTATGTGGTGCGGTATTATCCCGTGTTGACGCCGGGCAAGAGCAACTCGGTCGCCGCATACACTATTCTCAGAATGACTTGGTTGAGTACTCACCAGTCACAGAAAAGCATCTTACGGATGGCATGACAGTAAGAGAATTATGCAGTGCTGCCATAACCATGAGTGATAACACTGCGGCCAACTTACTTCTGACAACGATCGGAGGACCGAAGGAGCTAACCGCTTTTTTGCACAACATGGGGGATCATGTAACCCGCCTTGATCGTTGGGAACCGGAGCTGAATGAAGCCATACCAAACGACGAGCGTGACACCACGATGCCTGCAGCAATGGCAACAACGTTGCGCAAACTATTAACTGGCGAACTACTTACTCTAGCTTCCCGGCAACAATTAATAGACTGGATGGAGGCGGATAAAGTTGCAGGACCACTTCTGCGCTCGGCCCTTCCGGCTGGCTGGTTTATTGCTGATAAATCTGGAGCCGGTGAGCGTGGATCTCGCGGTATCATTGCAGCACTGGGGCCAGATGGTAAGCCCTCCCGTATCGTAGTTATCTACACGACGGGGAGTCAGGCAACTATGGA
324	gb|HG931732.1|+|0-825|ARO:3001559|OXA-373	ATGAAAACTTTACAGTTGGCTCTCATCGCCCTCATTACAACCTTCGGTTCTGCA...TAA	825.0	156	929	773	825	ATGAAAACTTTACAGTTGGGCCTCATCGTCCTCATTACTACCTTCGGTTCTGCATGTACCATAATAAGAAGCCCCTCCATAGAAACAGCTAAAAACCATGAGCAACAAAGTGCGCAGCAGCAGATCCAACAGGCCTTCGATCAACTCCAAACCACGGGGGTGATTGTCATAAAGGATAAGCATGGCTTACACAGCTACGGCAATGACTTGAGCCGTGCTCAGACACCCTATGTACCCGCCTCTACCTTTAAAATGCTGAATGCCTTAATCGGACTAGAACATGGTAAAGCAACCAGCACCGAGGTGTTTAAATGGGATGGTCAAAAGAACAGCTTCCCTGCTTGGGAAAAAGACATGACTTTAGGGCAAGCCATGCAAGCATCTGCCGTTCCTGTTTATCAGGAGCTAGCACGGCGCATTGGCCTAGATCTAATGCAAAAAGAAGTACAGCGCATTGGATATGGCAATCAACAGATTGGCACCGTTGTCGATAATTTTTGGTTAGTCGGTCCACTGCAAATTACGCCTGTTCAAGAAGTCCTTTTTGTAGAGAAGCTGGCCAATACGCAACTCGCTTTTAAGCCAGATGTGCAACATACCGTACAAGACATGCTGCTGATTGAACAAAAACCGAATTATAAACTCTACGCCAAATCTGGTTGGGGCATGGACCTAGAACCGCAAGTGGGCTGGTGGACAGGCTGGGTCGAAACAGCAACAGGTGAAAAAGTGTATTTTGCTTTGAATATGCATATGAAAACAGGAATTTCAGC
325	gb|KR057750.1|+|0-1116|ARO:3004344|PDC-81	GGCGAGGCCCCGGCGGATCGCCTGAAGGCATTGGTCGACGCCGCCGTACAACCG...TGA	1116.0	35594	36652	1058	1116	GAGGCCCCGGCGGATCGCCTGAAGGCACTGGTCGACGCCGCCGTACAACCGGTGATGAAGGCCAATGACATTCCGGGCCTGGCCGTAGCCATCAGCCTGAAAGGAGAACCGCATTACTTCAGCTATGGGCTGGCCTCGAAAGAGGACGGCCGCCGGGTGACGCCGGAGACCCTGTTCGAGATCGGCTCGGTGAGCAAGACCTTCACCGTCACCCTCGCCGGCTATGCCCTGGCCCAGGACAAGATGCGCCTCGACGACCGCGCCAGCCAGCACTGGCCGGCACTGCAGGGCAGCCGCTTCGACGGCATCAGCCTGCTCGACCTCGCGACCTATACCGCCGGCGGCTTGCCGCTGCAGTTCCCCGACTCGGTGCAGAAGGACCAGGCACAGATCCGCGACTACTACCGCCAGTGGCAGCCGACCTACGCGCCGGGCAGCCAGCGCCTCTATTCCAACCCGAGCATCGGCCTGTTCGGCTATCTCGCCGCGCGCAGCCTGGGCCAGCCGTTCGAACGGCTCATGGAGCAGCAATTGTTCCCGGCACTGGGCCTCGAACAGACCCACCTCGACGTGCCCGAGGCGGCGCTGGCGCAGTACGCCCAGGGCTACGGCAAGGACGACCGCCCGCTACGGGTCGGTCCCGGCCCGCTGGATGCCGAAGGCTACGGGGTGAAGACCAGCGCGGCCGACCTGCTGCGCTTCGTCGATGCCAACCTGCATCCGGAGCGCCTGGACAGGCCCTGGGCGCAGGCGCTCGATGCCACCCATCGCGGTTACTACAAGGTCGGCGACATGACCCAGGGCCTGGGCTGGGAAGCCTACGACTGGCCGATCTCCCTGAAGCGCCTGCAGGCCGGCAACTCGACGCCGATGGCGCTGCAACCACACAGGATCGCCAGGCTGCCCGCGCCACAGGCGCTGGAGGGCCAGCGCCTGCTGAACAAGACCGGCTCCACCAACGGCTTCGGCGCCTACGTGGCGTTCGTCCCGGGCCGCGACCTGGGCCTGGTGATCCTGGCCAACCGCAACTATCCCAATGCCGAGCGGGTGAAGATCGC
326	gb|FR853176|+|0-825|ARO:3001486|OXA-208	ATGAACATTAAAGCACTCTTACTTATAACAAGCGCTATTTTTATTTCAGCCTGC...TAG	825.0	54149	54919	770	825	ATGAACATTAAAGCACTCTTACTTATAACAAGCGCTATTTTTATTTCAGCCTGCTCACCTTATATAGTGACTGCTAATCCAAATCACAGCGCTTCAAAATCTGATGTAAAAGCAGAGAAAATTAAAAATTTATTTAACGAAGCACACACTACGGGTGTTTTAGTTATCCAACAAGGCCAAACTCAACAAAGCTATGGTAATGATCTTGCTCGTGCTTCGACCGAGTATGTACCTGCTTCGACCTTCAAAATGCTTAATGCTTTGATCGGCCTTGAGCACCATAAGGCAACCACCACAGAAGTATTTAAGTGGGATGGTAAAAAAAGGTTATTCCCAGAATGGGAAAAGGACATGACCCTAGGCGATGCCATGAAAGCTTCCGCTATTCCAGTTTATCAAGATTTAGCTCGTCGTATTGGACTTGAGCTCATGTCTAAGGAAGTGAAGCGTGTTGGTTATGGCAATGCAGATATCGGTACCCAAGTCGATAATTTTTGGCTGGTGGGTCCTTTAAAAATTACTCCTCAGCAAGAGGCACAGTTTGCTTACAAGCTAGCTAATAAAACGCTTCCATTTAGCCAAAAAGTCCAAGATGAAGTGCAATCCATGCTATTCATAGAAGAAAAGAATGGAAACAAAATATACGCAAAAAGTGGTTGGGGATGGGATGTAAACCCACAAGTAGGCTGGTTAACTGGATGGGTTGTTCAGCCTCAAGGGAATATTGTAGCGTTCTCCCTTAACTTAGAAATGAAAAAAGGAATACCTAG
327	gb|AM231719|+|0-825|ARO:3001650|OXA-90	ATGAACATTAAAGCCCTCTTACTTATAACAAGCGCTATTTTTATTTCAGCCTGC...TAG	825.0	54149	54919	770	825	ATGAACATTAAAGCACTCTTACTTATAACAAGCGCTATTTTTATTTCAGCCTGCTCACCTTATATAGTGACTGCTAATCCAAATCACAGCGCTTCAAAATCTGATGTAAAAGCAGAGAAAATTAAAAATTTATTTAACGAAGCACACACTACGGGTGTTTTAGTTATCCAACAAGGCCAAACTCAACAAAGCTATGGTAATGATCTTGCTCGTGCTTCGACCGAGTATGTACCTGCTTCGACCTTCAAAATGCTTAATGCTTTGATCGGCCTTGAGCACCATAAGGCAACCACCACAGAAGTATTTAAGTGGGATGGTAAAAAAAGGTTATTCCCAGAATGGGAAAAGGACATGACCCTAGGCGATGCCATGAAAGCTTCCGCTATTCCAGTTTATCAAGATTTAGCTCGTCGTATTGGACTTGAGCTCATGTCTAAGGAAGTGAAGCGTGTTGGTTATGGCAATGCAGATATCGGTACCCAAGTCGATAATTTTTGGCTGGTGGGTCCTTTAAAAATTACTCCTCAGCAAGAGGCACAGTTTGCTTACAAGCTAGCTAATAAAACGCTTCCATTTAGCCAAAAAGTCCAAGATGAAGTGCAATCCATGCTATTCATAGAAGAAAAGAATGGAAACAAAATATACGCAAAAAGTGGTTGGGGATGGGATGTAAACCCACAAGTAGGCTGGTTAACTGGATGGGTTGTTCAGCCTCAAGGGAATATTGTAGCGTTCTCCCTTAACTTAGAAATGAAAAAAGGAATACCTAG
328	gb|KF986255|+|16-841|ARO:3001560|OXA-374	ATGAACATTAAAGCCCTCTTACTTATAACAAGCGCTATTTTTATTTCAGCCTGC...TAG	825.0	54149	54919	770	825	ATGAACATTAAAGCACTCTTACTTATAACAAGCGCTATTTTTATTTCAGCCTGCTCACCTTATATAGTGACTGCTAATCCAAATCACAGCGCTTCAAAATCTGATGTAAAAGCAGAGAAAATTAAAAATTTATTTAACGAAGCACACACTACGGGTGTTTTAGTTATCCAACAAGGCCAAACTCAACAAAGCTATGGTAATGATCTTGCTCGTGCTTCGACCGAGTATGTACCTGCTTCGACCTTCAAAATGCTTAATGCTTTGATCGGCCTTGAGCACCATAAGGCAACCACCACAGAAGTATTTAAGTGGGATGGTAAAAAAAGGTTATTCCCAGAATGGGAAAAGGACATGACCCTAGGCGATGCCATGAAAGCTTCCGCTATTCCAGTTTATCAAGATTTAGCTCGTCGTATTGGACTTGAGCTCATGTCTAAGGAAGTGAAGCGTGTTGGTTATGGCAATGCAGATATCGGTACCCAAGTCGATAATTTTTGGCTGGTGGGTCCTTTAAAAATTACTCCTCAGCAAGAGGCACAGTTTGCTTACAAGCTAGCTAATAAAACGCTTCCATTTAGCCAAAAAGTCCAAGATGAAGTGCAATCCATGCTATTCATAGAAGAAAAGAATGGAAACAAAATATACGCAAAAAGTGGTTGGGGATGGGATGTAAACCCACAAGTAGGCTGGTTAACTGGATGGGTTGTTCAGCCTCAAGGGAATATTGTAGCGTTCTCCCTTAACTTAGAAATGAAAAAAGGAATACCTAG
329	gb|HQ845196|+|0-861|ARO:3001109|SHV-52	ATGCGTTATATTCGCCTGTGTATTATCTCCCTGTTAGCCGCCCTGCCGCTGGCG...TAA	861.0	16	822	806	861	ATGCGTTATATTCGCCTGTGTATTATCACCCTGTGAGCCACCCTGCCGCTGGCGGTACACGCCAGCCCGCAGCCGCTTGAGCAAATTAAACAAAGCGAAAGCCAGCTGTCGGGCCGCGTAGGCATGATAGAAATGGATCTGGCCAGCGGCCGCACGCTGACCGCCTGGCGCGCCGATGAACGCTTTCCCATGATGAGCACCTTTAAAGTAGTGCTCTGCGGCGCAGTGCTGGCGCGGGTGGATGCCGGTGACGAACAGCTGGAGCGAAAGATCCACTATCGCCAGCAGGATCTGGTGGACTACTCGCCGGTCAGCGAAAAACACCTTGCCGACGGCATGACGGTCGGCGAACTCTGCGCCGCCGCCATTACCATGAGCGATAACAGCGCCGCCAATCTGCTGCTGGCCACCGTCGGCGGCCCCGCAGGATTGACTGCCTTTTTGCGCCAGATCGGCGACAACGTCACCCGCCTTGACCGCTGGGAAACGGAACTGAATGAGGCGCTTCCCGGCGACGCCCGCGACACCACTACCCCGGCCAGCATGGCCGCGACCCTGCGCAAGCTGCTGACCAGCCAGCGTCTGAGCGCCCGTTCGCAACGGCAGCTGCTGCAGTGGATGGTGGACGATCGGGTCGCCGGACCGTTGATCCGCTCCGTGCTGCCGGCGGGCTGGTTTATCGCCGATAAGACCGGAGCTAGCAAGCGGGGTGCGCGCGGGATTGTCGCCCTGCTTGGCCCGAATAACAAAGCAGAGCGCATTGTGGTGATTTATCTGCGGGATACGCCGGCGAGCATGGCCGAGCG
330	gb|KF986256.1|-|40-865|ARO:3001561|OXA-375	ATGAACATTAAAGCACTCTTACTTATAACAAGCGCTATTTTTATTTCAGCCTGC...TAG	825.0	54149	54919	770	825	ATGAACATTAAAGCACTCTTACTTATAACAAGCGCTATTTTTATTTCAGCCTGCTCACCTTATATAGTGACTGCTAATCCAAATCACAGCGCTTCAAAATCTGATGTAAAAGCAGAGAAAATTAAAAATTTATTTAACGAAGCACACACTACGGGTGTTTTAGTTATCCAACAAGGCCAAACTCAACAAAGCTATGGTAATGATCTTGCTCGTGCTTCGACCGAGTATGTACCTGCTTCGACCTTCAAAATGCTTAATGCTTTGATCGGCCTTGAGCACCATAAGGCAACCACCACAGAAGTATTTAAGTGGGATGGTAAAAAAAGGTTATTCCCAGAATGGGAAAAGGACATGACCCTAGGCGATGCCATGAAAGCTTCCGCTATTCCAGTTTATCAAGATTTAGCTCGTCGTATTGGACTTGAGCTCATGTCTAAGGAAGTGAAGCGTGTTGGTTATGGCAATGCAGATATCGGTACCCAAGTCGATAATTTTTGGCTGGTGGGTCCTTTAAAAATTACTCCTCAGCAAGAGGCACAGTTTGCTTACAAGCTAGCTAATAAAACGCTTCCATTTAGCCAAAAAGTCCAAGATGAAGTGCAATCCATGCTATTCATAGAAGAAAAGAATGGAAACAAAATATACGCAAAAAGTGGTTGGGGATGGGATGTAAACCCACAAGTAGGCTGGTTAACTGGATGGGTTGTTCAGCCTCAAGGGAATATTGTAGCGTTCTCCCTTAACTTAGAAATGAAAAAAGGAATACCTAG
331	gb|DQ519086|+|1198-2023|ARO:3001627|OXA-91	ATGAACATTAAAGCACTCTTACTTATAACAAGCGCTATTTTTATTTCAGCCTGC...TAG	825.0	54149	54919	770	825	ATGAACATTAAAGCACTCTTACTTATAACAAGCGCTATTTTTATTTCAGCCTGCTCACCTTATATAGTGACTGCTAATCCAAATCACAGCGCTTCAAAATCTGATGTAAAAGCAGAGAAAATTAAAAATTTATTTAACGAAGCACACACTACGGGTGTTTTAGTTATCCAACAAGGCCAAACTCAACAAAGCTATGGTAATGATCTTGCTCGTGCTTCGACCGAGTATGTACCTGCTTCGACCTTCAAAATGCTTAATGCTTTGATCGGCCTTGAGCACCATAAGGCAACCACCACAGAAGTATTTAAGTGGGATGGTAAAAAAAGGTTATTCCCAGAATGGGAAAAGGACATGACCCTAGGCGATGCCATGAAAGCTTCCGCTATTCCAGTTTATCAAGATTTAGCTCGTCGTATTGGACTTGAGCTCATGTCTAAGGAAGTGAAGCGTGTTGGTTATGGCAATGCAGATATCGGTACCCAAGTCGATAATTTTTGGCTGGTGGGTCCTTTAAAAATTACTCCTCAGCAAGAGGCACAGTTTGCTTACAAGCTAGCTAATAAAACGCTTCCATTTAGCCAAAAAGTCCAAGATGAAGTGCAATCCATGCTATTCATAGAAGAAAAGAATGGAAACAAAATATACGCAAAAAGTGGTTGGGGATGGGATGTAAACCCACAAGTAGGCTGGTTAACTGGATGGGTTGTTCAGCCTCAAGGGAATATTGTAGCGTTCTCCCTTAACTTAGAAATGAAAAAAGGAATACCTAG
332	gb|KF705209|+|0-861|ARO:3001361|SHV-178	ATGCGTTATATTCGCCTGTGTATTATCTCCCTGTTAGCCACCCTGCCGCTGGCG...TAA	861.0	16	822	806	861	ATGCGTTATATTCGCCTGTGTATTATCACCCTGTGAGCCACCCTGCCGCTGGCGGTACACGCCAGCCCGCAGCCGCTTGAGCAAATTAAACAAAGCGAAAGCCAGCTGTCGGGCCGCGTAGGCATGATAGAAATGGATCTGGCCAGCGGCCGCACGCTGACCGCCTGGCGCGCCGATGAACGCTTTCCCATGATGAGCACCTTTAAAGTAGTGCTCTGCGGCGCAGTGCTGGCGCGGGTGGATGCCGGTGACGAACAGCTGGAGCGAAAGATCCACTATCGCCAGCAGGATCTGGTGGACTACTCGCCGGTCAGCGAAAAACACCTTGCCGACGGCATGACGGTCGGCGAACTCTGCGCCGCCGCCATTACCATGAGCGATAACAGCGCCGCCAATCTGCTGCTGGCCACCGTCGGCGGCCCCGCAGGATTGACTGCCTTTTTGCGCCAGATCGGCGACAACGTCACCCGCCTTGACCGCTGGGAAACGGAACTGAATGAGGCGCTTCCCGGCGACGCCCGCGACACCACTACCCCGGCCAGCATGGCCGCGACCCTGCGCAAGCTGCTGACCAGCCAGCGTCTGAGCGCCCGTTCGCAACGGCAGCTGCTGCAGTGGATGGTGGACGATCGGGTCGCCGGACCGTTGATCCGCTCCGTGCTGCCGGCGGGCTGGTTTATCGCCGATAAGACCGGAGCTAGCAAGCGGGGTGCGCGCGGGATTGTCGCCCTGCTTGGCCCGAATAACAAAGCAGAGCGCATTGTGGTGATTTATCTGCGGGATACGCCGGCGAGCATGGCCGAGCG
333	gb|AY040093|+|68-929|ARO:3000965|TEM-102	ATGAGTATTCAACATTTTCGTGTCGCCCTTATTCCCTTTTTTGCGGCATTTTGC...TAA	861.0	46	852	806	861	ATGAGTATTCAACATTTCCGTGTCGCCCTTATTCCCTTTTTTGCGGCATTTTGCCTTCCTGTTTTTGCTCACCCAGAAACGCTGGTGAAAGTAAAAGATGCTGAAGATCAGTTGGGTGCACGAGTGGGTTACATCGAGCTGGATCTCAACAGCGGTAAGATCCTTGAGAGTTTTCGCCCCGAAGAACGTTTTCCAATGATGAGCACTTTTAAAGTTCTGCTATGTGGTGCGGTATTATCCCGTGTTGACGCCGGGCAAGAGCAACTCGGTCGCCGCATACACTATTCTCAGAATGACTTGGTTGAGTACTCACCAGTCACAGAAAAGCATCTTACGGATGGCATGACAGTAAGAGAATTATGCAGTGCTGCCATAACCATGAGTGATAACACTGCGGCCAACTTACTTCTGACAACGATCGGAGGACCGAAGGAGCTAACCGCTTTTTTGCACAACATGGGGGATCATGTAACCCGCCTTGATCGTTGGGAACCGGAGCTGAATGAAGCCATACCAAACGACGAGCGTGACACCACGATGCCTGCAGCAATGGCAACAACGTTGCGCAAACTATTAACTGGCGAACTACTTACTCTAGCTTCCCGGCAACAATTAATAGACTGGATGGAGGCGGATAAAGTTGCAGGACCACTTCTGCGCTCGGCCCTTCCGGCTGGCTGGTTTATTGCTGATAAATCTGGAGCCGGTGAGCGTGGATCTCGCGGTATCATTGCAGCACTGGGGCCAGATGGTAAGCCCTCCCGTATCGTAGTTATCTACACGACGGGGAGTCAGGCAACTATGGA
334	gb|JN861779|+|0-825|ARO:3001710|OXA-211	ATGAAAACTTTACAGTTGGCTCTCATCGCCCTCATTACAACCTTCGGTTCCGCA...TAA	825.0	156	929	773	825	ATGAAAACTTTACAGTTGGGCCTCATCGTCCTCATTACTACCTTCGGTTCTGCATGTACCATAATAAGAAGCCCCTCCATAGAAACAGCTAAAAACCATGAGCAACAAAGTGCGCAGCAGCAGATCCAACAGGCCTTCGATCAACTCCAAACCACGGGGGTGATTGTCATAAAGGATAAGCATGGCTTACACAGCTACGGCAATGACTTGAGCCGTGCTCAGACACCCTATGTACCCGCCTCTACCTTTAAAATGCTGAATGCCTTAATCGGACTAGAACATGGTAAAGCAACCAGCACCGAGGTGTTTAAATGGGATGGTCAAAAGAACAGCTTCCCTGCTTGGGAAAAAGACATGACTTTAGGGCAAGCCATGCAAGCATCTGCCGTTCCTGTTTATCAGGAGCTAGCACGGCGCATTGGCCTAGATCTAATGCAAAAAGAAGTACAGCGCATTGGATATGGCAATCAACAGATTGGCACCGTTGTCGATAATTTTTGGTTAGTCGGTCCACTGCAAATTACGCCTGTTCAAGAAGTCCTTTTTGTAGAGAAGCTGGCCAATACGCAACTCGCTTTTAAGCCAGATGTGCAACATACCGTACAAGACATGCTGCTGATTGAACAAAAACCGAATTATAAACTCTACGCCAAATCTGGTTGGGGCATGGACCTAGAACCGCAAGTGGGCTGGTGGACAGGCTGGGTCGAAACAGCAACAGGTGAAAAAGTGTATTTTGCTTTGAATATGCATATGAAAACAGGAATTTCAGC
335	gb|KR057751.1|+|0-1116|ARO:3004345|PDC-82	GGCGAGGCCCCGGCGGATCGCCTGAAGGCATTGGTCGACGCCGCCGTACAACCG...TGA	1116.0	35594	36652	1058	1116	GAGGCCCCGGCGGATCGCCTGAAGGCACTGGTCGACGCCGCCGTACAACCGGTGATGAAGGCCAATGACATTCCGGGCCTGGCCGTAGCCATCAGCCTGAAAGGAGAACCGCATTACTTCAGCTATGGGCTGGCCTCGAAAGAGGACGGCCGCCGGGTGACGCCGGAGACCCTGTTCGAGATCGGCTCGGTGAGCAAGACCTTCACCGTCACCCTCGCCGGCTATGCCCTGGCCCAGGACAAGATGCGCCTCGACGACCGCGCCAGCCAGCACTGGCCGGCACTGCAGGGCAGCCGCTTCGACGGCATCAGCCTGCTCGACCTCGCGACCTATACCGCCGGCGGCTTGCCGCTGCAGTTCCCCGACTCGGTGCAGAAGGACCAGGCACAGATCCGCGACTACTACCGCCAGTGGCAGCCGACCTACGCGCCGGGCAGCCAGCGCCTCTATTCCAACCCGAGCATCGGCCTGTTCGGCTATCTCGCCGCGCGCAGCCTGGGCCAGCCGTTCGAACGGCTCATGGAGCAGCAATTGTTCCCGGCACTGGGCCTCGAACAGACCCACCTCGACGTGCCCGAGGCGGCGCTGGCGCAGTACGCCCAGGGCTACGGCAAGGACGACCGCCCGCTACGGGTCGGTCCCGGCCCGCTGGATGCCGAAGGCTACGGGGTGAAGACCAGCGCGGCCGACCTGCTGCGCTTCGTCGATGCCAACCTGCATCCGGAGCGCCTGGACAGGCCCTGGGCGCAGGCGCTCGATGCCACCCATCGCGGTTACTACAAGGTCGGCGACATGACCCAGGGCCTGGGCTGGGAAGCCTACGACTGGCCGATCTCCCTGAAGCGCCTGCAGGCCGGCAACTCGACGCCGATGGCGCTGCAACCACACAGGATCGCCAGGCTGCCCGCGCCACAGGCGCTGGAGGGCCAGCGCCTGCTGAACAAGACCGGCTCCACCAACGGCTTCGGCGCCTACGTGGCGTTCGTCCCGGGCCGCGACCTGGGCCTGGTGATCCTGGCCAACCGCAACTATCCCAATGCCGAGCGGGTGAAGATCGC
336	gb|KF986257|+|20-845|ARO:3001562|OXA-376	ATGAACATTAAAACACTCTTACTTATAACAAGCGCTATTTTTATTTCAGCCTGC...TAG	825.0	54149	54919	770	825	ATGAACATTAAAGCACTCTTACTTATAACAAGCGCTATTTTTATTTCAGCCTGCTCACCTTATATAGTGACTGCTAATCCAAATCACAGCGCTTCAAAATCTGATGTAAAAGCAGAGAAAATTAAAAATTTATTTAACGAAGCACACACTACGGGTGTTTTAGTTATCCAACAAGGCCAAACTCAACAAAGCTATGGTAATGATCTTGCTCGTGCTTCGACCGAGTATGTACCTGCTTCGACCTTCAAAATGCTTAATGCTTTGATCGGCCTTGAGCACCATAAGGCAACCACCACAGAAGTATTTAAGTGGGATGGTAAAAAAAGGTTATTCCCAGAATGGGAAAAGGACATGACCCTAGGCGATGCCATGAAAGCTTCCGCTATTCCAGTTTATCAAGATTTAGCTCGTCGTATTGGACTTGAGCTCATGTCTAAGGAAGTGAAGCGTGTTGGTTATGGCAATGCAGATATCGGTACCCAAGTCGATAATTTTTGGCTGGTGGGTCCTTTAAAAATTACTCCTCAGCAAGAGGCACAGTTTGCTTACAAGCTAGCTAATAAAACGCTTCCATTTAGCCAAAAAGTCCAAGATGAAGTGCAATCCATGCTATTCATAGAAGAAAAGAATGGAAACAAAATATACGCAAAAAGTGGTTGGGGATGGGATGTAAACCCACAAGTAGGCTGGTTAACTGGATGGGTTGTTCAGCCTCAAGGGAATATTGTAGCGTTCTCCCTTAACTTAGAAATGAAAAAAGGAATACCTAG
337	gb|DQ335566|+|0-825|ARO:3001632|OXA-92	ATGAACATTAAAGCACTCTTACTTATAACAAGCGCTATTTTTATTTCAGCCTGC...TAG	825.0	54149	54919	770	825	ATGAACATTAAAGCACTCTTACTTATAACAAGCGCTATTTTTATTTCAGCCTGCTCACCTTATATAGTGACTGCTAATCCAAATCACAGCGCTTCAAAATCTGATGTAAAAGCAGAGAAAATTAAAAATTTATTTAACGAAGCACACACTACGGGTGTTTTAGTTATCCAACAAGGCCAAACTCAACAAAGCTATGGTAATGATCTTGCTCGTGCTTCGACCGAGTATGTACCTGCTTCGACCTTCAAAATGCTTAATGCTTTGATCGGCCTTGAGCACCATAAGGCAACCACCACAGAAGTATTTAAGTGGGATGGTAAAAAAAGGTTATTCCCAGAATGGGAAAAGGACATGACCCTAGGCGATGCCATGAAAGCTTCCGCTATTCCAGTTTATCAAGATTTAGCTCGTCGTATTGGACTTGAGCTCATGTCTAAGGAAGTGAAGCGTGTTGGTTATGGCAATGCAGATATCGGTACCCAAGTCGATAATTTTTGGCTGGTGGGTCCTTTAAAAATTACTCCTCAGCAAGAGGCACAGTTTGCTTACAAGCTAGCTAATAAAACGCTTCCATTTAGCCAAAAAGTCCAAGATGAAGTGCAATCCATGCTATTCATAGAAGAAAAGAATGGAAACAAAATATACGCAAAAAGTGGTTGGGGATGGGATGTAAACCCACAAGTAGGCTGGTTAACTGGATGGGTTGTTCAGCCTCAAGGGAATATTGTAGCGTTCTCCCTTAACTTAGAAATGAAAAAAGGAATACCTAG
338	gb|KF705208|+|0-861|ARO:3001362|SHV-179	ATGCGTTATATTCGCCTGTGTATTATCTCCCTGTTAGCCACCCTGCCGCTGGCG...TAA	861.0	16	822	806	861	ATGCGTTATATTCGCCTGTGTATTATCACCCTGTGAGCCACCCTGCCGCTGGCGGTACACGCCAGCCCGCAGCCGCTTGAGCAAATTAAACAAAGCGAAAGCCAGCTGTCGGGCCGCGTAGGCATGATAGAAATGGATCTGGCCAGCGGCCGCACGCTGACCGCCTGGCGCGCCGATGAACGCTTTCCCATGATGAGCACCTTTAAAGTAGTGCTCTGCGGCGCAGTGCTGGCGCGGGTGGATGCCGGTGACGAACAGCTGGAGCGAAAGATCCACTATCGCCAGCAGGATCTGGTGGACTACTCGCCGGTCAGCGAAAAACACCTTGCCGACGGCATGACGGTCGGCGAACTCTGCGCCGCCGCCATTACCATGAGCGATAACAGCGCCGCCAATCTGCTGCTGGCCACCGTCGGCGGCCCCGCAGGATTGACTGCCTTTTTGCGCCAGATCGGCGACAACGTCACCCGCCTTGACCGCTGGGAAACGGAACTGAATGAGGCGCTTCCCGGCGACGCCCGCGACACCACTACCCCGGCCAGCATGGCCGCGACCCTGCGCAAGCTGCTGACCAGCCAGCGTCTGAGCGCCCGTTCGCAACGGCAGCTGCTGCAGTGGATGGTGGACGATCGGGTCGCCGGACCGTTGATCCGCTCCGTGCTGCCGGCGGGCTGGTTTATCGCCGATAAGACCGGAGCTAGCAAGCGGGGTGCGCGCGGGATTGTCGCCCTGCTTGGCCCGAATAACAAAGCAGAGCGCATTGTGGTGATTTATCTGCGGGATACGCCGGCGAGCATGGCCGAGCG
339	gb|AF516719|+|214-1075|ARO:3000967|TEM-104	ATGAGTATTCAACATTTTCGTGTCGCCCTTATTCCCTTTTTTGCGGCATTTTGC...TAA	861.0	46	852	806	861	ATGAGTATTCAACATTTCCGTGTCGCCCTTATTCCCTTTTTTGCGGCATTTTGCCTTCCTGTTTTTGCTCACCCAGAAACGCTGGTGAAAGTAAAAGATGCTGAAGATCAGTTGGGTGCACGAGTGGGTTACATCGAGCTGGATCTCAACAGCGGTAAGATCCTTGAGAGTTTTCGCCCCGAAGAACGTTTTCCAATGATGAGCACTTTTAAAGTTCTGCTATGTGGTGCGGTATTATCCCGTGTTGACGCCGGGCAAGAGCAACTCGGTCGCCGCATACACTATTCTCAGAATGACTTGGTTGAGTACTCACCAGTCACAGAAAAGCATCTTACGGATGGCATGACAGTAAGAGAATTATGCAGTGCTGCCATAACCATGAGTGATAACACTGCGGCCAACTTACTTCTGACAACGATCGGAGGACCGAAGGAGCTAACCGCTTTTTTGCACAACATGGGGGATCATGTAACCCGCCTTGATCGTTGGGAACCGGAGCTGAATGAAGCCATACCAAACGACGAGCGTGACACCACGATGCCTGCAGCAATGGCAACAACGTTGCGCAAACTATTAACTGGCGAACTACTTACTCTAGCTTCCCGGCAACAATTAATAGACTGGATGGAGGCGGATAAAGTTGCAGGACCACTTCTGCGCTCGGCCCTTCCGGCTGGCTGGTTTATTGCTGATAAATCTGGAGCCGGTGAGCGTGGATCTCGCGGTATCATTGCAGCACTGGGGCCAGATGGTAAGCCCTCCCGTATCGTAGTTATCTACACGACGGGGAGTCAGGCAACTATGGA
340	gb|KF986258|+|14-839|ARO:3001563|OXA-377	ATGAACATTAAAACACTCTTACTTATAACAAGCGCTATTTTTATTTCAGCCTGC...TAG	825.0	54149	54919	770	825	ATGAACATTAAAGCACTCTTACTTATAACAAGCGCTATTTTTATTTCAGCCTGCTCACCTTATATAGTGACTGCTAATCCAAATCACAGCGCTTCAAAATCTGATGTAAAAGCAGAGAAAATTAAAAATTTATTTAACGAAGCACACACTACGGGTGTTTTAGTTATCCAACAAGGCCAAACTCAACAAAGCTATGGTAATGATCTTGCTCGTGCTTCGACCGAGTATGTACCTGCTTCGACCTTCAAAATGCTTAATGCTTTGATCGGCCTTGAGCACCATAAGGCAACCACCACAGAAGTATTTAAGTGGGATGGTAAAAAAAGGTTATTCCCAGAATGGGAAAAGGACATGACCCTAGGCGATGCCATGAAAGCTTCCGCTATTCCAGTTTATCAAGATTTAGCTCGTCGTATTGGACTTGAGCTCATGTCTAAGGAAGTGAAGCGTGTTGGTTATGGCAATGCAGATATCGGTACCCAAGTCGATAATTTTTGGCTGGTGGGTCCTTTAAAAATTACTCCTCAGCAAGAGGCACAGTTTGCTTACAAGCTAGCTAATAAAACGCTTCCATTTAGCCAAAAAGTCCAAGATGAAGTGCAATCCATGCTATTCATAGAAGAAAAGAATGGAAACAAAATATACGCAAAAAGTGGTTGGGGATGGGATGTAAACCCACAAGTAGGCTGGTTAACTGGATGGGTTGTTCAGCCTCAAGGGAATATTGTAGCGTTCTCCCTTAACTTAGAAATGAAAAAAGGAATACCTAG
341	gb|DQ519087|+|38-863|ARO:3001628|OXA-93	ATGAACATTAAAGCCCTCTTACTTATAACAAGCACTATTTTTATTTCAGCCTGC...TAG	825.0	54149	54919	770	825	ATGAACATTAAAGCACTCTTACTTATAACAAGCGCTATTTTTATTTCAGCCTGCTCACCTTATATAGTGACTGCTAATCCAAATCACAGCGCTTCAAAATCTGATGTAAAAGCAGAGAAAATTAAAAATTTATTTAACGAAGCACACACTACGGGTGTTTTAGTTATCCAACAAGGCCAAACTCAACAAAGCTATGGTAATGATCTTGCTCGTGCTTCGACCGAGTATGTACCTGCTTCGACCTTCAAAATGCTTAATGCTTTGATCGGCCTTGAGCACCATAAGGCAACCACCACAGAAGTATTTAAGTGGGATGGTAAAAAAAGGTTATTCCCAGAATGGGAAAAGGACATGACCCTAGGCGATGCCATGAAAGCTTCCGCTATTCCAGTTTATCAAGATTTAGCTCGTCGTATTGGACTTGAGCTCATGTCTAAGGAAGTGAAGCGTGTTGGTTATGGCAATGCAGATATCGGTACCCAAGTCGATAATTTTTGGCTGGTGGGTCCTTTAAAAATTACTCCTCAGCAAGAGGCACAGTTTGCTTACAAGCTAGCTAATAAAACGCTTCCATTTAGCCAAAAAGTCCAAGATGAAGTGCAATCCATGCTATTCATAGAAGAAAAGAATGGAAACAAAATATACGCAAAAAGTGGTTGGGGATGGGATGTAAACCCACAAGTAGGCTGGTTAACTGGATGGGTTGTTCAGCCTCAAGGGAATATTGTAGCGTTCTCCCTTAACTTAGAAATGAAAAAAGGAATACCTAG
342	gb|AF516720|+|214-1075|ARO:3000968|TEM-105	ATGAGTATTCAACATTTTCGTGTCGCCCTTATTCCCTTTTTTGCGGCATTTTGC...TAA	861.0	46	852	806	861	ATGAGTATTCAACATTTCCGTGTCGCCCTTATTCCCTTTTTTGCGGCATTTTGCCTTCCTGTTTTTGCTCACCCAGAAACGCTGGTGAAAGTAAAAGATGCTGAAGATCAGTTGGGTGCACGAGTGGGTTACATCGAGCTGGATCTCAACAGCGGTAAGATCCTTGAGAGTTTTCGCCCCGAAGAACGTTTTCCAATGATGAGCACTTTTAAAGTTCTGCTATGTGGTGCGGTATTATCCCGTGTTGACGCCGGGCAAGAGCAACTCGGTCGCCGCATACACTATTCTCAGAATGACTTGGTTGAGTACTCACCAGTCACAGAAAAGCATCTTACGGATGGCATGACAGTAAGAGAATTATGCAGTGCTGCCATAACCATGAGTGATAACACTGCGGCCAACTTACTTCTGACAACGATCGGAGGACCGAAGGAGCTAACCGCTTTTTTGCACAACATGGGGGATCATGTAACCCGCCTTGATCGTTGGGAACCGGAGCTGAATGAAGCCATACCAAACGACGAGCGTGACACCACGATGCCTGCAGCAATGGCAACAACGTTGCGCAAACTATTAACTGGCGAACTACTTACTCTAGCTTCCCGGCAACAATTAATAGACTGGATGGAGGCGGATAAAGTTGCAGGACCACTTCTGCGCTCGGCCCTTCCGGCTGGCTGGTTTATTGCTGATAAATCTGGAGCCGGTGAGCGTGGATCTCGCGGTATCATTGCAGCACTGGGGCCAGATGGTAAGCCCTCCCGTATCGTAGTTATCTACACGACGGGGAGTCAGGCAACTATGGA
343	gb|DQ519088|+|8-833|ARO:3001629|OXA-94	ATGAACATTCAAGCACTCTTACTTATAACAAGCGCTATTTTTATTTCAGCCTGC...TAG	825.0	54149	54919	770	825	ATGAACATTAAAGCACTCTTACTTATAACAAGCGCTATTTTTATTTCAGCCTGCTCACCTTATATAGTGACTGCTAATCCAAATCACAGCGCTTCAAAATCTGATGTAAAAGCAGAGAAAATTAAAAATTTATTTAACGAAGCACACACTACGGGTGTTTTAGTTATCCAACAAGGCCAAACTCAACAAAGCTATGGTAATGATCTTGCTCGTGCTTCGACCGAGTATGTACCTGCTTCGACCTTCAAAATGCTTAATGCTTTGATCGGCCTTGAGCACCATAAGGCAACCACCACAGAAGTATTTAAGTGGGATGGTAAAAAAAGGTTATTCCCAGAATGGGAAAAGGACATGACCCTAGGCGATGCCATGAAAGCTTCCGCTATTCCAGTTTATCAAGATTTAGCTCGTCGTATTGGACTTGAGCTCATGTCTAAGGAAGTGAAGCGTGTTGGTTATGGCAATGCAGATATCGGTACCCAAGTCGATAATTTTTGGCTGGTGGGTCCTTTAAAAATTACTCCTCAGCAAGAGGCACAGTTTGCTTACAAGCTAGCTAATAAAACGCTTCCATTTAGCCAAAAAGTCCAAGATGAAGTGCAATCCATGCTATTCATAGAAGAAAAGAATGGAAACAAAATATACGCAAAAAGTGGTTGGGGATGGGATGTAAACCCACAAGTAGGCTGGTTAACTGGATGGGTTGTTCAGCCTCAAGGGAATATTGTAGCGTTCTCCCTTAACTTAGAAATGAAAAAAGGAATACCTAG
344	gb|AF132290|+|87-948|ARO:3001076|SHV-18	ATGCGTTATTTTCGCCTGTGTATTATCTCCCTGTTAGCCACCCTGCCGCTGGCG...TAA	861.0	16	822	806	861	ATGCGTTATATTCGCCTGTGTATTATCACCCTGTGAGCCACCCTGCCGCTGGCGGTACACGCCAGCCCGCAGCCGCTTGAGCAAATTAAACAAAGCGAAAGCCAGCTGTCGGGCCGCGTAGGCATGATAGAAATGGATCTGGCCAGCGGCCGCACGCTGACCGCCTGGCGCGCCGATGAACGCTTTCCCATGATGAGCACCTTTAAAGTAGTGCTCTGCGGCGCAGTGCTGGCGCGGGTGGATGCCGGTGACGAACAGCTGGAGCGAAAGATCCACTATCGCCAGCAGGATCTGGTGGACTACTCGCCGGTCAGCGAAAAACACCTTGCCGACGGCATGACGGTCGGCGAACTCTGCGCCGCCGCCATTACCATGAGCGATAACAGCGCCGCCAATCTGCTGCTGGCCACCGTCGGCGGCCCCGCAGGATTGACTGCCTTTTTGCGCCAGATCGGCGACAACGTCACCCGCCTTGACCGCTGGGAAACGGAACTGAATGAGGCGCTTCCCGGCGACGCCCGCGACACCACTACCCCGGCCAGCATGGCCGCGACCCTGCGCAAGCTGCTGACCAGCCAGCGTCTGAGCGCCCGTTCGCAACGGCAGCTGCTGCAGTGGATGGTGGACGATCGGGTCGCCGGACCGTTGATCCGCTCCGTGCTGCCGGCGGGCTGGTTTATCGCCGATAAGACCGGAGCTAGCAAGCGGGGTGCGCGCGGGATTGTCGCCCTGCTTGGCCCGAATAACAAAGCAGAGCGCATTGTGGTGATTTATCTGCGGGATACGCCGGCGAGCATGGCCGAGCG
345	gb|KF986259.1|-|16-841|ARO:3001564|OXA-378	ATGAACATTCAAGCACTCTTACTTATAACAAGCGCTATTTTTATTTCAGCCTGC...TAG	825.0	54149	54919	770	825	ATGAACATTAAAGCACTCTTACTTATAACAAGCGCTATTTTTATTTCAGCCTGCTCACCTTATATAGTGACTGCTAATCCAAATCACAGCGCTTCAAAATCTGATGTAAAAGCAGAGAAAATTAAAAATTTATTTAACGAAGCACACACTACGGGTGTTTTAGTTATCCAACAAGGCCAAACTCAACAAAGCTATGGTAATGATCTTGCTCGTGCTTCGACCGAGTATGTACCTGCTTCGACCTTCAAAATGCTTAATGCTTTGATCGGCCTTGAGCACCATAAGGCAACCACCACAGAAGTATTTAAGTGGGATGGTAAAAAAAGGTTATTCCCAGAATGGGAAAAGGACATGACCCTAGGCGATGCCATGAAAGCTTCCGCTATTCCAGTTTATCAAGATTTAGCTCGTCGTATTGGACTTGAGCTCATGTCTAAGGAAGTGAAGCGTGTTGGTTATGGCAATGCAGATATCGGTACCCAAGTCGATAATTTTTGGCTGGTGGGTCCTTTAAAAATTACTCCTCAGCAAGAGGCACAGTTTGCTTACAAGCTAGCTAATAAAACGCTTCCATTTAGCCAAAAAGTCCAAGATGAAGTGCAATCCATGCTATTCATAGAAGAAAAGAATGGAAACAAAATATACGCAAAAAGTGGTTGGGGATGGGATGTAAACCCACAAGTAGGCTGGTTAACTGGATGGGTTGTTCAGCCTCAAGGGAATATTGTAGCGTTCTCCCTTAACTTAGAAATGAAAAAAGGAATACCTAG
346	gb|AY101578|+|214-1075|ARO:3000969|TEM-106	ATGAGTATTCAACATTTTCGTGTCGCCCTTATTCCCTTTTTTGCGGCATTTTGC...TAA	861.0	46	852	806	861	ATGAGTATTCAACATTTCCGTGTCGCCCTTATTCCCTTTTTTGCGGCATTTTGCCTTCCTGTTTTTGCTCACCCAGAAACGCTGGTGAAAGTAAAAGATGCTGAAGATCAGTTGGGTGCACGAGTGGGTTACATCGAGCTGGATCTCAACAGCGGTAAGATCCTTGAGAGTTTTCGCCCCGAAGAACGTTTTCCAATGATGAGCACTTTTAAAGTTCTGCTATGTGGTGCGGTATTATCCCGTGTTGACGCCGGGCAAGAGCAACTCGGTCGCCGCATACACTATTCTCAGAATGACTTGGTTGAGTACTCACCAGTCACAGAAAAGCATCTTACGGATGGCATGACAGTAAGAGAATTATGCAGTGCTGCCATAACCATGAGTGATAACACTGCGGCCAACTTACTTCTGACAACGATCGGAGGACCGAAGGAGCTAACCGCTTTTTTGCACAACATGGGGGATCATGTAACCCGCCTTGATCGTTGGGAACCGGAGCTGAATGAAGCCATACCAAACGACGAGCGTGACACCACGATGCCTGCAGCAATGGCAACAACGTTGCGCAAACTATTAACTGGCGAACTACTTACTCTAGCTTCCCGGCAACAATTAATAGACTGGATGGAGGCGGATAAAGTTGCAGGACCACTTCTGCGCTCGGCCCTTCCGGCTGGCTGGTTTATTGCTGATAAATCTGGAGCCGGTGAGCGTGGATCTCGCGGTATCATTGCAGCACTGGGGCCAGATGGTAAGCCCTCCCGTATCGTAGTTATCTACACGACGGGGAGTCAGGCAACTATGGA
347	gb|AY874537|+|177-1038|ARO:3000883|TEM-11	ATGAGTATTCAACATTTCCGTGTCGCCCTTATTCCCTTTTTTGCGGCATTTTGC...TAA	861.0	46	852	806	861	ATGAGTATTCAACATTTCCGTGTCGCCCTTATTCCCTTTTTTGCGGCATTTTGCCTTCCTGTTTTTGCTCACCCAGAAACGCTGGTGAAAGTAAAAGATGCTGAAGATCAGTTGGGTGCACGAGTGGGTTACATCGAGCTGGATCTCAACAGCGGTAAGATCCTTGAGAGTTTTCGCCCCGAAGAACGTTTTCCAATGATGAGCACTTTTAAAGTTCTGCTATGTGGTGCGGTATTATCCCGTGTTGACGCCGGGCAAGAGCAACTCGGTCGCCGCATACACTATTCTCAGAATGACTTGGTTGAGTACTCACCAGTCACAGAAAAGCATCTTACGGATGGCATGACAGTAAGAGAATTATGCAGTGCTGCCATAACCATGAGTGATAACACTGCGGCCAACTTACTTCTGACAACGATCGGAGGACCGAAGGAGCTAACCGCTTTTTTGCACAACATGGGGGATCATGTAACCCGCCTTGATCGTTGGGAACCGGAGCTGAATGAAGCCATACCAAACGACGAGCGTGACACCACGATGCCTGCAGCAATGGCAACAACGTTGCGCAAACTATTAACTGGCGAACTACTTACTCTAGCTTCCCGGCAACAATTAATAGACTGGATGGAGGCGGATAAAGTTGCAGGACCACTTCTGCGCTCGGCCCTTCCGGCTGGCTGGTTTATTGCTGATAAATCTGGAGCCGGTGAGCGTGGATCTCGCGGTATCATTGCAGCACTGGGGCCAGATGGTAAGCCCTCCCGTATCGTAGTTATCTACACGACGGGGAGTCAGGCAACTATGGA
348	gb|DQ519089|+|8-833|ARO:3001630|OXA-95	ATGAACATTAAAGCACTCTTCCTTATAACAAGCGCTATTTTTATTTCAGCCTGC...TAG	825.0	54149	54919	770	825	ATGAACATTAAAGCACTCTTACTTATAACAAGCGCTATTTTTATTTCAGCCTGCTCACCTTATATAGTGACTGCTAATCCAAATCACAGCGCTTCAAAATCTGATGTAAAAGCAGAGAAAATTAAAAATTTATTTAACGAAGCACACACTACGGGTGTTTTAGTTATCCAACAAGGCCAAACTCAACAAAGCTATGGTAATGATCTTGCTCGTGCTTCGACCGAGTATGTACCTGCTTCGACCTTCAAAATGCTTAATGCTTTGATCGGCCTTGAGCACCATAAGGCAACCACCACAGAAGTATTTAAGTGGGATGGTAAAAAAAGGTTATTCCCAGAATGGGAAAAGGACATGACCCTAGGCGATGCCATGAAAGCTTCCGCTATTCCAGTTTATCAAGATTTAGCTCGTCGTATTGGACTTGAGCTCATGTCTAAGGAAGTGAAGCGTGTTGGTTATGGCAATGCAGATATCGGTACCCAAGTCGATAATTTTTGGCTGGTGGGTCCTTTAAAAATTACTCCTCAGCAAGAGGCACAGTTTGCTTACAAGCTAGCTAATAAAACGCTTCCATTTAGCCAAAAAGTCCAAGATGAAGTGCAATCCATGCTATTCATAGAAGAAAAGAATGGAAACAAAATATACGCAAAAAGTGGTTGGGGATGGGATGTAAACCCACAAGTAGGCTGGTTAACTGGATGGGTTGTTCAGCCTCAAGGGAATATTGTAGCGTTCTCCCTTAACTTAGAAATGAAAAAAGGAATACCTAG
349	gb|AY072920|+|0-861|ARO:3000973|TEM-110	ATGAGTATTCAACATTTCCGTGTCGCCCTTATTCCCTTTTTTGCGGCATTTTGC...TAA	861.0	46	852	806	861	ATGAGTATTCAACATTTCCGTGTCGCCCTTATTCCCTTTTTTGCGGCATTTTGCCTTCCTGTTTTTGCTCACCCAGAAACGCTGGTGAAAGTAAAAGATGCTGAAGATCAGTTGGGTGCACGAGTGGGTTACATCGAGCTGGATCTCAACAGCGGTAAGATCCTTGAGAGTTTTCGCCCCGAAGAACGTTTTCCAATGATGAGCACTTTTAAAGTTCTGCTATGTGGTGCGGTATTATCCCGTGTTGACGCCGGGCAAGAGCAACTCGGTCGCCGCATACACTATTCTCAGAATGACTTGGTTGAGTACTCACCAGTCACAGAAAAGCATCTTACGGATGGCATGACAGTAAGAGAATTATGCAGTGCTGCCATAACCATGAGTGATAACACTGCGGCCAACTTACTTCTGACAACGATCGGAGGACCGAAGGAGCTAACCGCTTTTTTGCACAACATGGGGGATCATGTAACCCGCCTTGATCGTTGGGAACCGGAGCTGAATGAAGCCATACCAAACGACGAGCGTGACACCACGATGCCTGCAGCAATGGCAACAACGTTGCGCAAACTATTAACTGGCGAACTACTTACTCTAGCTTCCCGGCAACAATTAATAGACTGGATGGAGGCGGATAAAGTTGCAGGACCACTTCTGCGCTCGGCCCTTCCGGCTGGCTGGTTTATTGCTGATAAATCTGGAGCCGGTGAGCGTGGATCTCGCGGTATCATTGCAGCACTGGGGCCAGATGGTAAGCCCTCCCGTATCGTAGTTATCTACACGACGGGGAGTCAGGCAACTATGGA
350	gb|JQ867374.1|+|0-1152|ARO:3004632|ADC-62	ATGCGATTTAAAAAAATTTCTTGTCTACTTTTATCCCCGCTTTTTATTTTTAGT...TAA	1152.0	63	1160	1097	1152	ATGCGATTTAAAAAAATTTCTTGTCTACTTTTATCCCCGCTTTTTATTTTTAGTACCTCAATTTATGCGGGCAATACACCAAAAGACCAAGAAATTAAAAAACTGGTAGATCAAAACTTTAAACCGTTATTAGAAAAATATGATGTGCCAGGTATGGCTGTGGGTGTTATTCAAAATAATAAAAAGTATGAAATGTATTATGGTCTTCAATCTGTTCAAGATAAAAAAGCCGTAAATAGCAGTACTATTTTTGAGCTAGGTTCTGTCAGTAAATTATTTACCGCGACAGCAGGTGGATATGCAAAAAATAAAGGAAAAATCTCTTTTGACGATACGCCTGGTAAGTATTGGAAAGAACTAAAAAATACACCGATTGACCAAGTTAACTTACTTCAACTCGCGACGTATACAAGTGGTAACCTTGCCTTGCAATTTCCAGATGAAGTAAAAACAGATCAGCAAGTTTTAACATTTTTTAAAGACTGGAAACCTAAAAACTCAATCGGTGAATATCGACAATATTCAAACCCAAGCATTGGTTTATTTGGAAAAGTTGTAGCTTTGTCTATGAATAAACCTTTCGACCAAGTCTTAGAAAAAACAATTTTTCCGGCCCTTGGCTTAAAACATAGCTATGTAAATGTACCTAAGACCCAGATGCAAAACTATGCTTTTGGCTATAACCAAGAAAATCAGCCGATTCGAGTTAACCCCGGCCCACTCGATGCCCCAGCATATGGCGTCAAATCGACACTACCCGACATGTTGAGTTTTATTCATGCCAACCTAAATCCACAAAAATATCCAGCAGATATTCAACGGGCAATTAATGAAACACATCAGGGTCGCTATCAAGTAAATACCATGTATCAGGCACTCGGTTGGGAAGAGTTTTCTTATCCGGCAACGTTACAAACTTTATTAGACAGTAATTCAGAACAGATTGTGATGAAACCTAATAAAGTGACTGCTATTTCAAAGGAACCTTCAGTTAAGATGTACCATAAAACTGGCTCAACTACCGGTTTCGGAACATATGTGGTGTTTATTCCTAAAGAAAATATTGGTTTAGTCATGTTAACCAATAAACGTATTCC
351	gb|AY101764|+|206-1067|ARO:3000970|TEM-107	ATGAGTATTCAACATTTTCGTGTCGCCCTTATTCCCTTTTTTGCGGCATTTTGC...TAA	861.0	46	852	806	861	ATGAGTATTCAACATTTCCGTGTCGCCCTTATTCCCTTTTTTGCGGCATTTTGCCTTCCTGTTTTTGCTCACCCAGAAACGCTGGTGAAAGTAAAAGATGCTGAAGATCAGTTGGGTGCACGAGTGGGTTACATCGAGCTGGATCTCAACAGCGGTAAGATCCTTGAGAGTTTTCGCCCCGAAGAACGTTTTCCAATGATGAGCACTTTTAAAGTTCTGCTATGTGGTGCGGTATTATCCCGTGTTGACGCCGGGCAAGAGCAACTCGGTCGCCGCATACACTATTCTCAGAATGACTTGGTTGAGTACTCACCAGTCACAGAAAAGCATCTTACGGATGGCATGACAGTAAGAGAATTATGCAGTGCTGCCATAACCATGAGTGATAACACTGCGGCCAACTTACTTCTGACAACGATCGGAGGACCGAAGGAGCTAACCGCTTTTTTGCACAACATGGGGGATCATGTAACCCGCCTTGATCGTTGGGAACCGGAGCTGAATGAAGCCATACCAAACGACGAGCGTGACACCACGATGCCTGCAGCAATGGCAACAACGTTGCGCAAACTATTAACTGGCGAACTACTTACTCTAGCTTCCCGGCAACAATTAATAGACTGGATGGAGGCGGATAAAGTTGCAGGACCACTTCTGCGCTCGGCCCTTCCGGCTGGCTGGTTTATTGCTGATAAATCTGGAGCCGGTGAGCGTGGATCTCGCGGTATCATTGCAGCACTGGGGCCAGATGGTAAGCCCTCCCGTATCGTAGTTATCTACACGACGGGGAGTCAGGCAACTATGGA
352	gb|AF468003|+|0-861|ARO:3000974|TEM-111	ATGAGTATTCAACATTTCCGTGTCGCCCTTATTCCCTTTTTTGCGGCATTTTGC...TAA	861.0	46	852	806	861	ATGAGTATTCAACATTTCCGTGTCGCCCTTATTCCCTTTTTTGCGGCATTTTGCCTTCCTGTTTTTGCTCACCCAGAAACGCTGGTGAAAGTAAAAGATGCTGAAGATCAGTTGGGTGCACGAGTGGGTTACATCGAGCTGGATCTCAACAGCGGTAAGATCCTTGAGAGTTTTCGCCCCGAAGAACGTTTTCCAATGATGAGCACTTTTAAAGTTCTGCTATGTGGTGCGGTATTATCCCGTGTTGACGCCGGGCAAGAGCAACTCGGTCGCCGCATACACTATTCTCAGAATGACTTGGTTGAGTACTCACCAGTCACAGAAAAGCATCTTACGGATGGCATGACAGTAAGAGAATTATGCAGTGCTGCCATAACCATGAGTGATAACACTGCGGCCAACTTACTTCTGACAACGATCGGAGGACCGAAGGAGCTAACCGCTTTTTTGCACAACATGGGGGATCATGTAACCCGCCTTGATCGTTGGGAACCGGAGCTGAATGAAGCCATACCAAACGACGAGCGTGACACCACGATGCCTGCAGCAATGGCAACAACGTTGCGCAAACTATTAACTGGCGAACTACTTACTCTAGCTTCCCGGCAACAATTAATAGACTGGATGGAGGCGGATAAAGTTGCAGGACCACTTCTGCGCTCGGCCCTTCCGGCTGGCTGGTTTATTGCTGATAAATCTGGAGCCGGTGAGCGTGGATCTCGCGGTATCATTGCAGCACTGGGGCCAGATGGTAAGCCCTCCCGTATCGTAGTTATCTACACGACGGGGAGTCAGGCAACTATGGA
353	gb|JN861780|+|0-825|ARO:3001711|OXA-212	ATGAAAACTTTACAGTCGGGCCTCATCGCCCTCATTACAACCTTCGGTTCCGCA...TAA	825.0	156	929	773	825	ATGAAAACTTTACAGTTGGGCCTCATCGTCCTCATTACTACCTTCGGTTCTGCATGTACCATAATAAGAAGCCCCTCCATAGAAACAGCTAAAAACCATGAGCAACAAAGTGCGCAGCAGCAGATCCAACAGGCCTTCGATCAACTCCAAACCACGGGGGTGATTGTCATAAAGGATAAGCATGGCTTACACAGCTACGGCAATGACTTGAGCCGTGCTCAGACACCCTATGTACCCGCCTCTACCTTTAAAATGCTGAATGCCTTAATCGGACTAGAACATGGTAAAGCAACCAGCACCGAGGTGTTTAAATGGGATGGTCAAAAGAACAGCTTCCCTGCTTGGGAAAAAGACATGACTTTAGGGCAAGCCATGCAAGCATCTGCCGTTCCTGTTTATCAGGAGCTAGCACGGCGCATTGGCCTAGATCTAATGCAAAAAGAAGTACAGCGCATTGGATATGGCAATCAACAGATTGGCACCGTTGTCGATAATTTTTGGTTAGTCGGTCCACTGCAAATTACGCCTGTTCAAGAAGTCCTTTTTGTAGAGAAGCTGGCCAATACGCAACTCGCTTTTAAGCCAGATGTGCAACATACCGTACAAGACATGCTGCTGATTGAACAAAAACCGAATTATAAACTCTACGCCAAATCTGGTTGGGGCATGGACCTAGAACCGCAAGTGGGCTGGTGGACAGGCTGGGTCGAAACAGCAACAGGTGAAAAAGTGTATTTTGCTTTGAATATGCATATGAAAACAGGAATTTCAGC
354	gb|AY590467|+|0-729|ARO:3001110|SHV-53  Partial			36	710	674	729	TATTATCACCCTGTGAGCCACCCTGCCGCTGGCGGTACACGCCAGCCCGCAGCCGCTTGAGCAAATTAAACAAAGCGAAAGCCAGCTGTCGGGCCGCGTAGGCATGATAGAAATGGATCTGGCCAGCGGCCGCACGCTGACCGCCTGGCGCGCCGATGAACGCTTTCCCATGATGAGCACCTTTAAAGTAGTGCTCTGCGGCGCAGTGCTGGCGCGGGTGGATGCCGGTGACGAACAGCTGGAGCGAAAGATCCACTATCGCCAGCAGGATCTGGTGGACTACTCGCCGGTCAGCGAAAAACACCTTGCCGACGGCATGACGGTCGGCGAACTCTGCGCCGCCGCCATTACCATGAGCGATAACAGCGCCGCCAATCTGCTGCTGGCCACCGTCGGCGGCCCCGCAGGATTGACTGCCTTTTTGCGCCAGATCGGCGACAACGTCACCCGCCTTGACCGCTGGGAAACGGAACTGAATGAGGCGCTTCCCGGCGACGCCCGCGACACCACTACCCCGGCCAGCATGGCCGCGACCCTGCGCAAGCTGCTGACCAGCCAGCGTCTGAGCGCCCGTTCGCAACGGCAGCTGCTGCAGTGGATGGTGGACGATCGGGTCGCCGGACCGTTGATCCGCTCCGTGCTGCCGGCGGGCTGGTTTATCGCCGATAAGACCG
355	gb|KF986260|+|20-845|ARO:3001565|OXA-379	ATGAACATTAAAGCACTCTTACTTATAACAAGCGCTATTTTTATTTCAGCCTGT...TAG	825.0	54149	54919	770	825	ATGAACATTAAAGCACTCTTACTTATAACAAGCGCTATTTTTATTTCAGCCTGCTCACCTTATATAGTGACTGCTAATCCAAATCACAGCGCTTCAAAATCTGATGTAAAAGCAGAGAAAATTAAAAATTTATTTAACGAAGCACACACTACGGGTGTTTTAGTTATCCAACAAGGCCAAACTCAACAAAGCTATGGTAATGATCTTGCTCGTGCTTCGACCGAGTATGTACCTGCTTCGACCTTCAAAATGCTTAATGCTTTGATCGGCCTTGAGCACCATAAGGCAACCACCACAGAAGTATTTAAGTGGGATGGTAAAAAAAGGTTATTCCCAGAATGGGAAAAGGACATGACCCTAGGCGATGCCATGAAAGCTTCCGCTATTCCAGTTTATCAAGATTTAGCTCGTCGTATTGGACTTGAGCTCATGTCTAAGGAAGTGAAGCGTGTTGGTTATGGCAATGCAGATATCGGTACCCAAGTCGATAATTTTTGGCTGGTGGGTCCTTTAAAAATTACTCCTCAGCAAGAGGCACAGTTTGCTTACAAGCTAGCTAATAAAACGCTTCCATTTAGCCAAAAAGTCCAAGATGAAGTGCAATCCATGCTATTCATAGAAGAAAAGAATGGAAACAAAATATACGCAAAAAGTGGTTGGGGATGGGATGTAAACCCACAAGTAGGCTGGTTAACTGGATGGGTTGTTCAGCCTCAAGGGAATATTGTAGCGTTCTCCCTTAACTTAGAAATGAAAAAAGGAATACCTAG
356	gb|AF506748|+|38-899|ARO:3000971|TEM-108	ATGGATCCTCAACATTTCCGTGTCGCCCTTATTCCCTTTTTTGCGGCATTTTGC...TAA	861.0	54	852	798	861	TCAACATTTCCGTGTCGCCCTTATTCCCTTTTTTGCGGCATTTTGCCTTCCTGTTTTTGCTCACCCAGAAACGCTGGTGAAAGTAAAAGATGCTGAAGATCAGTTGGGTGCACGAGTGGGTTACATCGAGCTGGATCTCAACAGCGGTAAGATCCTTGAGAGTTTTCGCCCCGAAGAACGTTTTCCAATGATGAGCACTTTTAAAGTTCTGCTATGTGGTGCGGTATTATCCCGTGTTGACGCCGGGCAAGAGCAACTCGGTCGCCGCATACACTATTCTCAGAATGACTTGGTTGAGTACTCACCAGTCACAGAAAAGCATCTTACGGATGGCATGACAGTAAGAGAATTATGCAGTGCTGCCATAACCATGAGTGATAACACTGCGGCCAACTTACTTCTGACAACGATCGGAGGACCGAAGGAGCTAACCGCTTTTTTGCACAACATGGGGGATCATGTAACCCGCCTTGATCGTTGGGAACCGGAGCTGAATGAAGCCATACCAAACGACGAGCGTGACACCACGATGCCTGCAGCAATGGCAACAACGTTGCGCAAACTATTAACTGGCGAACTACTTACTCTAGCTTCCCGGCAACAATTAATAGACTGGATGGAGGCGGATAAAGTTGCAGGACCACTTCTGCGCTCGGCCCTTCCGGCTGGCTGGTTTATTGCTGATAAATCTGGAGCCGGTGAGCGTGGATCTCGCGGTATCATTGCAGCACTGGGGCCAGATGGTAAGCCCTCCCGTATCGTAGTTATCTACACGACGGGGAGTCAGGCAACTATGGA
357	gb|AY589493|+|166-1027|ARO:3000975|TEM-112	ATGAGTATTCAACATTTCCGTGTCGCCCTTATTCCCTTTTTTGCGGCATTTTGC...TAA	861.0	46	852	806	861	ATGAGTATTCAACATTTCCGTGTCGCCCTTATTCCCTTTTTTGCGGCATTTTGCCTTCCTGTTTTTGCTCACCCAGAAACGCTGGTGAAAGTAAAAGATGCTGAAGATCAGTTGGGTGCACGAGTGGGTTACATCGAGCTGGATCTCAACAGCGGTAAGATCCTTGAGAGTTTTCGCCCCGAAGAACGTTTTCCAATGATGAGCACTTTTAAAGTTCTGCTATGTGGTGCGGTATTATCCCGTGTTGACGCCGGGCAAGAGCAACTCGGTCGCCGCATACACTATTCTCAGAATGACTTGGTTGAGTACTCACCAGTCACAGAAAAGCATCTTACGGATGGCATGACAGTAAGAGAATTATGCAGTGCTGCCATAACCATGAGTGATAACACTGCGGCCAACTTACTTCTGACAACGATCGGAGGACCGAAGGAGCTAACCGCTTTTTTGCACAACATGGGGGATCATGTAACCCGCCTTGATCGTTGGGAACCGGAGCTGAATGAAGCCATACCAAACGACGAGCGTGACACCACGATGCCTGCAGCAATGGCAACAACGTTGCGCAAACTATTAACTGGCGAACTACTTACTCTAGCTTCCCGGCAACAATTAATAGACTGGATGGAGGCGGATAAAGTTGCAGGACCACTTCTGCGCTCGGCCCTTCCGGCTGGCTGGTTTATTGCTGATAAATCTGGAGCCGGTGAGCGTGGATCTCGCGGTATCATTGCAGCACTGGGGCCAGATGGTAAGCCCTCCCGTATCGTAGTTATCTACACGACGGGGAGTCAGGCAACTATGGA
358	gb|JX169789.1|+|0-1152|ARO:3004633|ADC-67	ATGCGATTTAAAAAAATTTCTTGTCTACTTTTATCCCCGCTTTTTATTTTTAGT...TAA	1152.0	63	1160	1097	1152	ATGCGATTTAAAAAAATTTCTTGTCTACTTTTATCCCCGCTTTTTATTTTTAGTACCTCAATTTATGCGGGCAATACACCAAAAGACCAAGAAATTAAAAAACTGGTAGATCAAAACTTTAAACCGTTATTAGAAAAATATGATGTGCCAGGTATGGCTGTGGGTGTTATTCAAAATAATAAAAAGTATGAAATGTATTATGGTCTTCAATCTGTTCAAGATAAAAAAGCCGTAAATAGCAGTACTATTTTTGAGCTAGGTTCTGTCAGTAAATTATTTACCGCGACAGCAGGTGGATATGCAAAAAATAAAGGAAAAATCTCTTTTGACGATACGCCTGGTAAGTATTGGAAAGAACTAAAAAATACACCGATTGACCAAGTTAACTTACTTCAACTCGCGACGTATACAAGTGGTAACCTTGCCTTGCAATTTCCAGATGAAGTAAAAACAGATCAGCAAGTTTTAACATTTTTTAAAGACTGGAAACCTAAAAACTCAATCGGTGAATATCGACAATATTCAAACCCAAGCATTGGTTTATTTGGAAAAGTTGTAGCTTTGTCTATGAATAAACCTTTCGACCAAGTCTTAGAAAAAACAATTTTTCCGGCCCTTGGCTTAAAACATAGCTATGTAAATGTACCTAAGACCCAGATGCAAAACTATGCTTTTGGCTATAACCAAGAAAATCAGCCGATTCGAGTTAACCCCGGCCCACTCGATGCCCCAGCATATGGCGTCAAATCGACACTACCCGACATGTTGAGTTTTATTCATGCCAACCTAAATCCACAAAAATATCCAGCAGATATTCAACGGGCAATTAATGAAACACATCAGGGTCGCTATCAAGTAAATACCATGTATCAGGCACTCGGTTGGGAAGAGTTTTCTTATCCGGCAACGTTACAAACTTTATTAGACAGTAATTCAGAACAGATTGTGATGAAACCTAATAAAGTGACTGCTATTTCAAAGGAACCTTCAGTTAAGATGTACCATAAAACTGGCTCAACTACCGGTTTCGGAACATATGTGGTGTTTATTCCTAAAGAAAATATTGGTTTAGTCATGTTAACCAATAAACGTATTCC
359	gb|KR057752.1|+|0-1116|ARO:3004346|PDC-83	GGCGAGGCCCCGGCGGATCGCCTGAAGGCATTGGTCGACGCCGCCGTACAACCG...TGA	1116.0	35594	36652	1058	1116	GAGGCCCCGGCGGATCGCCTGAAGGCACTGGTCGACGCCGCCGTACAACCGGTGATGAAGGCCAATGACATTCCGGGCCTGGCCGTAGCCATCAGCCTGAAAGGAGAACCGCATTACTTCAGCTATGGGCTGGCCTCGAAAGAGGACGGCCGCCGGGTGACGCCGGAGACCCTGTTCGAGATCGGCTCGGTGAGCAAGACCTTCACCGTCACCCTCGCCGGCTATGCCCTGGCCCAGGACAAGATGCGCCTCGACGACCGCGCCAGCCAGCACTGGCCGGCACTGCAGGGCAGCCGCTTCGACGGCATCAGCCTGCTCGACCTCGCGACCTATACCGCCGGCGGCTTGCCGCTGCAGTTCCCCGACTCGGTGCAGAAGGACCAGGCACAGATCCGCGACTACTACCGCCAGTGGCAGCCGACCTACGCGCCGGGCAGCCAGCGCCTCTATTCCAACCCGAGCATCGGCCTGTTCGGCTATCTCGCCGCGCGCAGCCTGGGCCAGCCGTTCGAACGGCTCATGGAGCAGCAATTGTTCCCGGCACTGGGCCTCGAACAGACCCACCTCGACGTGCCCGAGGCGGCGCTGGCGCAGTACGCCCAGGGCTACGGCAAGGACGACCGCCCGCTACGGGTCGGTCCCGGCCCGCTGGATGCCGAAGGCTACGGGGTGAAGACCAGCGCGGCCGACCTGCTGCGCTTCGTCGATGCCAACCTGCATCCGGAGCGCCTGGACAGGCCCTGGGCGCAGGCGCTCGATGCCACCCATCGCGGTTACTACAAGGTCGGCGACATGACCCAGGGCCTGGGCTGGGAAGCCTACGACTGGCCGATCTCCCTGAAGCGCCTGCAGGCCGGCAACTCGACGCCGATGGCGCTGCAACCACACAGGATCGCCAGGCTGCCCGCGCCACAGGCGCTGGAGGGCCAGCGCCTGCTGAACAAGACCGGCTCCACCAACGGCTTCGGCGCCTACGTGGCGTTCGTCCCGGGCCGCGACCTGGGCCTGGTGATCCTGGCCAACCGCAACTATCCCAATGCCGAGCGGGTGAAGATCGC
360	gb|AM279652|+|0-825|ARO:3001646|OXA-98	ATGAACATTAAAGCACTCTTACTTATAACAAGCGCTATTTTTATTTCAGCCTGC...TAG	825.0	54149	54919	770	825	ATGAACATTAAAGCACTCTTACTTATAACAAGCGCTATTTTTATTTCAGCCTGCTCACCTTATATAGTGACTGCTAATCCAAATCACAGCGCTTCAAAATCTGATGTAAAAGCAGAGAAAATTAAAAATTTATTTAACGAAGCACACACTACGGGTGTTTTAGTTATCCAACAAGGCCAAACTCAACAAAGCTATGGTAATGATCTTGCTCGTGCTTCGACCGAGTATGTACCTGCTTCGACCTTCAAAATGCTTAATGCTTTGATCGGCCTTGAGCACCATAAGGCAACCACCACAGAAGTATTTAAGTGGGATGGTAAAAAAAGGTTATTCCCAGAATGGGAAAAGGACATGACCCTAGGCGATGCCATGAAAGCTTCCGCTATTCCAGTTTATCAAGATTTAGCTCGTCGTATTGGACTTGAGCTCATGTCTAAGGAAGTGAAGCGTGTTGGTTATGGCAATGCAGATATCGGTACCCAAGTCGATAATTTTTGGCTGGTGGGTCCTTTAAAAATTACTCCTCAGCAAGAGGCACAGTTTGCTTACAAGCTAGCTAATAAAACGCTTCCATTTAGCCAAAAAGTCCAAGATGAAGTGCAATCCATGCTATTCATAGAAGAAAAGAATGGAAACAAAATATACGCAAAAAGTGGTTGGGGATGGGATGTAAACCCACAAGTAGGCTGGTTAACTGGATGGGTTGTTCAGCCTCAAGGGAATATTGTAGCGTTCTCCCTTAACTTAGAAATGAAAAAAGGAATACCTAG
361	gb|AY589494|+|193-1054|ARO:3000976|TEM-113	ATGAGTATTCAACATTTCCGTGTCGCCCTTATTCCCTTTTTTGCGGCATTTTGC...TAA	861.0	46	852	806	861	ATGAGTATTCAACATTTCCGTGTCGCCCTTATTCCCTTTTTTGCGGCATTTTGCCTTCCTGTTTTTGCTCACCCAGAAACGCTGGTGAAAGTAAAAGATGCTGAAGATCAGTTGGGTGCACGAGTGGGTTACATCGAGCTGGATCTCAACAGCGGTAAGATCCTTGAGAGTTTTCGCCCCGAAGAACGTTTTCCAATGATGAGCACTTTTAAAGTTCTGCTATGTGGTGCGGTATTATCCCGTGTTGACGCCGGGCAAGAGCAACTCGGTCGCCGCATACACTATTCTCAGAATGACTTGGTTGAGTACTCACCAGTCACAGAAAAGCATCTTACGGATGGCATGACAGTAAGAGAATTATGCAGTGCTGCCATAACCATGAGTGATAACACTGCGGCCAACTTACTTCTGACAACGATCGGAGGACCGAAGGAGCTAACCGCTTTTTTGCACAACATGGGGGATCATGTAACCCGCCTTGATCGTTGGGAACCGGAGCTGAATGAAGCCATACCAAACGACGAGCGTGACACCACGATGCCTGCAGCAATGGCAACAACGTTGCGCAAACTATTAACTGGCGAACTACTTACTCTAGCTTCCCGGCAACAATTAATAGACTGGATGGAGGCGGATAAAGTTGCAGGACCACTTCTGCGCTCGGCCCTTCCGGCTGGCTGGTTTATTGCTGATAAATCTGGAGCCGGTGAGCGTGGATCTCGCGGTATCATTGCAGCACTGGGGCCAGATGGTAAGCCCTCCCGTATCGTAGTTATCTACACGACGGGGAGTCAGGCAACTATGGA
362	gb|AY628175|+|210-1071|ARO:3000972|TEM-109	ATGAGTATTCAACATTTTCGTGTCGCCCTTATTCCCTTTTTTGCGGCATTTTGC...TAA	861.0	46	852	806	861	ATGAGTATTCAACATTTCCGTGTCGCCCTTATTCCCTTTTTTGCGGCATTTTGCCTTCCTGTTTTTGCTCACCCAGAAACGCTGGTGAAAGTAAAAGATGCTGAAGATCAGTTGGGTGCACGAGTGGGTTACATCGAGCTGGATCTCAACAGCGGTAAGATCCTTGAGAGTTTTCGCCCCGAAGAACGTTTTCCAATGATGAGCACTTTTAAAGTTCTGCTATGTGGTGCGGTATTATCCCGTGTTGACGCCGGGCAAGAGCAACTCGGTCGCCGCATACACTATTCTCAGAATGACTTGGTTGAGTACTCACCAGTCACAGAAAAGCATCTTACGGATGGCATGACAGTAAGAGAATTATGCAGTGCTGCCATAACCATGAGTGATAACACTGCGGCCAACTTACTTCTGACAACGATCGGAGGACCGAAGGAGCTAACCGCTTTTTTGCACAACATGGGGGATCATGTAACCCGCCTTGATCGTTGGGAACCGGAGCTGAATGAAGCCATACCAAACGACGAGCGTGACACCACGATGCCTGCAGCAATGGCAACAACGTTGCGCAAACTATTAACTGGCGAACTACTTACTCTAGCTTCCCGGCAACAATTAATAGACTGGATGGAGGCGGATAAAGTTGCAGGACCACTTCTGCGCTCGGCCCTTCCGGCTGGCTGGTTTATTGCTGATAAATCTGGAGCCGGTGAGCGTGGATCTCGCGGTATCATTGCAGCACTGGGGCCAGATGGTAAGCCCTCCCGTATCGTAGTTATCTACACGACGGGGAGTCAGGCAACTATGGA
363	gb|AY589495|+|181-1042|ARO:3000977|TEM-114	ATGAGTATTCAACATTTCCGTGTCGCCCTTATTCCCTTTTTTGCGGCATTTTGC...TAA	861.0	46	852	806	861	ATGAGTATTCAACATTTCCGTGTCGCCCTTATTCCCTTTTTTGCGGCATTTTGCCTTCCTGTTTTTGCTCACCCAGAAACGCTGGTGAAAGTAAAAGATGCTGAAGATCAGTTGGGTGCACGAGTGGGTTACATCGAGCTGGATCTCAACAGCGGTAAGATCCTTGAGAGTTTTCGCCCCGAAGAACGTTTTCCAATGATGAGCACTTTTAAAGTTCTGCTATGTGGTGCGGTATTATCCCGTGTTGACGCCGGGCAAGAGCAACTCGGTCGCCGCATACACTATTCTCAGAATGACTTGGTTGAGTACTCACCAGTCACAGAAAAGCATCTTACGGATGGCATGACAGTAAGAGAATTATGCAGTGCTGCCATAACCATGAGTGATAACACTGCGGCCAACTTACTTCTGACAACGATCGGAGGACCGAAGGAGCTAACCGCTTTTTTGCACAACATGGGGGATCATGTAACCCGCCTTGATCGTTGGGAACCGGAGCTGAATGAAGCCATACCAAACGACGAGCGTGACACCACGATGCCTGCAGCAATGGCAACAACGTTGCGCAAACTATTAACTGGCGAACTACTTACTCTAGCTTCCCGGCAACAATTAATAGACTGGATGGAGGCGGATAAAGTTGCAGGACCACTTCTGCGCTCGGCCCTTCCGGCTGGCTGGTTTATTGCTGATAAATCTGGAGCCGGTGAGCGTGGATCTCGCGGTATCATTGCAGCACTGGGGCCAGATGGTAAGCCCTCCCGTATCGTAGTTATCTACACGACGGGGAGTCAGGCAACTATGGA
364	gb|EF136376|+|0-861|ARO:3001025|TEM-159	ATGAGTATTCAACATTTCCGTGTCGCCCTTATTCCCTTTTTTGCGGCATTTTGC...TAA	861.0	46	852	806	861	ATGAGTATTCAACATTTCCGTGTCGCCCTTATTCCCTTTTTTGCGGCATTTTGCCTTCCTGTTTTTGCTCACCCAGAAACGCTGGTGAAAGTAAAAGATGCTGAAGATCAGTTGGGTGCACGAGTGGGTTACATCGAGCTGGATCTCAACAGCGGTAAGATCCTTGAGAGTTTTCGCCCCGAAGAACGTTTTCCAATGATGAGCACTTTTAAAGTTCTGCTATGTGGTGCGGTATTATCCCGTGTTGACGCCGGGCAAGAGCAACTCGGTCGCCGCATACACTATTCTCAGAATGACTTGGTTGAGTACTCACCAGTCACAGAAAAGCATCTTACGGATGGCATGACAGTAAGAGAATTATGCAGTGCTGCCATAACCATGAGTGATAACACTGCGGCCAACTTACTTCTGACAACGATCGGAGGACCGAAGGAGCTAACCGCTTTTTTGCACAACATGGGGGATCATGTAACCCGCCTTGATCGTTGGGAACCGGAGCTGAATGAAGCCATACCAAACGACGAGCGTGACACCACGATGCCTGCAGCAATGGCAACAACGTTGCGCAAACTATTAACTGGCGAACTACTTACTCTAGCTTCCCGGCAACAATTAATAGACTGGATGGAGGCGGATAAAGTTGCAGGACCACTTCTGCGCTCGGCCCTTCCGGCTGGCTGGTTTATTGCTGATAAATCTGGAGCCGGTGAGCGTGGATCTCGCGGTATCATTGCAGCACTGGGGCCAGATGGTAAGCCCTCCCGTATCGTAGTTATCTACACGACGGGGAGTCAGGCAACTATGGA
365	gb|AJ863560|+|0-861|ARO:3001111|SHV-55	ATGCGTTTTATTCGCCTGTGTATTATCTCCCTGTTAGCCACCCTGCCGCTGGCG...TAA	861.0	16	822	806	861	ATGCGTTATATTCGCCTGTGTATTATCACCCTGTGAGCCACCCTGCCGCTGGCGGTACACGCCAGCCCGCAGCCGCTTGAGCAAATTAAACAAAGCGAAAGCCAGCTGTCGGGCCGCGTAGGCATGATAGAAATGGATCTGGCCAGCGGCCGCACGCTGACCGCCTGGCGCGCCGATGAACGCTTTCCCATGATGAGCACCTTTAAAGTAGTGCTCTGCGGCGCAGTGCTGGCGCGGGTGGATGCCGGTGACGAACAGCTGGAGCGAAAGATCCACTATCGCCAGCAGGATCTGGTGGACTACTCGCCGGTCAGCGAAAAACACCTTGCCGACGGCATGACGGTCGGCGAACTCTGCGCCGCCGCCATTACCATGAGCGATAACAGCGCCGCCAATCTGCTGCTGGCCACCGTCGGCGGCCCCGCAGGATTGACTGCCTTTTTGCGCCAGATCGGCGACAACGTCACCCGCCTTGACCGCTGGGAAACGGAACTGAATGAGGCGCTTCCCGGCGACGCCCGCGACACCACTACCCCGGCCAGCATGGCCGCGACCCTGCGCAAGCTGCTGACCAGCCAGCGTCTGAGCGCCCGTTCGCAACGGCAGCTGCTGCAGTGGATGGTGGACGATCGGGTCGCCGGACCGTTGATCCGCTCCGTGCTGCCGGCGGGCTGGTTTATCGCCGATAAGACCGGAGCTAGCAAGCGGGGTGCGCGCGGGATTGTCGCCCTGCTTGGCCCGAATAACAAAGCAGAGCGCATTGTGGTGATTTATCTGCGGGATACGCCGGCGAGCATGGCCGAGCG
366	gb|AF535127|+|208-1069|ARO:3000978|TEM-115	ATGAGTATTCAACATTTCCGTGTCGCCCTTATTCCCTTTTTTGCGGCATTTTGC...TAA	861.0	46	852	806	861	ATGAGTATTCAACATTTCCGTGTCGCCCTTATTCCCTTTTTTGCGGCATTTTGCCTTCCTGTTTTTGCTCACCCAGAAACGCTGGTGAAAGTAAAAGATGCTGAAGATCAGTTGGGTGCACGAGTGGGTTACATCGAGCTGGATCTCAACAGCGGTAAGATCCTTGAGAGTTTTCGCCCCGAAGAACGTTTTCCAATGATGAGCACTTTTAAAGTTCTGCTATGTGGTGCGGTATTATCCCGTGTTGACGCCGGGCAAGAGCAACTCGGTCGCCGCATACACTATTCTCAGAATGACTTGGTTGAGTACTCACCAGTCACAGAAAAGCATCTTACGGATGGCATGACAGTAAGAGAATTATGCAGTGCTGCCATAACCATGAGTGATAACACTGCGGCCAACTTACTTCTGACAACGATCGGAGGACCGAAGGAGCTAACCGCTTTTTTGCACAACATGGGGGATCATGTAACCCGCCTTGATCGTTGGGAACCGGAGCTGAATGAAGCCATACCAAACGACGAGCGTGACACCACGATGCCTGCAGCAATGGCAACAACGTTGCGCAAACTATTAACTGGCGAACTACTTACTCTAGCTTCCCGGCAACAATTAATAGACTGGATGGAGGCGGATAAAGTTGCAGGACCACTTCTGCGCTCGGCCCTTCCGGCTGGCTGGTTTATTGCTGATAAATCTGGAGCCGGTGAGCGTGGATCTCGCGGTATCATTGCAGCACTGGGGCCAGATGGTAAGCCCTCCCGTATCGTAGTTATCTACACGACGGGGAGTCAGGCAACTATGGA
367	gb|FR865168|+|0-825|ARO:3001488|OXA-216	ATGAACATTAAAGCACTCTTACTTATAACAAGCGCTATTTCTATTTCAGCCTGC...TAG	825.0	54149	54919	770	825	ATGAACATTAAAGCACTCTTACTTATAACAAGCGCTATTTTTATTTCAGCCTGCTCACCTTATATAGTGACTGCTAATCCAAATCACAGCGCTTCAAAATCTGATGTAAAAGCAGAGAAAATTAAAAATTTATTTAACGAAGCACACACTACGGGTGTTTTAGTTATCCAACAAGGCCAAACTCAACAAAGCTATGGTAATGATCTTGCTCGTGCTTCGACCGAGTATGTACCTGCTTCGACCTTCAAAATGCTTAATGCTTTGATCGGCCTTGAGCACCATAAGGCAACCACCACAGAAGTATTTAAGTGGGATGGTAAAAAAAGGTTATTCCCAGAATGGGAAAAGGACATGACCCTAGGCGATGCCATGAAAGCTTCCGCTATTCCAGTTTATCAAGATTTAGCTCGTCGTATTGGACTTGAGCTCATGTCTAAGGAAGTGAAGCGTGTTGGTTATGGCAATGCAGATATCGGTACCCAAGTCGATAATTTTTGGCTGGTGGGTCCTTTAAAAATTACTCCTCAGCAAGAGGCACAGTTTGCTTACAAGCTAGCTAATAAAACGCTTCCATTTAGCCAAAAAGTCCAAGATGAAGTGCAATCCATGCTATTCATAGAAGAAAAGAATGGAAACAAAATATACGCAAAAAGTGGTTGGGGATGGGATGTAAACCCACAAGTAGGCTGGTTAACTGGATGGGTTGTTCAGCCTCAAGGGAATATTGTAGCGTTCTCCCTTAACTTAGAAATGAAAAAAGGAATACCTAG
368	gb|KF986261|-|44-869|ARO:3001566|OXA-380	ATGAACATTAAAGCACTCTTACTTATAACAAGCGCTATTTTTATTTCAGCCTGC...TAG	825.0	54149	54919	770	825	ATGAACATTAAAGCACTCTTACTTATAACAAGCGCTATTTTTATTTCAGCCTGCTCACCTTATATAGTGACTGCTAATCCAAATCACAGCGCTTCAAAATCTGATGTAAAAGCAGAGAAAATTAAAAATTTATTTAACGAAGCACACACTACGGGTGTTTTAGTTATCCAACAAGGCCAAACTCAACAAAGCTATGGTAATGATCTTGCTCGTGCTTCGACCGAGTATGTACCTGCTTCGACCTTCAAAATGCTTAATGCTTTGATCGGCCTTGAGCACCATAAGGCAACCACCACAGAAGTATTTAAGTGGGATGGTAAAAAAAGGTTATTCCCAGAATGGGAAAAGGACATGACCCTAGGCGATGCCATGAAAGCTTCCGCTATTCCAGTTTATCAAGATTTAGCTCGTCGTATTGGACTTGAGCTCATGTCTAAGGAAGTGAAGCGTGTTGGTTATGGCAATGCAGATATCGGTACCCAAGTCGATAATTTTTGGCTGGTGGGTCCTTTAAAAATTACTCCTCAGCAAGAGGCACAGTTTGCTTACAAGCTAGCTAATAAAACGCTTCCATTTAGCCAAAAAGTCCAAGATGAAGTGCAATCCATGCTATTCATAGAAGAAAAGAATGGAAACAAAATATACGCAAAAAGTGGTTGGGGATGGGATGTAAACCCACAAGTAGGCTGGTTAACTGGATGGGTTGTTCAGCCTCAAGGGAATATTGTAGCGTTCTCCCTTAACTTAGAAATGAAAAAAGGAATACCTAG
369	gb|U36911.1|+|1429-2290|ARO:3000979|TEM-116	ATGAGTATTCAACATTTCCGTGTCGCCCTTATTCCCTTTTTTGCGGCATTTTGC...TAA	861.0	46	852	806	861	ATGAGTATTCAACATTTCCGTGTCGCCCTTATTCCCTTTTTTGCGGCATTTTGCCTTCCTGTTTTTGCTCACCCAGAAACGCTGGTGAAAGTAAAAGATGCTGAAGATCAGTTGGGTGCACGAGTGGGTTACATCGAGCTGGATCTCAACAGCGGTAAGATCCTTGAGAGTTTTCGCCCCGAAGAACGTTTTCCAATGATGAGCACTTTTAAAGTTCTGCTATGTGGTGCGGTATTATCCCGTGTTGACGCCGGGCAAGAGCAACTCGGTCGCCGCATACACTATTCTCAGAATGACTTGGTTGAGTACTCACCAGTCACAGAAAAGCATCTTACGGATGGCATGACAGTAAGAGAATTATGCAGTGCTGCCATAACCATGAGTGATAACACTGCGGCCAACTTACTTCTGACAACGATCGGAGGACCGAAGGAGCTAACCGCTTTTTTGCACAACATGGGGGATCATGTAACCCGCCTTGATCGTTGGGAACCGGAGCTGAATGAAGCCATACCAAACGACGAGCGTGACACCACGATGCCTGCAGCAATGGCAACAACGTTGCGCAAACTATTAACTGGCGAACTACTTACTCTAGCTTCCCGGCAACAATTAATAGACTGGATGGAGGCGGATAAAGTTGCAGGACCACTTCTGCGCTCGGCCCTTCCGGCTGGCTGGTTTATTGCTGATAAATCTGGAGCCGGTGAGCGTGGATCTCGCGGTATCATTGCAGCACTGGGGCCAGATGGTAAGCCCTCCCGTATCGTAGTTATCTACACGACGGGGAGTCAGGCAACTATGGA
370	gb|EU586041|+|0-861|ARO:3001112|SHV-56	ATGCGTTATATTCGCCTGTGTATTATCTCCCTGTTAGCCACCCTGCCGCTGGCG...TAA	861.0	16	822	806	861	ATGCGTTATATTCGCCTGTGTATTATCACCCTGTGAGCCACCCTGCCGCTGGCGGTACACGCCAGCCCGCAGCCGCTTGAGCAAATTAAACAAAGCGAAAGCCAGCTGTCGGGCCGCGTAGGCATGATAGAAATGGATCTGGCCAGCGGCCGCACGCTGACCGCCTGGCGCGCCGATGAACGCTTTCCCATGATGAGCACCTTTAAAGTAGTGCTCTGCGGCGCAGTGCTGGCGCGGGTGGATGCCGGTGACGAACAGCTGGAGCGAAAGATCCACTATCGCCAGCAGGATCTGGTGGACTACTCGCCGGTCAGCGAAAAACACCTTGCCGACGGCATGACGGTCGGCGAACTCTGCGCCGCCGCCATTACCATGAGCGATAACAGCGCCGCCAATCTGCTGCTGGCCACCGTCGGCGGCCCCGCAGGATTGACTGCCTTTTTGCGCCAGATCGGCGACAACGTCACCCGCCTTGACCGCTGGGAAACGGAACTGAATGAGGCGCTTCCCGGCGACGCCCGCGACACCACTACCCCGGCCAGCATGGCCGCGACCCTGCGCAAGCTGCTGACCAGCCAGCGTCTGAGCGCCCGTTCGCAACGGCAGCTGCTGCAGTGGATGGTGGACGATCGGGTCGCCGGACCGTTGATCCGCTCCGTGCTGCCGGCGGGCTGGTTTATCGCCGATAAGACCGGAGCTAGCAAGCGGGGTGCGCGCGGGATTGTCGCCCTGCTTGGCCCGAATAACAAAGCAGAGCGCATTGTGGTGATTTATCTGCGGGATACGCCGGCGAGCATGGCCGAGCG
371	gb|DQ888718|+|0-825|ARO:3001649|OXA-99	ATGAACATTAAAACACTCTTACTTATAACAAGCGCTATTTTTATTTCAGCCTGC...TAG	825.0	54149	54919	770	825	ATGAACATTAAAGCACTCTTACTTATAACAAGCGCTATTTTTATTTCAGCCTGCTCACCTTATATAGTGACTGCTAATCCAAATCACAGCGCTTCAAAATCTGATGTAAAAGCAGAGAAAATTAAAAATTTATTTAACGAAGCACACACTACGGGTGTTTTAGTTATCCAACAAGGCCAAACTCAACAAAGCTATGGTAATGATCTTGCTCGTGCTTCGACCGAGTATGTACCTGCTTCGACCTTCAAAATGCTTAATGCTTTGATCGGCCTTGAGCACCATAAGGCAACCACCACAGAAGTATTTAAGTGGGATGGTAAAAAAAGGTTATTCCCAGAATGGGAAAAGGACATGACCCTAGGCGATGCCATGAAAGCTTCCGCTATTCCAGTTTATCAAGATTTAGCTCGTCGTATTGGACTTGAGCTCATGTCTAAGGAAGTGAAGCGTGTTGGTTATGGCAATGCAGATATCGGTACCCAAGTCGATAATTTTTGGCTGGTGGGTCCTTTAAAAATTACTCCTCAGCAAGAGGCACAGTTTGCTTACAAGCTAGCTAATAAAACGCTTCCATTTAGCCAAAAAGTCCAAGATGAAGTGCAATCCATGCTATTCATAGAAGAAAAGAATGGAAACAAAATATACGCAAAAAGTGGTTGGGGATGGGATGTAAACCCACAAGTAGGCTGGTTAACTGGATGGGTTGTTCAGCCTCAAGGGAATATTGTAGCGTTCTCCCTTAACTTAGAAATGAAAAAAGGAATACCTAG
372	gb|KC866352.1|+|0-1152|ARO:3004493|ADC-68	ATGCGATTTAAAAAAATTTCTTGTCTACTTTTATCCCCGCTTTTTATTTTTAAT...TAA	1152.0	63	1160	1097	1152	ATGCGATTTAAAAAAATTTCTTGTCTACTTTTATCCCCGCTTTTTATTTTTAGTACCTCAATTTATGCGGGCAATACACCAAAAGACCAAGAAATTAAAAAACTGGTAGATCAAAACTTTAAACCGTTATTAGAAAAATATGATGTGCCAGGTATGGCTGTGGGTGTTATTCAAAATAATAAAAAGTATGAAATGTATTATGGTCTTCAATCTGTTCAAGATAAAAAAGCCGTAAATAGCAGTACTATTTTTGAGCTAGGTTCTGTCAGTAAATTATTTACCGCGACAGCAGGTGGATATGCAAAAAATAAAGGAAAAATCTCTTTTGACGATACGCCTGGTAAGTATTGGAAAGAACTAAAAAATACACCGATTGACCAAGTTAACTTACTTCAACTCGCGACGTATACAAGTGGTAACCTTGCCTTGCAATTTCCAGATGAAGTAAAAACAGATCAGCAAGTTTTAACATTTTTTAAAGACTGGAAACCTAAAAACTCAATCGGTGAATATCGACAATATTCAAACCCAAGCATTGGTTTATTTGGAAAAGTTGTAGCTTTGTCTATGAATAAACCTTTCGACCAAGTCTTAGAAAAAACAATTTTTCCGGCCCTTGGCTTAAAACATAGCTATGTAAATGTACCTAAGACCCAGATGCAAAACTATGCTTTTGGCTATAACCAAGAAAATCAGCCGATTCGAGTTAACCCCGGCCCACTCGATGCCCCAGCATATGGCGTCAAATCGACACTACCCGACATGTTGAGTTTTATTCATGCCAACCTAAATCCACAAAAATATCCAGCAGATATTCAACGGGCAATTAATGAAACACATCAGGGTCGCTATCAAGTAAATACCATGTATCAGGCACTCGGTTGGGAAGAGTTTTCTTATCCGGCAACGTTACAAACTTTATTAGACAGTAATTCAGAACAGATTGTGATGAAACCTAATAAAGTGACTGCTATTTCAAAGGAACCTTCAGTTAAGATGTACCATAAAACTGGCTCAACTACCGGTTTCGGAACATATGTGGTGTTTATTCCTAAAGAAAATATTGGTTTAGTCATGTTAACCAATAAACGTATTCC
373	gb|X65254|+|175-1036|ARO:3000887|TEM-16	ATGAGTATTCAACATTTCCGTGTCGCCCTTATTCCCTTTTTTGCGGCATTTTGC...TAA	861.0	46	852	806	861	ATGAGTATTCAACATTTCCGTGTCGCCCTTATTCCCTTTTTTGCGGCATTTTGCCTTCCTGTTTTTGCTCACCCAGAAACGCTGGTGAAAGTAAAAGATGCTGAAGATCAGTTGGGTGCACGAGTGGGTTACATCGAGCTGGATCTCAACAGCGGTAAGATCCTTGAGAGTTTTCGCCCCGAAGAACGTTTTCCAATGATGAGCACTTTTAAAGTTCTGCTATGTGGTGCGGTATTATCCCGTGTTGACGCCGGGCAAGAGCAACTCGGTCGCCGCATACACTATTCTCAGAATGACTTGGTTGAGTACTCACCAGTCACAGAAAAGCATCTTACGGATGGCATGACAGTAAGAGAATTATGCAGTGCTGCCATAACCATGAGTGATAACACTGCGGCCAACTTACTTCTGACAACGATCGGAGGACCGAAGGAGCTAACCGCTTTTTTGCACAACATGGGGGATCATGTAACCCGCCTTGATCGTTGGGAACCGGAGCTGAATGAAGCCATACCAAACGACGAGCGTGACACCACGATGCCTGCAGCAATGGCAACAACGTTGCGCAAACTATTAACTGGCGAACTACTTACTCTAGCTTCCCGGCAACAATTAATAGACTGGATGGAGGCGGATAAAGTTGCAGGACCACTTCTGCGCTCGGCCCTTCCGGCTGGCTGGTTTATTGCTGATAAATCTGGAGCCGGTGAGCGTGGATCTCGCGGTATCATTGCAGCACTGGGGCCAGATGGTAAGCCCTCCCGTATCGTAGTTATCTACACGACGGGGAGTCAGGCAACTATGGA
374	gb|AY130282|+|0-764|ARO:3000980|TEM-117  Partial			82	791	709	764	TTTTTTGCGGCATTTTGCCTTCCTGTTTTTGCTCACCCAGAAACGCTGGTGAAAGTAAAAGATGCTGAAGATCAGTTGGGTGCACGAGTGGGTTACATCGAGCTGGATCTCAACAGCGGTAAGATCCTTGAGAGTTTTCGCCCCGAAGAACGTTTTCCAATGATGAGCACTTTTAAAGTTCTGCTATGTGGTGCGGTATTATCCCGTGTTGACGCCGGGCAAGAGCAACTCGGTCGCCGCATACACTATTCTCAGAATGACTTGGTTGAGTACTCACCAGTCACAGAAAAGCATCTTACGGATGGCATGACAGTAAGAGAATTATGCAGTGCTGCCATAACCATGAGTGATAACACTGCGGCCAACTTACTTCTGACAACGATCGGAGGACCGAAGGAGCTAACCGCTTTTTTGCACAACATGGGGGATCATGTAACCCGCCTTGATCGTTGGGAACCGGAGCTGAATGAAGCCATACCAAACGACGAGCGTGACACCACGATGCCTGCAGCAATGGCAACAACGTTGCGCAAACTATTAACTGGCGAACTACTTACTCTAGCTTCCCGGCAACAATTAATAGACTGGATGGAGGCGGATAAAGTTGCAGGACCACTTCTGCGCTCGGCCCTTCCGGCTGGCTGGTTTATTGCTGATAAATCTGGAGCCGGTGAGCGTGGATCTCGCGGTATCATTGCAGCACTGGGGC
375	gb|JN603240|+|0-825|ARO:3001489|OXA-217	ATGAACATTAAAGCACTCTTACTTATAACAAGCGCTATTTTTATTTCAGCCTGC...TAG	825.0	54149	54919	770	825	ATGAACATTAAAGCACTCTTACTTATAACAAGCGCTATTTTTATTTCAGCCTGCTCACCTTATATAGTGACTGCTAATCCAAATCACAGCGCTTCAAAATCTGATGTAAAAGCAGAGAAAATTAAAAATTTATTTAACGAAGCACACACTACGGGTGTTTTAGTTATCCAACAAGGCCAAACTCAACAAAGCTATGGTAATGATCTTGCTCGTGCTTCGACCGAGTATGTACCTGCTTCGACCTTCAAAATGCTTAATGCTTTGATCGGCCTTGAGCACCATAAGGCAACCACCACAGAAGTATTTAAGTGGGATGGTAAAAAAAGGTTATTCCCAGAATGGGAAAAGGACATGACCCTAGGCGATGCCATGAAAGCTTCCGCTATTCCAGTTTATCAAGATTTAGCTCGTCGTATTGGACTTGAGCTCATGTCTAAGGAAGTGAAGCGTGTTGGTTATGGCAATGCAGATATCGGTACCCAAGTCGATAATTTTTGGCTGGTGGGTCCTTTAAAAATTACTCCTCAGCAAGAGGCACAGTTTGCTTACAAGCTAGCTAATAAAACGCTTCCATTTAGCCAAAAAGTCCAAGATGAAGTGCAATCCATGCTATTCATAGAAGAAAAGAATGGAAACAAAATATACGCAAAAAGTGGTTGGGGATGGGATGTAAACCCACAAGTAGGCTGGTTAACTGGATGGGTTGTTCAGCCTCAAGGGAATATTGTAGCGTTCTCCCTTAACTTAGAAATGAAAAAAGGAATACCTAG
376	gb|AY130285|+|0-785|ARO:3000981|TEM-118  Partial			82	812	730	785	TTTTTTGCGGCATTTTGCCTTCCTGTTTTTGCTCACCCAGAAACGCTGGTGAAAGTAAAAGATGCTGAAGATCAGTTGGGTGCACGAGTGGGTTACATCGAGCTGGATCTCAACAGCGGTAAGATCCTTGAGAGTTTTCGCCCCGAAGAACGTTTTCCAATGATGAGCACTTTTAAAGTTCTGCTATGTGGTGCGGTATTATCCCGTGTTGACGCCGGGCAAGAGCAACTCGGTCGCCGCATACACTATTCTCAGAATGACTTGGTTGAGTACTCACCAGTCACAGAAAAGCATCTTACGGATGGCATGACAGTAAGAGAATTATGCAGTGCTGCCATAACCATGAGTGATAACACTGCGGCCAACTTACTTCTGACAACGATCGGAGGACCGAAGGAGCTAACCGCTTTTTTGCACAACATGGGGGATCATGTAACCCGCCTTGATCGTTGGGAACCGGAGCTGAATGAAGCCATACCAAACGACGAGCGTGACACCACGATGCCTGCAGCAATGGCAACAACGTTGCGCAAACTATTAACTGGCGAACTACTTACTCTAGCTTCCCGGCAACAATTAATAGACTGGATGGAGGCGGATAAAGTTGCAGGACCACTTCTGCGCTCGGCCCTTCCGGCTGGCTGGTTTATTGCTGATAAATCTGGAGCCGGTGAGCGTGGATCTCGCGGTATCATTGCAGCACTGGGGCCAGATGGTAAGCCCTCCCGTA
377	gb|M88143|+|367-1228|ARO:3000884|TEM-12	ATGAGTATTCAACATTTCCGTGTCGCCCTTATTCCCTTTTTTGCGGCATTTTGC...TAA	861.0	46	852	806	861	ATGAGTATTCAACATTTCCGTGTCGCCCTTATTCCCTTTTTTGCGGCATTTTGCCTTCCTGTTTTTGCTCACCCAGAAACGCTGGTGAAAGTAAAAGATGCTGAAGATCAGTTGGGTGCACGAGTGGGTTACATCGAGCTGGATCTCAACAGCGGTAAGATCCTTGAGAGTTTTCGCCCCGAAGAACGTTTTCCAATGATGAGCACTTTTAAAGTTCTGCTATGTGGTGCGGTATTATCCCGTGTTGACGCCGGGCAAGAGCAACTCGGTCGCCGCATACACTATTCTCAGAATGACTTGGTTGAGTACTCACCAGTCACAGAAAAGCATCTTACGGATGGCATGACAGTAAGAGAATTATGCAGTGCTGCCATAACCATGAGTGATAACACTGCGGCCAACTTACTTCTGACAACGATCGGAGGACCGAAGGAGCTAACCGCTTTTTTGCACAACATGGGGGATCATGTAACCCGCCTTGATCGTTGGGAACCGGAGCTGAATGAAGCCATACCAAACGACGAGCGTGACACCACGATGCCTGCAGCAATGGCAACAACGTTGCGCAAACTATTAACTGGCGAACTACTTACTCTAGCTTCCCGGCAACAATTAATAGACTGGATGGAGGCGGATAAAGTTGCAGGACCACTTCTGCGCTCGGCCCTTCCGGCTGGCTGGTTTATTGCTGATAAATCTGGAGCCGGTGAGCGTGGATCTCGCGGTATCATTGCAGCACTGGGGCCAGATGGTAAGCCCTCCCGTATCGTAGTTATCTACACGACGGGGAGTCAGGCAACTATGGA
378	gb|EF136377|+|0-861|ARO:3001026|TEM-160	ATGAGTATTCAACATTTCCGTGTCGCCCTTATTCCCTTTTTTGCGGCATTTTGC...TAA	861.0	46	852	806	861	ATGAGTATTCAACATTTCCGTGTCGCCCTTATTCCCTTTTTTGCGGCATTTTGCCTTCCTGTTTTTGCTCACCCAGAAACGCTGGTGAAAGTAAAAGATGCTGAAGATCAGTTGGGTGCACGAGTGGGTTACATCGAGCTGGATCTCAACAGCGGTAAGATCCTTGAGAGTTTTCGCCCCGAAGAACGTTTTCCAATGATGAGCACTTTTAAAGTTCTGCTATGTGGTGCGGTATTATCCCGTGTTGACGCCGGGCAAGAGCAACTCGGTCGCCGCATACACTATTCTCAGAATGACTTGGTTGAGTACTCACCAGTCACAGAAAAGCATCTTACGGATGGCATGACAGTAAGAGAATTATGCAGTGCTGCCATAACCATGAGTGATAACACTGCGGCCAACTTACTTCTGACAACGATCGGAGGACCGAAGGAGCTAACCGCTTTTTTGCACAACATGGGGGATCATGTAACCCGCCTTGATCGTTGGGAACCGGAGCTGAATGAAGCCATACCAAACGACGAGCGTGACACCACGATGCCTGCAGCAATGGCAACAACGTTGCGCAAACTATTAACTGGCGAACTACTTACTCTAGCTTCCCGGCAACAATTAATAGACTGGATGGAGGCGGATAAAGTTGCAGGACCACTTCTGCGCTCGGCCCTTCCGGCTGGCTGGTTTATTGCTGATAAATCTGGAGCCGGTGAGCGTGGATCTCGCGGTATCATTGCAGCACTGGGGCCAGATGGTAAGCCCTCCCGTATCGTAGTTATCTACACGACGGGGAGTCAGGCAACTATGGA
379	gb|AY223863|+|170-1031|ARO:3001113|SHV-57	ATGCGTTATATTCGCCTGTGTATTATCTCCCTGTTAGCCACCCTGCCGCTGGCG...TAA	861.0	16	822	806	861	ATGCGTTATATTCGCCTGTGTATTATCACCCTGTGAGCCACCCTGCCGCTGGCGGTACACGCCAGCCCGCAGCCGCTTGAGCAAATTAAACAAAGCGAAAGCCAGCTGTCGGGCCGCGTAGGCATGATAGAAATGGATCTGGCCAGCGGCCGCACGCTGACCGCCTGGCGCGCCGATGAACGCTTTCCCATGATGAGCACCTTTAAAGTAGTGCTCTGCGGCGCAGTGCTGGCGCGGGTGGATGCCGGTGACGAACAGCTGGAGCGAAAGATCCACTATCGCCAGCAGGATCTGGTGGACTACTCGCCGGTCAGCGAAAAACACCTTGCCGACGGCATGACGGTCGGCGAACTCTGCGCCGCCGCCATTACCATGAGCGATAACAGCGCCGCCAATCTGCTGCTGGCCACCGTCGGCGGCCCCGCAGGATTGACTGCCTTTTTGCGCCAGATCGGCGACAACGTCACCCGCCTTGACCGCTGGGAAACGGAACTGAATGAGGCGCTTCCCGGCGACGCCCGCGACACCACTACCCCGGCCAGCATGGCCGCGACCCTGCGCAAGCTGCTGACCAGCCAGCGTCTGAGCGCCCGTTCGCAACGGCAGCTGCTGCAGTGGATGGTGGACGATCGGGTCGCCGGACCGTTGATCCGCTCCGTGCTGCCGGCGGGCTGGTTTATCGCCGATAAGACCGGAGCTAGCAAGCGGGGTGCGCGCGGGATTGTCGCCCTGCTTGGCCCGAATAACAAAGCAGAGCGCATTGTGGTGATTTATCTGCGGGATACGCCGGCGAGCATGGCCGAGCG
380	gb|JN215211|+|0-825|ARO:3001668|OXA-219	ATGAACATTAAAACACTCTTACTTATAACAAGCGCTATTTTTATTTCAGCCTGC...TAG	825.0	54149	54919	770	825	ATGAACATTAAAGCACTCTTACTTATAACAAGCGCTATTTTTATTTCAGCCTGCTCACCTTATATAGTGACTGCTAATCCAAATCACAGCGCTTCAAAATCTGATGTAAAAGCAGAGAAAATTAAAAATTTATTTAACGAAGCACACACTACGGGTGTTTTAGTTATCCAACAAGGCCAAACTCAACAAAGCTATGGTAATGATCTTGCTCGTGCTTCGACCGAGTATGTACCTGCTTCGACCTTCAAAATGCTTAATGCTTTGATCGGCCTTGAGCACCATAAGGCAACCACCACAGAAGTATTTAAGTGGGATGGTAAAAAAAGGTTATTCCCAGAATGGGAAAAGGACATGACCCTAGGCGATGCCATGAAAGCTTCCGCTATTCCAGTTTATCAAGATTTAGCTCGTCGTATTGGACTTGAGCTCATGTCTAAGGAAGTGAAGCGTGTTGGTTATGGCAATGCAGATATCGGTACCCAAGTCGATAATTTTTGGCTGGTGGGTCCTTTAAAAATTACTCCTCAGCAAGAGGCACAGTTTGCTTACAAGCTAGCTAATAAAACGCTTCCATTTAGCCAAAAAGTCCAAGATGAAGTGCAATCCATGCTATTCATAGAAGAAAAGAATGGAAACAAAATATACGCAAAAAGTGGTTGGGGATGGGATGTAAACCCACAAGTAGGCTGGTTAACTGGATGGGTTGTTCAGCCTCAAGGGAATATTGTAGCGTTCTCCCTTAACTTAGAAATGAAAAAAGGAATACCTAG
381	gb|AY243512|+|208-1069|ARO:3000982|TEM-120	ATGAGTATTCAACATTTCCGTGTCGCCCTTATTCCCTTTTTTGCGGCATTTTGC...TAA	861.0	46	852	806	861	ATGAGTATTCAACATTTCCGTGTCGCCCTTATTCCCTTTTTTGCGGCATTTTGCCTTCCTGTTTTTGCTCACCCAGAAACGCTGGTGAAAGTAAAAGATGCTGAAGATCAGTTGGGTGCACGAGTGGGTTACATCGAGCTGGATCTCAACAGCGGTAAGATCCTTGAGAGTTTTCGCCCCGAAGAACGTTTTCCAATGATGAGCACTTTTAAAGTTCTGCTATGTGGTGCGGTATTATCCCGTGTTGACGCCGGGCAAGAGCAACTCGGTCGCCGCATACACTATTCTCAGAATGACTTGGTTGAGTACTCACCAGTCACAGAAAAGCATCTTACGGATGGCATGACAGTAAGAGAATTATGCAGTGCTGCCATAACCATGAGTGATAACACTGCGGCCAACTTACTTCTGACAACGATCGGAGGACCGAAGGAGCTAACCGCTTTTTTGCACAACATGGGGGATCATGTAACCCGCCTTGATCGTTGGGAACCGGAGCTGAATGAAGCCATACCAAACGACGAGCGTGACACCACGATGCCTGCAGCAATGGCAACAACGTTGCGCAAACTATTAACTGGCGAACTACTTACTCTAGCTTCCCGGCAACAATTAATAGACTGGATGGAGGCGGATAAAGTTGCAGGACCACTTCTGCGCTCGGCCCTTCCGGCTGGCTGGTTTATTGCTGATAAATCTGGAGCCGGTGAGCGTGGATCTCGCGGTATCATTGCAGCACTGGGGCCAGATGGTAAGCCCTCCCGTATCGTAGTTATCTACACGACGGGGAGTCAGGCAACTATGGA
382	gb|KR057753.1|+|0-1116|ARO:3004347|PDC-84	GGCGAGGCCCCGGCGGATCGCCTGAAGGCATTGGTCGACGCCGCCGTACAACCG...TGA	1116.0	35594	36652	1058	1116	GAGGCCCCGGCGGATCGCCTGAAGGCACTGGTCGACGCCGCCGTACAACCGGTGATGAAGGCCAATGACATTCCGGGCCTGGCCGTAGCCATCAGCCTGAAAGGAGAACCGCATTACTTCAGCTATGGGCTGGCCTCGAAAGAGGACGGCCGCCGGGTGACGCCGGAGACCCTGTTCGAGATCGGCTCGGTGAGCAAGACCTTCACCGTCACCCTCGCCGGCTATGCCCTGGCCCAGGACAAGATGCGCCTCGACGACCGCGCCAGCCAGCACTGGCCGGCACTGCAGGGCAGCCGCTTCGACGGCATCAGCCTGCTCGACCTCGCGACCTATACCGCCGGCGGCTTGCCGCTGCAGTTCCCCGACTCGGTGCAGAAGGACCAGGCACAGATCCGCGACTACTACCGCCAGTGGCAGCCGACCTACGCGCCGGGCAGCCAGCGCCTCTATTCCAACCCGAGCATCGGCCTGTTCGGCTATCTCGCCGCGCGCAGCCTGGGCCAGCCGTTCGAACGGCTCATGGAGCAGCAATTGTTCCCGGCACTGGGCCTCGAACAGACCCACCTCGACGTGCCCGAGGCGGCGCTGGCGCAGTACGCCCAGGGCTACGGCAAGGACGACCGCCCGCTACGGGTCGGTCCCGGCCCGCTGGATGCCGAAGGCTACGGGGTGAAGACCAGCGCGGCCGACCTGCTGCGCTTCGTCGATGCCAACCTGCATCCGGAGCGCCTGGACAGGCCCTGGGCGCAGGCGCTCGATGCCACCCATCGCGGTTACTACAAGGTCGGCGACATGACCCAGGGCCTGGGCTGGGAAGCCTACGACTGGCCGATCTCCCTGAAGCGCCTGCAGGCCGGCAACTCGACGCCGATGGCGCTGCAACCACACAGGATCGCCAGGCTGCCCGCGCCACAGGCGCTGGAGGGCCAGCGCCTGCTGAACAAGACCGGCTCCACCAACGGCTTCGGCGCCTACGTGGCGTTCGTCCCGGGCCGCGACCTGGGCCTGGTGATCCTGGCCAACCGCAACTATCCCAATGCCGAGCGGGTGAAGATCGC
383	gb|KJ135344|+|14-839|ARO:3001567|OXA-381	ATGAACATTAAAGCACTCTTACTTATAACAAGCGCTATTTTTATTTCAGCCTGC...TAG	825.0	54149	54919	770	825	ATGAACATTAAAGCACTCTTACTTATAACAAGCGCTATTTTTATTTCAGCCTGCTCACCTTATATAGTGACTGCTAATCCAAATCACAGCGCTTCAAAATCTGATGTAAAAGCAGAGAAAATTAAAAATTTATTTAACGAAGCACACACTACGGGTGTTTTAGTTATCCAACAAGGCCAAACTCAACAAAGCTATGGTAATGATCTTGCTCGTGCTTCGACCGAGTATGTACCTGCTTCGACCTTCAAAATGCTTAATGCTTTGATCGGCCTTGAGCACCATAAGGCAACCACCACAGAAGTATTTAAGTGGGATGGTAAAAAAAGGTTATTCCCAGAATGGGAAAAGGACATGACCCTAGGCGATGCCATGAAAGCTTCCGCTATTCCAGTTTATCAAGATTTAGCTCGTCGTATTGGACTTGAGCTCATGTCTAAGGAAGTGAAGCGTGTTGGTTATGGCAATGCAGATATCGGTACCCAAGTCGATAATTTTTGGCTGGTGGGTCCTTTAAAAATTACTCCTCAGCAAGAGGCACAGTTTGCTTACAAGCTAGCTAATAAAACGCTTCCATTTAGCCAAAAAGTCCAAGATGAAGTGCAATCCATGCTATTCATAGAAGAAAAGAATGGAAACAAAATATACGCAAAAAGTGGTTGGGGATGGGATGTAAACCCACAAGTAGGCTGGTTAACTGGATGGGTTGTTCAGCCTCAAGGGAATATTGTAGCGTTCTCCCTTAACTTAGAAATGAAAAAAGGAATACCTAG
384	gb|AY271267|+|0-861|ARO:3000983|TEM-121	ATGAGTATTCAACATTTCCGTGTCGCCCTTATTCCCTTTTTTGCGGCATTTTGC...TAA	861.0	46	852	806	861	ATGAGTATTCAACATTTCCGTGTCGCCCTTATTCCCTTTTTTGCGGCATTTTGCCTTCCTGTTTTTGCTCACCCAGAAACGCTGGTGAAAGTAAAAGATGCTGAAGATCAGTTGGGTGCACGAGTGGGTTACATCGAGCTGGATCTCAACAGCGGTAAGATCCTTGAGAGTTTTCGCCCCGAAGAACGTTTTCCAATGATGAGCACTTTTAAAGTTCTGCTATGTGGTGCGGTATTATCCCGTGTTGACGCCGGGCAAGAGCAACTCGGTCGCCGCATACACTATTCTCAGAATGACTTGGTTGAGTACTCACCAGTCACAGAAAAGCATCTTACGGATGGCATGACAGTAAGAGAATTATGCAGTGCTGCCATAACCATGAGTGATAACACTGCGGCCAACTTACTTCTGACAACGATCGGAGGACCGAAGGAGCTAACCGCTTTTTTGCACAACATGGGGGATCATGTAACCCGCCTTGATCGTTGGGAACCGGAGCTGAATGAAGCCATACCAAACGACGAGCGTGACACCACGATGCCTGCAGCAATGGCAACAACGTTGCGCAAACTATTAACTGGCGAACTACTTACTCTAGCTTCCCGGCAACAATTAATAGACTGGATGGAGGCGGATAAAGTTGCAGGACCACTTCTGCGCTCGGCCCTTCCGGCTGGCTGGTTTATTGCTGATAAATCTGGAGCCGGTGAGCGTGGATCTCGCGGTATCATTGCAGCACTGGGGCCAGATGGTAAGCCCTCCCGTATCGTAGTTATCTACACGACGGGGAGTCAGGCAACTATGGA
385	gb|JN248564|+|0-825|ARO:3001669|OXA-223	ATGAACATTAAAACACTCTTACTTATAACAAGCGCTATTTTTATTTCAGCCTGC...TAG	825.0	54149	54919	770	825	ATGAACATTAAAGCACTCTTACTTATAACAAGCGCTATTTTTATTTCAGCCTGCTCACCTTATATAGTGACTGCTAATCCAAATCACAGCGCTTCAAAATCTGATGTAAAAGCAGAGAAAATTAAAAATTTATTTAACGAAGCACACACTACGGGTGTTTTAGTTATCCAACAAGGCCAAACTCAACAAAGCTATGGTAATGATCTTGCTCGTGCTTCGACCGAGTATGTACCTGCTTCGACCTTCAAAATGCTTAATGCTTTGATCGGCCTTGAGCACCATAAGGCAACCACCACAGAAGTATTTAAGTGGGATGGTAAAAAAAGGTTATTCCCAGAATGGGAAAAGGACATGACCCTAGGCGATGCCATGAAAGCTTCCGCTATTCCAGTTTATCAAGATTTAGCTCGTCGTATTGGACTTGAGCTCATGTCTAAGGAAGTGAAGCGTGTTGGTTATGGCAATGCAGATATCGGTACCCAAGTCGATAATTTTTGGCTGGTGGGTCCTTTAAAAATTACTCCTCAGCAAGAGGCACAGTTTGCTTACAAGCTAGCTAATAAAACGCTTCCATTTAGCCAAAAAGTCCAAGATGAAGTGCAATCCATGCTATTCATAGAAGAAAAGAATGGAAACAAAATATACGCAAAAAGTGGTTGGGGATGGGATGTAAACCCACAAGTAGGCTGGTTAACTGGATGGGTTGTTCAGCCTCAAGGGAATATTGTAGCGTTCTCCCTTAACTTAGAAATGAAAAAAGGAATACCTAG
386	gb|AY790341|+|0-861|ARO:3001114|SHV-59	ATGCGTTATATTCGCCTGTGTATTATCTCCCTGTTAGCCACCCTGCCGCTGGCG...TAA	861.0	16	822	806	861	ATGCGTTATATTCGCCTGTGTATTATCACCCTGTGAGCCACCCTGCCGCTGGCGGTACACGCCAGCCCGCAGCCGCTTGAGCAAATTAAACAAAGCGAAAGCCAGCTGTCGGGCCGCGTAGGCATGATAGAAATGGATCTGGCCAGCGGCCGCACGCTGACCGCCTGGCGCGCCGATGAACGCTTTCCCATGATGAGCACCTTTAAAGTAGTGCTCTGCGGCGCAGTGCTGGCGCGGGTGGATGCCGGTGACGAACAGCTGGAGCGAAAGATCCACTATCGCCAGCAGGATCTGGTGGACTACTCGCCGGTCAGCGAAAAACACCTTGCCGACGGCATGACGGTCGGCGAACTCTGCGCCGCCGCCATTACCATGAGCGATAACAGCGCCGCCAATCTGCTGCTGGCCACCGTCGGCGGCCCCGCAGGATTGACTGCCTTTTTGCGCCAGATCGGCGACAACGTCACCCGCCTTGACCGCTGGGAAACGGAACTGAATGAGGCGCTTCCCGGCGACGCCCGCGACACCACTACCCCGGCCAGCATGGCCGCGACCCTGCGCAAGCTGCTGACCAGCCAGCGTCTGAGCGCCCGTTCGCAACGGCAGCTGCTGCAGTGGATGGTGGACGATCGGGTCGCCGGACCGTTGATCCGCTCCGTGCTGCCGGCGGGCTGGTTTATCGCCGATAAGACCGGAGCTAGCAAGCGGGGTGCGCGCGGGATTGTCGCCCTGCTTGGCCCGAATAACAAAGCAGAGCGCATTGTGGTGATTTATCTGCGGGATACGCCGGCGAGCATGGCCGAGCG
387	gb|AY307100|+|0-861|ARO:3000984|TEM-122	ATGAGTATTCAACATTTCCGTGTCGCCCTTATTCCCTTTTTTGCGGCATTTTGC...TAA	861.0	46	852	806	861	ATGAGTATTCAACATTTCCGTGTCGCCCTTATTCCCTTTTTTGCGGCATTTTGCCTTCCTGTTTTTGCTCACCCAGAAACGCTGGTGAAAGTAAAAGATGCTGAAGATCAGTTGGGTGCACGAGTGGGTTACATCGAGCTGGATCTCAACAGCGGTAAGATCCTTGAGAGTTTTCGCCCCGAAGAACGTTTTCCAATGATGAGCACTTTTAAAGTTCTGCTATGTGGTGCGGTATTATCCCGTGTTGACGCCGGGCAAGAGCAACTCGGTCGCCGCATACACTATTCTCAGAATGACTTGGTTGAGTACTCACCAGTCACAGAAAAGCATCTTACGGATGGCATGACAGTAAGAGAATTATGCAGTGCTGCCATAACCATGAGTGATAACACTGCGGCCAACTTACTTCTGACAACGATCGGAGGACCGAAGGAGCTAACCGCTTTTTTGCACAACATGGGGGATCATGTAACCCGCCTTGATCGTTGGGAACCGGAGCTGAATGAAGCCATACCAAACGACGAGCGTGACACCACGATGCCTGCAGCAATGGCAACAACGTTGCGCAAACTATTAACTGGCGAACTACTTACTCTAGCTTCCCGGCAACAATTAATAGACTGGATGGAGGCGGATAAAGTTGCAGGACCACTTCTGCGCTCGGCCCTTCCGGCTGGCTGGTTTATTGCTGATAAATCTGGAGCCGGTGAGCGTGGATCTCGCGGTATCATTGCAGCACTGGGGCCAGATGGTAAGCCCTCCCGTATCGTAGTTATCTACACGACGGGGAGTCAGGCAACTATGGA
388	gb|JN638887|+|0-822|ARO:3001493|OXA-225	ATGAATAAATATTTTACTTGCTATGTGGTTGCTTCTCTTTTTCTTTCTGGTTGT...TAA	822.0	80	847	767	822	ATGAATAAATATTTTACTTGCTATGTGGTTGCTTCTCTTTTTCTTTCTGGTTGTACGGTTCAGCATAATTTAATAAATGAAACCCCGAGTCAGATTGTTCAAGGACATAATCAGGTGATTCATCAATACTTTGATGAAAAAAACACCTCAGGTGTGCTGGTTATTCAAACAGATAAAAAAATTAATCTATATGGTAATGCTCTAAGCCGCGCAAATACAGAATATGTGCCAGCCTCTACATTTAAAATGTTGAATGCCCTGATCGGATTGGAGAACCAGAAAACGGATATTAATGAAATATTTAAATGGAAGGGCGAGAAAAGGTCATTTACCGCTTGGGAAAAAGACATGACACTAGGAGAAGCCATGAAGCTTTCTGCAGTCCCAGTCTATCAGGAACTTGCGCGACGTATCGGTCTTGATCTCATGCAAAAAGAAGTAAAACGTATTGGTTTCGGTAATGCTGAAATTGGACAGCAGGTTGATAATTTCTGGTTGGTAGGACCATTAAAGGTTACGCCTATTCAAGAGGTAGAGTTTGTTTCCCAATTAGCACATACACAGCTTCCATTTAGTGAAAAAGTGCAGGCTAATGTAAAAAATATGCTTCTTTTAGAAGAGAGTAATGGCTACAAAATTTTTGGAAAGACTGGTTGGGCAATGGATATAAAACCACAAGTGGGCTGGTTGACCGGCTGGGTTGAGCAGCCAGATGGAAAAATTGTCGCTTTTGCATTAAATATGGAAATGCGGTCAGAAATGCCGGC
389	gb|KM114268|+|0-861|ARO:3003157|TEM-219	ATGAGTATTCAACATTTTCGTGTCGCCCTTATTCCCTTTTTTGCGGCATTTTGC...TAA	861.0	46	852	806	861	ATGAGTATTCAACATTTCCGTGTCGCCCTTATTCCCTTTTTTGCGGCATTTTGCCTTCCTGTTTTTGCTCACCCAGAAACGCTGGTGAAAGTAAAAGATGCTGAAGATCAGTTGGGTGCACGAGTGGGTTACATCGAGCTGGATCTCAACAGCGGTAAGATCCTTGAGAGTTTTCGCCCCGAAGAACGTTTTCCAATGATGAGCACTTTTAAAGTTCTGCTATGTGGTGCGGTATTATCCCGTGTTGACGCCGGGCAAGAGCAACTCGGTCGCCGCATACACTATTCTCAGAATGACTTGGTTGAGTACTCACCAGTCACAGAAAAGCATCTTACGGATGGCATGACAGTAAGAGAATTATGCAGTGCTGCCATAACCATGAGTGATAACACTGCGGCCAACTTACTTCTGACAACGATCGGAGGACCGAAGGAGCTAACCGCTTTTTTGCACAACATGGGGGATCATGTAACCCGCCTTGATCGTTGGGAACCGGAGCTGAATGAAGCCATACCAAACGACGAGCGTGACACCACGATGCCTGCAGCAATGGCAACAACGTTGCGCAAACTATTAACTGGCGAACTACTTACTCTAGCTTCCCGGCAACAATTAATAGACTGGATGGAGGCGGATAAAGTTGCAGGACCACTTCTGCGCTCGGCCCTTCCGGCTGGCTGGTTTATTGCTGATAAATCTGGAGCCGGTGAGCGTGGATCTCGCGGTATCATTGCAGCACTGGGGCCAGATGGTAAGCCCTCCCGTATCGTAGTTATCTACACGACGGGGAGTCAGGCAACTATGGA
390	gb|EF468463|+|66-927|ARO:3001028|TEM-162	ATGAGTATTCAACATTTCCGTGTCGCCCTTATTCCCTTTTTTGCGGCTTTTTGC...TAA	861.0	46	852	806	861	ATGAGTATTCAACATTTCCGTGTCGCCCTTATTCCCTTTTTTGCGGCATTTTGCCTTCCTGTTTTTGCTCACCCAGAAACGCTGGTGAAAGTAAAAGATGCTGAAGATCAGTTGGGTGCACGAGTGGGTTACATCGAGCTGGATCTCAACAGCGGTAAGATCCTTGAGAGTTTTCGCCCCGAAGAACGTTTTCCAATGATGAGCACTTTTAAAGTTCTGCTATGTGGTGCGGTATTATCCCGTGTTGACGCCGGGCAAGAGCAACTCGGTCGCCGCATACACTATTCTCAGAATGACTTGGTTGAGTACTCACCAGTCACAGAAAAGCATCTTACGGATGGCATGACAGTAAGAGAATTATGCAGTGCTGCCATAACCATGAGTGATAACACTGCGGCCAACTTACTTCTGACAACGATCGGAGGACCGAAGGAGCTAACCGCTTTTTTGCACAACATGGGGGATCATGTAACCCGCCTTGATCGTTGGGAACCGGAGCTGAATGAAGCCATACCAAACGACGAGCGTGACACCACGATGCCTGCAGCAATGGCAACAACGTTGCGCAAACTATTAACTGGCGAACTACTTACTCTAGCTTCCCGGCAACAATTAATAGACTGGATGGAGGCGGATAAAGTTGCAGGACCACTTCTGCGCTCGGCCCTTCCGGCTGGCTGGTTTATTGCTGATAAATCTGGAGCCGGTGAGCGTGGATCTCGCGGTATCATTGCAGCACTGGGGCCAGATGGTAAGCCCTCCCGTATCGTAGTTATCTACACGACGGGGAGTCAGGCAACTATGGA
391	gb|AY795964|+|0-822|ARO:3001418|OXA-23	ATGAATAAATATTTTACTTGCTATGTGGTTGCTTCTCTTTTTCTTTCTGGTTGT...TAA	822.0	80	847	767	822	ATGAATAAATATTTTACTTGCTATGTGGTTGCTTCTCTTTTTCTTTCTGGTTGTACGGTTCAGCATAATTTAATAAATGAAACCCCGAGTCAGATTGTTCAAGGACATAATCAGGTGATTCATCAATACTTTGATGAAAAAAACACCTCAGGTGTGCTGGTTATTCAAACAGATAAAAAAATTAATCTATATGGTAATGCTCTAAGCCGCGCAAATACAGAATATGTGCCAGCCTCTACATTTAAAATGTTGAATGCCCTGATCGGATTGGAGAACCAGAAAACGGATATTAATGAAATATTTAAATGGAAGGGCGAGAAAAGGTCATTTACCGCTTGGGAAAAAGACATGACACTAGGAGAAGCCATGAAGCTTTCTGCAGTCCCAGTCTATCAGGAACTTGCGCGACGTATCGGTCTTGATCTCATGCAAAAAGAAGTAAAACGTATTGGTTTCGGTAATGCTGAAATTGGACAGCAGGTTGATAATTTCTGGTTGGTAGGACCATTAAAGGTTACGCCTATTCAAGAGGTAGAGTTTGTTTCCCAATTAGCACATACACAGCTTCCATTTAGTGAAAAAGTGCAGGCTAATGTAAAAAATATGCTTCTTTTAGAAGAGAGTAATGGCTACAAAATTTTTGGAAAGACTGGTTGGGCAATGGATATAAAACCACAAGTGGGCTGGTTGACCGGCTGGGTTGAGCAGCCAGATGGAAAAATTGTCGCTTTTGCATTAAATATGGAAATGCGGTCAGAAATGCCGGC
392	gb|KJ135345|+|14-839|ARO:3001568|OXA-382	ATGAACATTAAAGCACTCTTACTTATAACAAGCGCTATTTTTATTTCAGCCTGC...TAG	825.0	54149	54919	770	825	ATGAACATTAAAGCACTCTTACTTATAACAAGCGCTATTTTTATTTCAGCCTGCTCACCTTATATAGTGACTGCTAATCCAAATCACAGCGCTTCAAAATCTGATGTAAAAGCAGAGAAAATTAAAAATTTATTTAACGAAGCACACACTACGGGTGTTTTAGTTATCCAACAAGGCCAAACTCAACAAAGCTATGGTAATGATCTTGCTCGTGCTTCGACCGAGTATGTACCTGCTTCGACCTTCAAAATGCTTAATGCTTTGATCGGCCTTGAGCACCATAAGGCAACCACCACAGAAGTATTTAAGTGGGATGGTAAAAAAAGGTTATTCCCAGAATGGGAAAAGGACATGACCCTAGGCGATGCCATGAAAGCTTCCGCTATTCCAGTTTATCAAGATTTAGCTCGTCGTATTGGACTTGAGCTCATGTCTAAGGAAGTGAAGCGTGTTGGTTATGGCAATGCAGATATCGGTACCCAAGTCGATAATTTTTGGCTGGTGGGTCCTTTAAAAATTACTCCTCAGCAAGAGGCACAGTTTGCTTACAAGCTAGCTAATAAAACGCTTCCATTTAGCCAAAAAGTCCAAGATGAAGTGCAATCCATGCTATTCATAGAAGAAAAGAATGGAAACAAAATATACGCAAAAAGTGGTTGGGGATGGGATGTAAACCCACAAGTAGGCTGGTTAACTGGATGGGTTGTTCAGCCTCAAGGGAATATTGTAGCGTTCTCCCTTAACTTAGAAATGAAAAAAGGAATACCTAG
393	gb|Y17583|+|213-1071|ARO:3000893|TEM-22	ATGAGTATTCAACATTTCCGTGTCGCCCTTATTCCCTTTTTTGCGGCATTTTGC...TGG	858.0	46	849	803	858	ATGAGTATTCAACATTTCCGTGTCGCCCTTATTCCCTTTTTTGCGGCATTTTGCCTTCCTGTTTTTGCTCACCCAGAAACGCTGGTGAAAGTAAAAGATGCTGAAGATCAGTTGGGTGCACGAGTGGGTTACATCGAGCTGGATCTCAACAGCGGTAAGATCCTTGAGAGTTTTCGCCCCGAAGAACGTTTTCCAATGATGAGCACTTTTAAAGTTCTGCTATGTGGTGCGGTATTATCCCGTGTTGACGCCGGGCAAGAGCAACTCGGTCGCCGCATACACTATTCTCAGAATGACTTGGTTGAGTACTCACCAGTCACAGAAAAGCATCTTACGGATGGCATGACAGTAAGAGAATTATGCAGTGCTGCCATAACCATGAGTGATAACACTGCGGCCAACTTACTTCTGACAACGATCGGAGGACCGAAGGAGCTAACCGCTTTTTTGCACAACATGGGGGATCATGTAACCCGCCTTGATCGTTGGGAACCGGAGCTGAATGAAGCCATACCAAACGACGAGCGTGACACCACGATGCCTGCAGCAATGGCAACAACGTTGCGCAAACTATTAACTGGCGAACTACTTACTCTAGCTTCCCGGCAACAATTAATAGACTGGATGGAGGCGGATAAAGTTGCAGGACCACTTCTGCGCTCGGCCCTTCCGGCTGGCTGGTTTATTGCTGATAAATCTGGAGCCGGTGAGCGTGGATCTCGCGGTATCATTGCAGCACTGGGGCCAGATGGTAAGCCCTCCCGTATCGTAGTTATCTACACGACGGGGAGTCAGGCAACTAT
394	gb|KR057754.1|+|0-1116|ARO:3004348|PDC-85	GGCGAGGCCCCGGCGGATCGCCTGAAGGCATTGGTCGACGCCGCCGTACAACCG...TGA	1116.0	35594	36652	1058	1116	GAGGCCCCGGCGGATCGCCTGAAGGCACTGGTCGACGCCGCCGTACAACCGGTGATGAAGGCCAATGACATTCCGGGCCTGGCCGTAGCCATCAGCCTGAAAGGAGAACCGCATTACTTCAGCTATGGGCTGGCCTCGAAAGAGGACGGCCGCCGGGTGACGCCGGAGACCCTGTTCGAGATCGGCTCGGTGAGCAAGACCTTCACCGTCACCCTCGCCGGCTATGCCCTGGCCCAGGACAAGATGCGCCTCGACGACCGCGCCAGCCAGCACTGGCCGGCACTGCAGGGCAGCCGCTTCGACGGCATCAGCCTGCTCGACCTCGCGACCTATACCGCCGGCGGCTTGCCGCTGCAGTTCCCCGACTCGGTGCAGAAGGACCAGGCACAGATCCGCGACTACTACCGCCAGTGGCAGCCGACCTACGCGCCGGGCAGCCAGCGCCTCTATTCCAACCCGAGCATCGGCCTGTTCGGCTATCTCGCCGCGCGCAGCCTGGGCCAGCCGTTCGAACGGCTCATGGAGCAGCAATTGTTCCCGGCACTGGGCCTCGAACAGACCCACCTCGACGTGCCCGAGGCGGCGCTGGCGCAGTACGCCCAGGGCTACGGCAAGGACGACCGCCCGCTACGGGTCGGTCCCGGCCCGCTGGATGCCGAAGGCTACGGGGTGAAGACCAGCGCGGCCGACCTGCTGCGCTTCGTCGATGCCAACCTGCATCCGGAGCGCCTGGACAGGCCCTGGGCGCAGGCGCTCGATGCCACCCATCGCGGTTACTACAAGGTCGGCGACATGACCCAGGGCCTGGGCTGGGAAGCCTACGACTGGCCGATCTCCCTGAAGCGCCTGCAGGCCGGCAACTCGACGCCGATGGCGCTGCAACCACACAGGATCGCCAGGCTGCCCGCGCCACAGGCGCTGGAGGGCCAGCGCCTGCTGAACAAGACCGGCTCCACCAACGGCTTCGGCGCCTACGTGGCGTTCGTCCCGGGCCGCGACCTGGGCCTGGTGATCCTGGCCAACCGCAACTATCCCAATGCCGAGCGGGTGAAGATCGC
395	gb|KJ657570|+|0-801|ARO:3001495|OXA-233	ATGAAAACATTTGCCGCATATGTAATTATCGCGTGTCTTTCGAGTACGGCATTA...TAA	801.0	659	1405	746	801	ATGAAAACATTTGCCGCATATGTAATTATCGCGTGTCTTTCGAGTACGGCATTAGCTGGTTCAATTACAGAAAATACGTCTTGGAACAAAGAGTTCTCTGCCGAAGCCGTCAATGGTGTCTTCGTGCTTTGTAAAAGTAGCAGTAAATCCTGCGCTACCAATGACTTAGCTCGTGCATCAAAGGAATATCTTCCAGCATCAACATTTAAGATCCCCAACGCAATTATCGGCCTAGAAACTGGTGTCATAAAGAATGAGCATCAGGTTTTCAAATGGGACGGAAAGCCAAGAGCCATGAAGCAATGGGAAAGAGACTTGACCTTAAGAGGGGCAATACAAGTTTCAGCTGTTCCCGTATTTCAACAAATCGCCAGAGAAGTTGGCGAAGTAAGAATGCAGAAATACCTTAAAAAATTTTCCTATGGCAACCAGAATATCAGTGGTGGCATTGACAAATTCTGGTTGGAAGGCCAGCTTAGAATTTCCGCAGTTAATCAAGTGGAGTTTCTAGAGTCTCTATATTTAAATAAATTGTCAGCATCTAAAGAAAACCAGCTAATAGTAAAAGAGGCTTTGGTAACGGAGGCGGCACCTGAATATCTAGTGCATTCAAAAACTGGTTTTTCTGGTGTGGGAACTGAGTCAAATCCTGGTGTCGCATGGTGGGTTGGGTGGGTTGAGAAGGAGACAGAGGTTTACTTTTTCGCCTTTAACATGGATATAGACAACGAAAGTAAGTTGCCGCT
396	gb|AY327539|+|0-858|ARO:3000985|TEM-123	ATGAGTATTAAACATTTCCGTGTCGCCCTTATTCCCTTTTTTGCGGCATTTTGC...TAA	858.0	46	852	806	858	ATGAGTATTCAACATTTCCGTGTCGCCCTTATTCCCTTTTTTGCGGCATTTTGCCTTCCTGTTTTTGCTCACCCAGAAACGCTGGTGAAAGTAAAAGATGCTGAAGATCAGTTGGGTGCACGAGTGGGTTACATCGAGCTGGATCTCAACAGCGGTAAGATCCTTGAGAGTTTTCGCCCCGAAGAACGTTTTCCAATGATGAGCACTTTTAAAGTTCTGCTATGTGGTGCGGTATTATCCCGTGTTGACGCCGGGCAAGAGCAACTCGGTCGCCGCATACACTATTCTCAGAATGACTTGGTTGAGTACTCACCAGTCACAGAAAAGCATCTTACGGATGGCATGACAGTAAGAGAATTATGCAGTGCTGCCATAACCATGAGTGATAACACTGCGGCCAACTTACTTCTGACAACGATCGGAGGACCGAAGGAGCTAACCGCTTTTTTGCACAACATGGGGGATCATGTAACCCGCCTTGATCGTTGGGAACCGGAGCTGAATGAAGCCATACCAAACGACGAGCGTGACACCACGATGCCTGCAGCAATGGCAACAACGTTGCGCAAACTATTAACTGGCGAACTACTTACTCTAGCTTCCCGGCAACAATTAATAGACTGGATGGAGGCGGATAAAGTTGCAGGACCACTTCTGCGCTCGGCCCTTCCGGCTGGCTGGTTTATTGCTGATAAATCTGGAGCCGGTGAGCGTGGATCTCGCGGTATCATTGCAGCACTGGGGCCAGATGGTAAGCCCTCCCGTATCGTAGTTATCTACACGACGGGGAGTCAGGCAACTATGGA
397	gb|KM998962.1|+|0-861|ARO:3003158|TEM-220	ATGAGTATTCAACATTTTCGTGTCGCCCTTATTCCCTTTTTTGCGGCATTTTGC...TAA	861.0	46	852	806	861	ATGAGTATTCAACATTTCCGTGTCGCCCTTATTCCCTTTTTTGCGGCATTTTGCCTTCCTGTTTTTGCTCACCCAGAAACGCTGGTGAAAGTAAAAGATGCTGAAGATCAGTTGGGTGCACGAGTGGGTTACATCGAGCTGGATCTCAACAGCGGTAAGATCCTTGAGAGTTTTCGCCCCGAAGAACGTTTTCCAATGATGAGCACTTTTAAAGTTCTGCTATGTGGTGCGGTATTATCCCGTGTTGACGCCGGGCAAGAGCAACTCGGTCGCCGCATACACTATTCTCAGAATGACTTGGTTGAGTACTCACCAGTCACAGAAAAGCATCTTACGGATGGCATGACAGTAAGAGAATTATGCAGTGCTGCCATAACCATGAGTGATAACACTGCGGCCAACTTACTTCTGACAACGATCGGAGGACCGAAGGAGCTAACCGCTTTTTTGCACAACATGGGGGATCATGTAACCCGCCTTGATCGTTGGGAACCGGAGCTGAATGAAGCCATACCAAACGACGAGCGTGACACCACGATGCCTGCAGCAATGGCAACAACGTTGCGCAAACTATTAACTGGCGAACTACTTACTCTAGCTTCCCGGCAACAATTAATAGACTGGATGGAGGCGGATAAAGTTGCAGGACCACTTCTGCGCTCGGCCCTTCCGGCTGGCTGGTTTATTGCTGATAAATCTGGAGCCGGTGAGCGTGGATCTCGCGGTATCATTGCAGCACTGGGGCCAGATGGTAAGCCCTCCCGTATCGTAGTTATCTACACGACGGGGAGTCAGGCAACTATGGA
398	gb|FJ666065|+|0-1194|ARO:3002497|PDC-1	ATGCGCGATACCAGATTCCCCTGCCTGTGCGGCATCGCCGCTTCCACACTGCTG...TGA	1194.0	35513	36652	1139	1194	ATGCGCGATACCAGATTCCCCTGCCTGTGCGGCATCGCCGCTTCCACACTGCTGTTCGCCACCACCCCGGCCATTGCCGATGAGGCCCCGGCGGATCGCCTGAAGGCACTGGTCGACGCCGCCGTACAACCGGTGATGAAGGCCAATGACATTCCGGGCCTGGCCGTAGCCATCAGCCTGAAAGGAGAACCGCATTACTTCAGCTATGGGCTGGCCTCGAAAGAGGACGGCCGCCGGGTGACGCCGGAGACCCTGTTCGAGATCGGCTCGGTGAGCAAGACCTTCACCGTCACCCTCGCCGGCTATGCCCTGGCCCAGGACAAGATGCGCCTCGACGACCGCGCCAGCCAGCACTGGCCGGCACTGCAGGGCAGCCGCTTCGACGGCATCAGCCTGCTCGACCTCGCGACCTATACCGCCGGCGGCTTGCCGCTGCAGTTCCCCGACTCGGTGCAGAAGGACCAGGCACAGATCCGCGACTACTACCGCCAGTGGCAGCCGACCTACGCGCCGGGCAGCCAGCGCCTCTATTCCAACCCGAGCATCGGCCTGTTCGGCTATCTCGCCGCGCGCAGCCTGGGCCAGCCGTTCGAACGGCTCATGGAGCAGCAATTGTTCCCGGCACTGGGCCTCGAACAGACCCACCTCGACGTGCCCGAGGCGGCGCTGGCGCAGTACGCCCAGGGCTACGGCAAGGACGACCGCCCGCTACGGGTCGGTCCCGGCCCGCTGGATGCCGAAGGCTACGGGGTGAAGACCAGCGCGGCCGACCTGCTGCGCTTCGTCGATGCCAACCTGCATCCGGAGCGCCTGGACAGGCCCTGGGCGCAGGCGCTCGATGCCACCCATCGCGGTTACTACAAGGTCGGCGACATGACCCAGGGCCTGGGCTGGGAAGCCTACGACTGGCCGATCTCCCTGAAGCGCCTGCAGGCCGGCAACTCGACGCCGATGGCGCTGCAACCACACAGGATCGCCAGGCTGCCCGCGCCACAGGCGCTGGAGGGCCAGCGCCTGCTGAACAAGACCGGCTCCACCAACGGCTTCGGCGCCTACGTGGCGTTCGTCCCGGGCCGCGACCTGGGCCTGGTGATCCTGGCCAACCGCAACTATCCCAATGCCGAGCGGGTGAAGATCGC
399	gb|KF986262.1|-|27-852|ARO:3001569|OXA-383	ATGAACATTAAAACACTCTTACTTATAACAAGCGCTATTTTTATTTCAGCCTGC...TAG	825.0	54149	54919	770	825	ATGAACATTAAAGCACTCTTACTTATAACAAGCGCTATTTTTATTTCAGCCTGCTCACCTTATATAGTGACTGCTAATCCAAATCACAGCGCTTCAAAATCTGATGTAAAAGCAGAGAAAATTAAAAATTTATTTAACGAAGCACACACTACGGGTGTTTTAGTTATCCAACAAGGCCAAACTCAACAAAGCTATGGTAATGATCTTGCTCGTGCTTCGACCGAGTATGTACCTGCTTCGACCTTCAAAATGCTTAATGCTTTGATCGGCCTTGAGCACCATAAGGCAACCACCACAGAAGTATTTAAGTGGGATGGTAAAAAAAGGTTATTCCCAGAATGGGAAAAGGACATGACCCTAGGCGATGCCATGAAAGCTTCCGCTATTCCAGTTTATCAAGATTTAGCTCGTCGTATTGGACTTGAGCTCATGTCTAAGGAAGTGAAGCGTGTTGGTTATGGCAATGCAGATATCGGTACCCAAGTCGATAATTTTTGGCTGGTGGGTCCTTTAAAAATTACTCCTCAGCAAGAGGCACAGTTTGCTTACAAGCTAGCTAATAAAACGCTTCCATTTAGCCAAAAAGTCCAAGATGAAGTGCAATCCATGCTATTCATAGAAGAAAAGAATGGAAACAAAATATACGCAAAAAGTGGTTGGGGATGGGATGTAAACCCACAAGTAGGCTGGTTAACTGGATGGGTTGTTCAGCCTCAAGGGAATATTGTAGCGTTCTCCCTTAACTTAGAAATGAAAAAAGGAATACCTAG
400	gb|NG_050607.1|+|100-925|ARO:3001496|OXA-234	ATGAACATTAAAGCACTCTTACTTATAACAAGCGCTATTTTTATTTCAGCCTGC...TAG	825.0	54149	54919	770	825	ATGAACATTAAAGCACTCTTACTTATAACAAGCGCTATTTTTATTTCAGCCTGCTCACCTTATATAGTGACTGCTAATCCAAATCACAGCGCTTCAAAATCTGATGTAAAAGCAGAGAAAATTAAAAATTTATTTAACGAAGCACACACTACGGGTGTTTTAGTTATCCAACAAGGCCAAACTCAACAAAGCTATGGTAATGATCTTGCTCGTGCTTCGACCGAGTATGTACCTGCTTCGACCTTCAAAATGCTTAATGCTTTGATCGGCCTTGAGCACCATAAGGCAACCACCACAGAAGTATTTAAGTGGGATGGTAAAAAAAGGTTATTCCCAGAATGGGAAAAGGACATGACCCTAGGCGATGCCATGAAAGCTTCCGCTATTCCAGTTTATCAAGATTTAGCTCGTCGTATTGGACTTGAGCTCATGTCTAAGGAAGTGAAGCGTGTTGGTTATGGCAATGCAGATATCGGTACCCAAGTCGATAATTTTTGGCTGGTGGGTCCTTTAAAAATTACTCCTCAGCAAGAGGCACAGTTTGCTTACAAGCTAGCTAATAAAACGCTTCCATTTAGCCAAAAAGTCCAAGATGAAGTGCAATCCATGCTATTCATAGAAGAAAAGAATGGAAACAAAATATACGCAAAAAGTGGTTGGGGATGGGATGTAAACCCACAAGTAGGCTGGTTAACTGGATGGGTTGTTCAGCCTCAAGGGAATATTGTAGCGTTCTCCCTTAACTTAGAAATGAAAAAAGGAATACCTAG
401	gb|AY648950.1|+|0-1152|ARO:3003853|ADC-7	ATGCGATTTAAAAAAATTTCTTGTTTACTTTTATCCCCGCTTTTTATTTTTAGT...TAA	1152.0	63	1160	1097	1152	ATGCGATTTAAAAAAATTTCTTGTCTACTTTTATCCCCGCTTTTTATTTTTAGTACCTCAATTTATGCGGGCAATACACCAAAAGACCAAGAAATTAAAAAACTGGTAGATCAAAACTTTAAACCGTTATTAGAAAAATATGATGTGCCAGGTATGGCTGTGGGTGTTATTCAAAATAATAAAAAGTATGAAATGTATTATGGTCTTCAATCTGTTCAAGATAAAAAAGCCGTAAATAGCAGTACTATTTTTGAGCTAGGTTCTGTCAGTAAATTATTTACCGCGACAGCAGGTGGATATGCAAAAAATAAAGGAAAAATCTCTTTTGACGATACGCCTGGTAAGTATTGGAAAGAACTAAAAAATACACCGATTGACCAAGTTAACTTACTTCAACTCGCGACGTATACAAGTGGTAACCTTGCCTTGCAATTTCCAGATGAAGTAAAAACAGATCAGCAAGTTTTAACATTTTTTAAAGACTGGAAACCTAAAAACTCAATCGGTGAATATCGACAATATTCAAACCCAAGCATTGGTTTATTTGGAAAAGTTGTAGCTTTGTCTATGAATAAACCTTTCGACCAAGTCTTAGAAAAAACAATTTTTCCGGCCCTTGGCTTAAAACATAGCTATGTAAATGTACCTAAGACCCAGATGCAAAACTATGCTTTTGGCTATAACCAAGAAAATCAGCCGATTCGAGTTAACCCCGGCCCACTCGATGCCCCAGCATATGGCGTCAAATCGACACTACCCGACATGTTGAGTTTTATTCATGCCAACCTAAATCCACAAAAATATCCAGCAGATATTCAACGGGCAATTAATGAAACACATCAGGGTCGCTATCAAGTAAATACCATGTATCAGGCACTCGGTTGGGAAGAGTTTTCTTATCCGGCAACGTTACAAACTTTATTAGACAGTAATTCAGAACAGATTGTGATGAAACCTAATAAAGTGACTGCTATTTCAAAGGAACCTTCAGTTAAGATGTACCATAAAACTGGCTCAACTACCGGTTTCGGAACATATGTGGTGTTTATTCCTAAAGAAAATATTGGTTTAGTCATGTTAACCAATAAACGTATTCC
402	gb|X65253|+|175-1036|ARO:3000894|TEM-24	ATGAGTATTCAACATTTCCGTGTCGCCCTTATTCCCTTTTTTGCGGCATTTTGC...TAA	861.0	46	852	806	861	ATGAGTATTCAACATTTCCGTGTCGCCCTTATTCCCTTTTTTGCGGCATTTTGCCTTCCTGTTTTTGCTCACCCAGAAACGCTGGTGAAAGTAAAAGATGCTGAAGATCAGTTGGGTGCACGAGTGGGTTACATCGAGCTGGATCTCAACAGCGGTAAGATCCTTGAGAGTTTTCGCCCCGAAGAACGTTTTCCAATGATGAGCACTTTTAAAGTTCTGCTATGTGGTGCGGTATTATCCCGTGTTGACGCCGGGCAAGAGCAACTCGGTCGCCGCATACACTATTCTCAGAATGACTTGGTTGAGTACTCACCAGTCACAGAAAAGCATCTTACGGATGGCATGACAGTAAGAGAATTATGCAGTGCTGCCATAACCATGAGTGATAACACTGCGGCCAACTTACTTCTGACAACGATCGGAGGACCGAAGGAGCTAACCGCTTTTTTGCACAACATGGGGGATCATGTAACCCGCCTTGATCGTTGGGAACCGGAGCTGAATGAAGCCATACCAAACGACGAGCGTGACACCACGATGCCTGCAGCAATGGCAACAACGTTGCGCAAACTATTAACTGGCGAACTACTTACTCTAGCTTCCCGGCAACAATTAATAGACTGGATGGAGGCGGATAAAGTTGCAGGACCACTTCTGCGCTCGGCCCTTCCGGCTGGCTGGTTTATTGCTGATAAATCTGGAGCCGGTGAGCGTGGATCTCGCGGTATCATTGCAGCACTGGGGCCAGATGGTAAGCCCTCCCGTATCGTAGTTATCTACACGACGGGGAGTCAGGCAACTATGGA
403	gb|NG_050256.1|+|100-961|ARO:3000896|TEM-26	ATGAGTATTCAACATTTCCGTGTCGCCCTTATTCCCTTTTTTGCGGCATTTTGC...TAA	861.0	46	852	806	861	ATGAGTATTCAACATTTCCGTGTCGCCCTTATTCCCTTTTTTGCGGCATTTTGCCTTCCTGTTTTTGCTCACCCAGAAACGCTGGTGAAAGTAAAAGATGCTGAAGATCAGTTGGGTGCACGAGTGGGTTACATCGAGCTGGATCTCAACAGCGGTAAGATCCTTGAGAGTTTTCGCCCCGAAGAACGTTTTCCAATGATGAGCACTTTTAAAGTTCTGCTATGTGGTGCGGTATTATCCCGTGTTGACGCCGGGCAAGAGCAACTCGGTCGCCGCATACACTATTCTCAGAATGACTTGGTTGAGTACTCACCAGTCACAGAAAAGCATCTTACGGATGGCATGACAGTAAGAGAATTATGCAGTGCTGCCATAACCATGAGTGATAACACTGCGGCCAACTTACTTCTGACAACGATCGGAGGACCGAAGGAGCTAACCGCTTTTTTGCACAACATGGGGGATCATGTAACCCGCCTTGATCGTTGGGAACCGGAGCTGAATGAAGCCATACCAAACGACGAGCGTGACACCACGATGCCTGCAGCAATGGCAACAACGTTGCGCAAACTATTAACTGGCGAACTACTTACTCTAGCTTCCCGGCAACAATTAATAGACTGGATGGAGGCGGATAAAGTTGCAGGACCACTTCTGCGCTCGGCCCTTCCGGCTGGCTGGTTTATTGCTGATAAATCTGGAGCCGGTGAGCGTGGATCTCGCGGTATCATTGCAGCACTGGGGCCAGATGGTAAGCCCTCCCGTATCGTAGTTATCTACACGACGGGGAGTCAGGCAACTATGGA
404	gb|JQ837239|+|0-822|ARO:3001498|OXA-239	ATGAATAAATATTTTACTTGCTATGTGGTTGCTTCTCTTTTTCTTTCTGGTTGT...TAA	822.0	80	847	767	822	ATGAATAAATATTTTACTTGCTATGTGGTTGCTTCTCTTTTTCTTTCTGGTTGTACGGTTCAGCATAATTTAATAAATGAAACCCCGAGTCAGATTGTTCAAGGACATAATCAGGTGATTCATCAATACTTTGATGAAAAAAACACCTCAGGTGTGCTGGTTATTCAAACAGATAAAAAAATTAATCTATATGGTAATGCTCTAAGCCGCGCAAATACAGAATATGTGCCAGCCTCTACATTTAAAATGTTGAATGCCCTGATCGGATTGGAGAACCAGAAAACGGATATTAATGAAATATTTAAATGGAAGGGCGAGAAAAGGTCATTTACCGCTTGGGAAAAAGACATGACACTAGGAGAAGCCATGAAGCTTTCTGCAGTCCCAGTCTATCAGGAACTTGCGCGACGTATCGGTCTTGATCTCATGCAAAAAGAAGTAAAACGTATTGGTTTCGGTAATGCTGAAATTGGACAGCAGGTTGATAATTTCTGGTTGGTAGGACCATTAAAGGTTACGCCTATTCAAGAGGTAGAGTTTGTTTCCCAATTAGCACATACACAGCTTCCATTTAGTGAAAAAGTGCAGGCTAATGTAAAAAATATGCTTCTTTTAGAAGAGAGTAATGGCTACAAAATTTTTGGAAAGACTGGTTGGGCAATGGATATAAAACCACAAGTGGGCTGGTTGACCGGCTGGGTTGAGCAGCCAGATGGAAAAATTGTCGCTTTTGCATTAAATATGGAAATGCGGTCAGAAATGCCGGC
405	gb|LLSH01000109.1|+|88827-90021|ARO:3004349|PDC-86	ATGCGCGATACCAGATTCCCCTGCCTGTGCGGCATCGCCGCTTCCACACTGCTG...TGA	1194.0	35513	36652	1139	1194	ATGCGCGATACCAGATTCCCCTGCCTGTGCGGCATCGCCGCTTCCACACTGCTGTTCGCCACCACCCCGGCCATTGCCGATGAGGCCCCGGCGGATCGCCTGAAGGCACTGGTCGACGCCGCCGTACAACCGGTGATGAAGGCCAATGACATTCCGGGCCTGGCCGTAGCCATCAGCCTGAAAGGAGAACCGCATTACTTCAGCTATGGGCTGGCCTCGAAAGAGGACGGCCGCCGGGTGACGCCGGAGACCCTGTTCGAGATCGGCTCGGTGAGCAAGACCTTCACCGTCACCCTCGCCGGCTATGCCCTGGCCCAGGACAAGATGCGCCTCGACGACCGCGCCAGCCAGCACTGGCCGGCACTGCAGGGCAGCCGCTTCGACGGCATCAGCCTGCTCGACCTCGCGACCTATACCGCCGGCGGCTTGCCGCTGCAGTTCCCCGACTCGGTGCAGAAGGACCAGGCACAGATCCGCGACTACTACCGCCAGTGGCAGCCGACCTACGCGCCGGGCAGCCAGCGCCTCTATTCCAACCCGAGCATCGGCCTGTTCGGCTATCTCGCCGCGCGCAGCCTGGGCCAGCCGTTCGAACGGCTCATGGAGCAGCAATTGTTCCCGGCACTGGGCCTCGAACAGACCCACCTCGACGTGCCCGAGGCGGCGCTGGCGCAGTACGCCCAGGGCTACGGCAAGGACGACCGCCCGCTACGGGTCGGTCCCGGCCCGCTGGATGCCGAAGGCTACGGGGTGAAGACCAGCGCGGCCGACCTGCTGCGCTTCGTCGATGCCAACCTGCATCCGGAGCGCCTGGACAGGCCCTGGGCGCAGGCGCTCGATGCCACCCATCGCGGTTACTACAAGGTCGGCGACATGACCCAGGGCCTGGGCTGGGAAGCCTACGACTGGCCGATCTCCCTGAAGCGCCTGCAGGCCGGCAACTCGACGCCGATGGCGCTGCAACCACACAGGATCGCCAGGCTGCCCGCGCCACAGGCGCTGGAGGGCCAGCGCCTGCTGAACAAGACCGGCTCCACCAACGGCTTCGGCGCCTACGTGGCGTTCGTCCCGGGCCGCGACCTGGGCCTGGTGATCCTGGCCAACCGCAACTATCCCAATGCCGAGCGGGTGAAGATCGC
406	gb|AF351241|+|89-950|ARO:3000957|TEM-90	ATGAGTATTCAACATTTCCGTGTCGCCCTTATTCCCTTTTTTGCGGCATTTTGC...TAA	861.0	46	852	806	861	ATGAGTATTCAACATTTCCGTGTCGCCCTTATTCCCTTTTTTGCGGCATTTTGCCTTCCTGTTTTTGCTCACCCAGAAACGCTGGTGAAAGTAAAAGATGCTGAAGATCAGTTGGGTGCACGAGTGGGTTACATCGAGCTGGATCTCAACAGCGGTAAGATCCTTGAGAGTTTTCGCCCCGAAGAACGTTTTCCAATGATGAGCACTTTTAAAGTTCTGCTATGTGGTGCGGTATTATCCCGTGTTGACGCCGGGCAAGAGCAACTCGGTCGCCGCATACACTATTCTCAGAATGACTTGGTTGAGTACTCACCAGTCACAGAAAAGCATCTTACGGATGGCATGACAGTAAGAGAATTATGCAGTGCTGCCATAACCATGAGTGATAACACTGCGGCCAACTTACTTCTGACAACGATCGGAGGACCGAAGGAGCTAACCGCTTTTTTGCACAACATGGGGGATCATGTAACCCGCCTTGATCGTTGGGAACCGGAGCTGAATGAAGCCATACCAAACGACGAGCGTGACACCACGATGCCTGCAGCAATGGCAACAACGTTGCGCAAACTATTAACTGGCGAACTACTTACTCTAGCTTCCCGGCAACAATTAATAGACTGGATGGAGGCGGATAAAGTTGCAGGACCACTTCTGCGCTCGGCCCTTCCGGCTGGCTGGTTTATTGCTGATAAATCTGGAGCCGGTGAGCGTGGATCTCGCGGTATCATTGCAGCACTGGGGCCAGATGGTAAGCCCTCCCGTATCGTAGTTATCTACACGACGGGGAGTCAGGCAACTATGGA
407	gb|EU815939|+|0-861|ARO:3001029|TEM-163	ATGAGTATTCAACATTTCCGTGTCGCCCTTATTCCCTTTTTTGCGGCATTTTGC...TAA	861.0	46	852	806	861	ATGAGTATTCAACATTTCCGTGTCGCCCTTATTCCCTTTTTTGCGGCATTTTGCCTTCCTGTTTTTGCTCACCCAGAAACGCTGGTGAAAGTAAAAGATGCTGAAGATCAGTTGGGTGCACGAGTGGGTTACATCGAGCTGGATCTCAACAGCGGTAAGATCCTTGAGAGTTTTCGCCCCGAAGAACGTTTTCCAATGATGAGCACTTTTAAAGTTCTGCTATGTGGTGCGGTATTATCCCGTGTTGACGCCGGGCAAGAGCAACTCGGTCGCCGCATACACTATTCTCAGAATGACTTGGTTGAGTACTCACCAGTCACAGAAAAGCATCTTACGGATGGCATGACAGTAAGAGAATTATGCAGTGCTGCCATAACCATGAGTGATAACACTGCGGCCAACTTACTTCTGACAACGATCGGAGGACCGAAGGAGCTAACCGCTTTTTTGCACAACATGGGGGATCATGTAACCCGCCTTGATCGTTGGGAACCGGAGCTGAATGAAGCCATACCAAACGACGAGCGTGACACCACGATGCCTGCAGCAATGGCAACAACGTTGCGCAAACTATTAACTGGCGAACTACTTACTCTAGCTTCCCGGCAACAATTAATAGACTGGATGGAGGCGGATAAAGTTGCAGGACCACTTCTGCGCTCGGCCCTTCCGGCTGGCTGGTTTATTGCTGATAAATCTGGAGCCGGTGAGCGTGGATCTCGCGGTATCATTGCAGCACTGGGGCCAGATGGTAAGCCCTCCCGTATCGTAGTTATCTACACGACGGGGAGTCAGGCAACTATGGA
408	gb|KF986263.1|-|90-915|ARO:3001570|OXA-384	ATGAACATTCAAGCCCTCTTACTTATAACAAGCGCTATTTTTATTTCAGCCTGC...TAG	825.0	54149	54919	770	825	ATGAACATTAAAGCACTCTTACTTATAACAAGCGCTATTTTTATTTCAGCCTGCTCACCTTATATAGTGACTGCTAATCCAAATCACAGCGCTTCAAAATCTGATGTAAAAGCAGAGAAAATTAAAAATTTATTTAACGAAGCACACACTACGGGTGTTTTAGTTATCCAACAAGGCCAAACTCAACAAAGCTATGGTAATGATCTTGCTCGTGCTTCGACCGAGTATGTACCTGCTTCGACCTTCAAAATGCTTAATGCTTTGATCGGCCTTGAGCACCATAAGGCAACCACCACAGAAGTATTTAAGTGGGATGGTAAAAAAAGGTTATTCCCAGAATGGGAAAAGGACATGACCCTAGGCGATGCCATGAAAGCTTCCGCTATTCCAGTTTATCAAGATTTAGCTCGTCGTATTGGACTTGAGCTCATGTCTAAGGAAGTGAAGCGTGTTGGTTATGGCAATGCAGATATCGGTACCCAAGTCGATAATTTTTGGCTGGTGGGTCCTTTAAAAATTACTCCTCAGCAAGAGGCACAGTTTGCTTACAAGCTAGCTAATAAAACGCTTCCATTTAGCCAAAAAGTCCAAGATGAAGTGCAATCCATGCTATTCATAGAAGAAAAGAATGGAAACAAAATATACGCAAAAAGTGGTTGGGGATGGGATGTAAACCCACAAGTAGGCTGGTTAACTGGATGGGTTGTTCAGCCTCAAGGGAATATTGTAGCGTTCTCCCTTAACTTAGAAATGAAAAAAGGAATACCTAG
409	gb|U37195|+|75-936|ARO:3000898|TEM-28	ATGAGTATTCAACATTTTCGTGTCGCCCTTATTCCCTTTTTTGCGGCATTTTGC...TAA	861.0	46	852	806	861	ATGAGTATTCAACATTTCCGTGTCGCCCTTATTCCCTTTTTTGCGGCATTTTGCCTTCCTGTTTTTGCTCACCCAGAAACGCTGGTGAAAGTAAAAGATGCTGAAGATCAGTTGGGTGCACGAGTGGGTTACATCGAGCTGGATCTCAACAGCGGTAAGATCCTTGAGAGTTTTCGCCCCGAAGAACGTTTTCCAATGATGAGCACTTTTAAAGTTCTGCTATGTGGTGCGGTATTATCCCGTGTTGACGCCGGGCAAGAGCAACTCGGTCGCCGCATACACTATTCTCAGAATGACTTGGTTGAGTACTCACCAGTCACAGAAAAGCATCTTACGGATGGCATGACAGTAAGAGAATTATGCAGTGCTGCCATAACCATGAGTGATAACACTGCGGCCAACTTACTTCTGACAACGATCGGAGGACCGAAGGAGCTAACCGCTTTTTTGCACAACATGGGGGATCATGTAACCCGCCTTGATCGTTGGGAACCGGAGCTGAATGAAGCCATACCAAACGACGAGCGTGACACCACGATGCCTGCAGCAATGGCAACAACGTTGCGCAAACTATTAACTGGCGAACTACTTACTCTAGCTTCCCGGCAACAATTAATAGACTGGATGGAGGCGGATAAAGTTGCAGGACCACTTCTGCGCTCGGCCCTTCCGGCTGGCTGGTTTATTGCTGATAAATCTGGAGCCGGTGAGCGTGGATCTCGCGGTATCATTGCAGCACTGGGGCCAGATGGTAAGCCCTCCCGTATCGTAGTTATCTACACGACGGGGAGTCAGGCAACTATGGA
410	gb|JX089628|+|0-801|ARO:3001499|OXA-240	ATGAAAACATTTGCCGCATATGTAATTATCGCGTGTCTTTCGAGTACGGCATTA...TAA	801.0	659	1405	746	801	ATGAAAACATTTGCCGCATATGTAATTATCGCGTGTCTTTCGAGTACGGCATTAGCTGGTTCAATTACAGAAAATACGTCTTGGAACAAAGAGTTCTCTGCCGAAGCCGTCAATGGTGTCTTCGTGCTTTGTAAAAGTAGCAGTAAATCCTGCGCTACCAATGACTTAGCTCGTGCATCAAAGGAATATCTTCCAGCATCAACATTTAAGATCCCCAACGCAATTATCGGCCTAGAAACTGGTGTCATAAAGAATGAGCATCAGGTTTTCAAATGGGACGGAAAGCCAAGAGCCATGAAGCAATGGGAAAGAGACTTGACCTTAAGAGGGGCAATACAAGTTTCAGCTGTTCCCGTATTTCAACAAATCGCCAGAGAAGTTGGCGAAGTAAGAATGCAGAAATACCTTAAAAAATTTTCCTATGGCAACCAGAATATCAGTGGTGGCATTGACAAATTCTGGTTGGAAGGCCAGCTTAGAATTTCCGCAGTTAATCAAGTGGAGTTTCTAGAGTCTCTATATTTAAATAAATTGTCAGCATCTAAAGAAAACCAGCTAATAGTAAAAGAGGCTTTGGTAACGGAGGCGGCACCTGAATATCTAGTGCATTCAAAAACTGGTTTTTCTGGTGTGGGAACTGAGTCAAATCCTGGTGTCGCATGGTGGGTTGGGTGGGTTGAGAAGGAGACAGAGGTTTACTTTTTCGCCTTTAACATGGATATAGACAACGAAAGTAAGTTGCCGCT
411	gb|Y17584|+|0-858|ARO:3000899|TEM-29	ATGAGTATTCAACATTTCCGTGTCGCCCTTATTCCCTTTTTTGCGGCATTTTGC...TGG	858.0	46	849	803	858	ATGAGTATTCAACATTTCCGTGTCGCCCTTATTCCCTTTTTTGCGGCATTTTGCCTTCCTGTTTTTGCTCACCCAGAAACGCTGGTGAAAGTAAAAGATGCTGAAGATCAGTTGGGTGCACGAGTGGGTTACATCGAGCTGGATCTCAACAGCGGTAAGATCCTTGAGAGTTTTCGCCCCGAAGAACGTTTTCCAATGATGAGCACTTTTAAAGTTCTGCTATGTGGTGCGGTATTATCCCGTGTTGACGCCGGGCAAGAGCAACTCGGTCGCCGCATACACTATTCTCAGAATGACTTGGTTGAGTACTCACCAGTCACAGAAAAGCATCTTACGGATGGCATGACAGTAAGAGAATTATGCAGTGCTGCCATAACCATGAGTGATAACACTGCGGCCAACTTACTTCTGACAACGATCGGAGGACCGAAGGAGCTAACCGCTTTTTTGCACAACATGGGGGATCATGTAACCCGCCTTGATCGTTGGGAACCGGAGCTGAATGAAGCCATACCAAACGACGAGCGTGACACCACGATGCCTGCAGCAATGGCAACAACGTTGCGCAAACTATTAACTGGCGAACTACTTACTCTAGCTTCCCGGCAACAATTAATAGACTGGATGGAGGCGGATAAAGTTGCAGGACCACTTCTGCGCTCGGCCCTTCCGGCTGGCTGGTTTATTGCTGATAAATCTGGAGCCGGTGAGCGTGGATCTCGCGGTATCATTGCAGCACTGGGGCCAGATGGTAAGCCCTCCCGTATCGTAGTTATCTACACGACGGGGAGTCAGGCAACTAT
412	gb|KP881233.1|+|0-1152|ARO:3004634|ADC-73	ATGCGATTTAAAAAAATTTCTTGTCTACTTTTATCCCCGCTTTTTATTTTTAGT...TAA	1152.0	63	1160	1097	1152	ATGCGATTTAAAAAAATTTCTTGTCTACTTTTATCCCCGCTTTTTATTTTTAGTACCTCAATTTATGCGGGCAATACACCAAAAGACCAAGAAATTAAAAAACTGGTAGATCAAAACTTTAAACCGTTATTAGAAAAATATGATGTGCCAGGTATGGCTGTGGGTGTTATTCAAAATAATAAAAAGTATGAAATGTATTATGGTCTTCAATCTGTTCAAGATAAAAAAGCCGTAAATAGCAGTACTATTTTTGAGCTAGGTTCTGTCAGTAAATTATTTACCGCGACAGCAGGTGGATATGCAAAAAATAAAGGAAAAATCTCTTTTGACGATACGCCTGGTAAGTATTGGAAAGAACTAAAAAATACACCGATTGACCAAGTTAACTTACTTCAACTCGCGACGTATACAAGTGGTAACCTTGCCTTGCAATTTCCAGATGAAGTAAAAACAGATCAGCAAGTTTTAACATTTTTTAAAGACTGGAAACCTAAAAACTCAATCGGTGAATATCGACAATATTCAAACCCAAGCATTGGTTTATTTGGAAAAGTTGTAGCTTTGTCTATGAATAAACCTTTCGACCAAGTCTTAGAAAAAACAATTTTTCCGGCCCTTGGCTTAAAACATAGCTATGTAAATGTACCTAAGACCCAGATGCAAAACTATGCTTTTGGCTATAACCAAGAAAATCAGCCGATTCGAGTTAACCCCGGCCCACTCGATGCCCCAGCATATGGCGTCAAATCGACACTACCCGACATGTTGAGTTTTATTCATGCCAACCTAAATCCACAAAAATATCCAGCAGATATTCAACGGGCAATTAATGAAACACATCAGGGTCGCTATCAAGTAAATACCATGTATCAGGCACTCGGTTGGGAAGAGTTTTCTTATCCGGCAACGTTACAAACTTTATTAGACAGTAATTCAGAACAGATTGTGATGAAACCTAATAAAGTGACTGCTATTTCAAAGGAACCTTCAGTTAAGATGTACCATAAAACTGGCTCAACTACCGGTTTCGGAACATATGTGGTGTTTATTCCTAAAGAAAATATTGGTTTAGTCATGTTAACCAATAAACGTATTCC
413	gb|X64523.1|-|476-1337|ARO:3000875|TEM-3	ATGAGTATTCAACATTTCCGTGTCGCCCTTATTCCCTTTTTTGCGGCATTTTGC...TAA	861.0	46	852	806	861	ATGAGTATTCAACATTTCCGTGTCGCCCTTATTCCCTTTTTTGCGGCATTTTGCCTTCCTGTTTTTGCTCACCCAGAAACGCTGGTGAAAGTAAAAGATGCTGAAGATCAGTTGGGTGCACGAGTGGGTTACATCGAGCTGGATCTCAACAGCGGTAAGATCCTTGAGAGTTTTCGCCCCGAAGAACGTTTTCCAATGATGAGCACTTTTAAAGTTCTGCTATGTGGTGCGGTATTATCCCGTGTTGACGCCGGGCAAGAGCAACTCGGTCGCCGCATACACTATTCTCAGAATGACTTGGTTGAGTACTCACCAGTCACAGAAAAGCATCTTACGGATGGCATGACAGTAAGAGAATTATGCAGTGCTGCCATAACCATGAGTGATAACACTGCGGCCAACTTACTTCTGACAACGATCGGAGGACCGAAGGAGCTAACCGCTTTTTTGCACAACATGGGGGATCATGTAACCCGCCTTGATCGTTGGGAACCGGAGCTGAATGAAGCCATACCAAACGACGAGCGTGACACCACGATGCCTGCAGCAATGGCAACAACGTTGCGCAAACTATTAACTGGCGAACTACTTACTCTAGCTTCCCGGCAACAATTAATAGACTGGATGGAGGCGGATAAAGTTGCAGGACCACTTCTGCGCTCGGCCCTTCCGGCTGGCTGGTTTATTGCTGATAAATCTGGAGCCGGTGAGCGTGGATCTCGCGGTATCATTGCAGCACTGGGGCCAGATGGTAAGCCCTCCCGTATCGTAGTTATCTACACGACGGGGAGTCAGGCAACTATGGA
414	gb|EU274580|+|214-1075|ARO:3001030|TEM-164	ATGAGTATTCAACATTTTCGTGTCGCCCTTATTCCCTTTTTTGCGGCATTTTGC...TAA	861.0	46	852	806	861	ATGAGTATTCAACATTTCCGTGTCGCCCTTATTCCCTTTTTTGCGGCATTTTGCCTTCCTGTTTTTGCTCACCCAGAAACGCTGGTGAAAGTAAAAGATGCTGAAGATCAGTTGGGTGCACGAGTGGGTTACATCGAGCTGGATCTCAACAGCGGTAAGATCCTTGAGAGTTTTCGCCCCGAAGAACGTTTTCCAATGATGAGCACTTTTAAAGTTCTGCTATGTGGTGCGGTATTATCCCGTGTTGACGCCGGGCAAGAGCAACTCGGTCGCCGCATACACTATTCTCAGAATGACTTGGTTGAGTACTCACCAGTCACAGAAAAGCATCTTACGGATGGCATGACAGTAAGAGAATTATGCAGTGCTGCCATAACCATGAGTGATAACACTGCGGCCAACTTACTTCTGACAACGATCGGAGGACCGAAGGAGCTAACCGCTTTTTTGCACAACATGGGGGATCATGTAACCCGCCTTGATCGTTGGGAACCGGAGCTGAATGAAGCCATACCAAACGACGAGCGTGACACCACGATGCCTGCAGCAATGGCAACAACGTTGCGCAAACTATTAACTGGCGAACTACTTACTCTAGCTTCCCGGCAACAATTAATAGACTGGATGGAGGCGGATAAAGTTGCAGGACCACTTCTGCGCTCGGCCCTTCCGGCTGGCTGGTTTATTGCTGATAAATCTGGAGCCGGTGAGCGTGGATCTCGCGGTATCATTGCAGCACTGGGGCCAGATGGTAAGCCCTCCCGTATCGTAGTTATCTACACGACGGGGAGTCAGGCAACTATGGA
415	gb|AY327540|+|0-858|ARO:3000986|TEM-124	ATGAGTATTAAACATTTTCGTGTCGCCCTTATTCCCTTTTTTGCGGCATTTTGC...TAA	858.0	46	852	806	858	ATGAGTATTCAACATTTCCGTGTCGCCCTTATTCCCTTTTTTGCGGCATTTTGCCTTCCTGTTTTTGCTCACCCAGAAACGCTGGTGAAAGTAAAAGATGCTGAAGATCAGTTGGGTGCACGAGTGGGTTACATCGAGCTGGATCTCAACAGCGGTAAGATCCTTGAGAGTTTTCGCCCCGAAGAACGTTTTCCAATGATGAGCACTTTTAAAGTTCTGCTATGTGGTGCGGTATTATCCCGTGTTGACGCCGGGCAAGAGCAACTCGGTCGCCGCATACACTATTCTCAGAATGACTTGGTTGAGTACTCACCAGTCACAGAAAAGCATCTTACGGATGGCATGACAGTAAGAGAATTATGCAGTGCTGCCATAACCATGAGTGATAACACTGCGGCCAACTTACTTCTGACAACGATCGGAGGACCGAAGGAGCTAACCGCTTTTTTGCACAACATGGGGGATCATGTAACCCGCCTTGATCGTTGGGAACCGGAGCTGAATGAAGCCATACCAAACGACGAGCGTGACACCACGATGCCTGCAGCAATGGCAACAACGTTGCGCAAACTATTAACTGGCGAACTACTTACTCTAGCTTCCCGGCAACAATTAATAGACTGGATGGAGGCGGATAAAGTTGCAGGACCACTTCTGCGCTCGGCCCTTCCGGCTGGCTGGTTTATTGCTGATAAATCTGGAGCCGGTGAGCGTGGATCTCGCGGTATCATTGCAGCACTGGGGCCAGATGGTAAGCCCTCCCGTATCGTAGTTATCTACACGACGGGGAGTCAGGCAACTATGGA
416	gb|AB049569|+|0-861|ARO:3000958|TEM-91	ATGAGTATTCAACATTTCCGTGTCGCCCTTATTCCCTTTTTTGCGGCATTTTGC...TAA	861.0	46	852	806	861	ATGAGTATTCAACATTTCCGTGTCGCCCTTATTCCCTTTTTTGCGGCATTTTGCCTTCCTGTTTTTGCTCACCCAGAAACGCTGGTGAAAGTAAAAGATGCTGAAGATCAGTTGGGTGCACGAGTGGGTTACATCGAGCTGGATCTCAACAGCGGTAAGATCCTTGAGAGTTTTCGCCCCGAAGAACGTTTTCCAATGATGAGCACTTTTAAAGTTCTGCTATGTGGTGCGGTATTATCCCGTGTTGACGCCGGGCAAGAGCAACTCGGTCGCCGCATACACTATTCTCAGAATGACTTGGTTGAGTACTCACCAGTCACAGAAAAGCATCTTACGGATGGCATGACAGTAAGAGAATTATGCAGTGCTGCCATAACCATGAGTGATAACACTGCGGCCAACTTACTTCTGACAACGATCGGAGGACCGAAGGAGCTAACCGCTTTTTTGCACAACATGGGGGATCATGTAACCCGCCTTGATCGTTGGGAACCGGAGCTGAATGAAGCCATACCAAACGACGAGCGTGACACCACGATGCCTGCAGCAATGGCAACAACGTTGCGCAAACTATTAACTGGCGAACTACTTACTCTAGCTTCCCGGCAACAATTAATAGACTGGATGGAGGCGGATAAAGTTGCAGGACCACTTCTGCGCTCGGCCCTTCCGGCTGGCTGGTTTATTGCTGATAAATCTGGAGCCGGTGAGCGTGGATCTCGCGGTATCATTGCAGCACTGGGGCCAGATGGTAAGCCCTCCCGTATCGTAGTTATCTACACGACGGGGAGTCAGGCAACTATGGA
417	gb|JX025021|+|0-825|ARO:3001679|OXA-241	ATGAACATTAAAGCCCTCTTACTTATAACAAGCGCTATTTTTATTTCAGCCTGC...TAG	825.0	54149	54919	770	825	ATGAACATTAAAGCACTCTTACTTATAACAAGCGCTATTTTTATTTCAGCCTGCTCACCTTATATAGTGACTGCTAATCCAAATCACAGCGCTTCAAAATCTGATGTAAAAGCAGAGAAAATTAAAAATTTATTTAACGAAGCACACACTACGGGTGTTTTAGTTATCCAACAAGGCCAAACTCAACAAAGCTATGGTAATGATCTTGCTCGTGCTTCGACCGAGTATGTACCTGCTTCGACCTTCAAAATGCTTAATGCTTTGATCGGCCTTGAGCACCATAAGGCAACCACCACAGAAGTATTTAAGTGGGATGGTAAAAAAAGGTTATTCCCAGAATGGGAAAAGGACATGACCCTAGGCGATGCCATGAAAGCTTCCGCTATTCCAGTTTATCAAGATTTAGCTCGTCGTATTGGACTTGAGCTCATGTCTAAGGAAGTGAAGCGTGTTGGTTATGGCAATGCAGATATCGGTACCCAAGTCGATAATTTTTGGCTGGTGGGTCCTTTAAAAATTACTCCTCAGCAAGAGGCACAGTTTGCTTACAAGCTAGCTAATAAAACGCTTCCATTTAGCCAAAAAGTCCAAGATGAAGTGCAATCCATGCTATTCATAGAAGAAAAGAATGGAAACAAAATATACGCAAAAAGTGGTTGGGGATGGGATGTAAACCCACAAGTAGGCTGGTTAACTGGATGGGTTGTTCAGCCTCAAGGGAATATTGTAGCGTTCTCCCTTAACTTAGAAATGAAAAAAGGAATACCTAG
418	gb|AJ437107|+|208-1069|ARO:3000900|TEM-30	ATGAGTATTCAACATTTTCGTGTCGCCCTTATTCCCTTTTTTGCGGCATTTTGC...TAA	861.0	46	852	806	861	ATGAGTATTCAACATTTCCGTGTCGCCCTTATTCCCTTTTTTGCGGCATTTTGCCTTCCTGTTTTTGCTCACCCAGAAACGCTGGTGAAAGTAAAAGATGCTGAAGATCAGTTGGGTGCACGAGTGGGTTACATCGAGCTGGATCTCAACAGCGGTAAGATCCTTGAGAGTTTTCGCCCCGAAGAACGTTTTCCAATGATGAGCACTTTTAAAGTTCTGCTATGTGGTGCGGTATTATCCCGTGTTGACGCCGGGCAAGAGCAACTCGGTCGCCGCATACACTATTCTCAGAATGACTTGGTTGAGTACTCACCAGTCACAGAAAAGCATCTTACGGATGGCATGACAGTAAGAGAATTATGCAGTGCTGCCATAACCATGAGTGATAACACTGCGGCCAACTTACTTCTGACAACGATCGGAGGACCGAAGGAGCTAACCGCTTTTTTGCACAACATGGGGGATCATGTAACCCGCCTTGATCGTTGGGAACCGGAGCTGAATGAAGCCATACCAAACGACGAGCGTGACACCACGATGCCTGCAGCAATGGCAACAACGTTGCGCAAACTATTAACTGGCGAACTACTTACTCTAGCTTCCCGGCAACAATTAATAGACTGGATGGAGGCGGATAAAGTTGCAGGACCACTTCTGCGCTCGGCCCTTCCGGCTGGCTGGTTTATTGCTGATAAATCTGGAGCCGGTGAGCGTGGATCTCGCGGTATCATTGCAGCACTGGGGCCAGATGGTAAGCCCTCCCGTATCGTAGTTATCTACACGACGGGGAGTCAGGCAACTATGGA
419	gb|FJ197316|+|0-861|ARO:3001032|TEM-166	ATGAGTATTCAACATTTTCGTGTCGCCCTTATTCCCTTTTTTGCGGCATTTTGC...TAA	861.0	46	852	806	861	ATGAGTATTCAACATTTCCGTGTCGCCCTTATTCCCTTTTTTGCGGCATTTTGCCTTCCTGTTTTTGCTCACCCAGAAACGCTGGTGAAAGTAAAAGATGCTGAAGATCAGTTGGGTGCACGAGTGGGTTACATCGAGCTGGATCTCAACAGCGGTAAGATCCTTGAGAGTTTTCGCCCCGAAGAACGTTTTCCAATGATGAGCACTTTTAAAGTTCTGCTATGTGGTGCGGTATTATCCCGTGTTGACGCCGGGCAAGAGCAACTCGGTCGCCGCATACACTATTCTCAGAATGACTTGGTTGAGTACTCACCAGTCACAGAAAAGCATCTTACGGATGGCATGACAGTAAGAGAATTATGCAGTGCTGCCATAACCATGAGTGATAACACTGCGGCCAACTTACTTCTGACAACGATCGGAGGACCGAAGGAGCTAACCGCTTTTTTGCACAACATGGGGGATCATGTAACCCGCCTTGATCGTTGGGAACCGGAGCTGAATGAAGCCATACCAAACGACGAGCGTGACACCACGATGCCTGCAGCAATGGCAACAACGTTGCGCAAACTATTAACTGGCGAACTACTTACTCTAGCTTCCCGGCAACAATTAATAGACTGGATGGAGGCGGATAAAGTTGCAGGACCACTTCTGCGCTCGGCCCTTCCGGCTGGCTGGTTTATTGCTGATAAATCTGGAGCCGGTGAGCGTGGATCTCGCGGTATCATTGCAGCACTGGGGCCAGATGGTAAGCCCTCCCGTATCGTAGTTATCTACACGACGGGGAGTCAGGCAACTATGGA
420	gb|KF986253|-|15-840|ARO:3001571|OXA-385	ATGAACATTAAAGCCCTCTTACTTATAACAAGCGCTATTTTTATTTCAGCCTGC...TAG	825.0	54149	54919	770	825	ATGAACATTAAAGCACTCTTACTTATAACAAGCGCTATTTTTATTTCAGCCTGCTCACCTTATATAGTGACTGCTAATCCAAATCACAGCGCTTCAAAATCTGATGTAAAAGCAGAGAAAATTAAAAATTTATTTAACGAAGCACACACTACGGGTGTTTTAGTTATCCAACAAGGCCAAACTCAACAAAGCTATGGTAATGATCTTGCTCGTGCTTCGACCGAGTATGTACCTGCTTCGACCTTCAAAATGCTTAATGCTTTGATCGGCCTTGAGCACCATAAGGCAACCACCACAGAAGTATTTAAGTGGGATGGTAAAAAAAGGTTATTCCCAGAATGGGAAAAGGACATGACCCTAGGCGATGCCATGAAAGCTTCCGCTATTCCAGTTTATCAAGATTTAGCTCGTCGTATTGGACTTGAGCTCATGTCTAAGGAAGTGAAGCGTGTTGGTTATGGCAATGCAGATATCGGTACCCAAGTCGATAATTTTTGGCTGGTGGGTCCTTTAAAAATTACTCCTCAGCAAGAGGCACAGTTTGCTTACAAGCTAGCTAATAAAACGCTTCCATTTAGCCAAAAAGTCCAAGATGAAGTGCAATCCATGCTATTCATAGAAGAAAAGAATGGAAACAAAATATACGCAAAAAGTGGTTGGGGATGGGATGTAAACCCACAAGTAGGCTGGTTAACTGGATGGGTTGTTCAGCCTCAAGGGAATATTGTAGCGTTCTCCCTTAACTTAGAAATGAAAAAAGGAATACCTAG
421	gb|GU371926|-|50304-51165|ARO:3000903|TEM-33	ATGAGTATTCAACATTTTCGTGTCGCCCTTATTCCCTTTTTTGCGGCATTTTGC...TAA	861.0	46	852	806	861	ATGAGTATTCAACATTTCCGTGTCGCCCTTATTCCCTTTTTTGCGGCATTTTGCCTTCCTGTTTTTGCTCACCCAGAAACGCTGGTGAAAGTAAAAGATGCTGAAGATCAGTTGGGTGCACGAGTGGGTTACATCGAGCTGGATCTCAACAGCGGTAAGATCCTTGAGAGTTTTCGCCCCGAAGAACGTTTTCCAATGATGAGCACTTTTAAAGTTCTGCTATGTGGTGCGGTATTATCCCGTGTTGACGCCGGGCAAGAGCAACTCGGTCGCCGCATACACTATTCTCAGAATGACTTGGTTGAGTACTCACCAGTCACAGAAAAGCATCTTACGGATGGCATGACAGTAAGAGAATTATGCAGTGCTGCCATAACCATGAGTGATAACACTGCGGCCAACTTACTTCTGACAACGATCGGAGGACCGAAGGAGCTAACCGCTTTTTTGCACAACATGGGGGATCATGTAACCCGCCTTGATCGTTGGGAACCGGAGCTGAATGAAGCCATACCAAACGACGAGCGTGACACCACGATGCCTGCAGCAATGGCAACAACGTTGCGCAAACTATTAACTGGCGAACTACTTACTCTAGCTTCCCGGCAACAATTAATAGACTGGATGGAGGCGGATAAAGTTGCAGGACCACTTCTGCGCTCGGCCCTTCCGGCTGGCTGGTTTATTGCTGATAAATCTGGAGCCGGTGAGCGTGGATCTCGCGGTATCATTGCAGCACTGGGGCCAGATGGTAAGCCCTCCCGTATCGTAGTTATCTACACGACGGGGAGTCAGGCAACTATGGA
422	gb|FJ360884|+|213-1074|ARO:3001033|TEM-167	ATGAGTATTCAACATTTCCGTGTCGCCCTTATTCCCTTTTTTGCGGCATTTTGC...TAA	861.0	46	852	806	861	ATGAGTATTCAACATTTCCGTGTCGCCCTTATTCCCTTTTTTGCGGCATTTTGCCTTCCTGTTTTTGCTCACCCAGAAACGCTGGTGAAAGTAAAAGATGCTGAAGATCAGTTGGGTGCACGAGTGGGTTACATCGAGCTGGATCTCAACAGCGGTAAGATCCTTGAGAGTTTTCGCCCCGAAGAACGTTTTCCAATGATGAGCACTTTTAAAGTTCTGCTATGTGGTGCGGTATTATCCCGTGTTGACGCCGGGCAAGAGCAACTCGGTCGCCGCATACACTATTCTCAGAATGACTTGGTTGAGTACTCACCAGTCACAGAAAAGCATCTTACGGATGGCATGACAGTAAGAGAATTATGCAGTGCTGCCATAACCATGAGTGATAACACTGCGGCCAACTTACTTCTGACAACGATCGGAGGACCGAAGGAGCTAACCGCTTTTTTGCACAACATGGGGGATCATGTAACCCGCCTTGATCGTTGGGAACCGGAGCTGAATGAAGCCATACCAAACGACGAGCGTGACACCACGATGCCTGCAGCAATGGCAACAACGTTGCGCAAACTATTAACTGGCGAACTACTTACTCTAGCTTCCCGGCAACAATTAATAGACTGGATGGAGGCGGATAAAGTTGCAGGACCACTTCTGCGCTCGGCCCTTCCGGCTGGCTGGTTTATTGCTGATAAATCTGGAGCCGGTGAGCGTGGATCTCGCGGTATCATTGCAGCACTGGGGCCAGATGGTAAGCCCTCCCGTATCGTAGTTATCTACACGACGGGGAGTCAGGCAACTATGGA
423	gb|JX025022|+|0-825|ARO:3001680|OXA-242	ATGAACATTAAAACACTCTTACTTATAACAAGCGCTATTTTTATTTCAGCCTGC...TAG	825.0	54149	54919	770	825	ATGAACATTAAAGCACTCTTACTTATAACAAGCGCTATTTTTATTTCAGCCTGCTCACCTTATATAGTGACTGCTAATCCAAATCACAGCGCTTCAAAATCTGATGTAAAAGCAGAGAAAATTAAAAATTTATTTAACGAAGCACACACTACGGGTGTTTTAGTTATCCAACAAGGCCAAACTCAACAAAGCTATGGTAATGATCTTGCTCGTGCTTCGACCGAGTATGTACCTGCTTCGACCTTCAAAATGCTTAATGCTTTGATCGGCCTTGAGCACCATAAGGCAACCACCACAGAAGTATTTAAGTGGGATGGTAAAAAAAGGTTATTCCCAGAATGGGAAAAGGACATGACCCTAGGCGATGCCATGAAAGCTTCCGCTATTCCAGTTTATCAAGATTTAGCTCGTCGTATTGGACTTGAGCTCATGTCTAAGGAAGTGAAGCGTGTTGGTTATGGCAATGCAGATATCGGTACCCAAGTCGATAATTTTTGGCTGGTGGGTCCTTTAAAAATTACTCCTCAGCAAGAGGCACAGTTTGCTTACAAGCTAGCTAATAAAACGCTTCCATTTAGCCAAAAAGTCCAAGATGAAGTGCAATCCATGCTATTCATAGAAGAAAAGAATGGAAACAAAATATACGCAAAAAGTGGTTGGGGATGGGATGTAAACCCACAAGTAGGCTGGTTAACTGGATGGGTTGTTCAGCCTCAAGGGAATATTGTAGCGTTCTCCCTTAACTTAGAAATGAAAAAAGGAATACCTAG
424	gb|AY628176|+|75-936|ARO:3000987|TEM-125	ATGAGTATTCAACATTTCCGTGTCGCCCTTATTCCCTTTCTTGCGGCATTTTGC...TAA	861.0	46	852	806	861	ATGAGTATTCAACATTTCCGTGTCGCCCTTATTCCCTTTTTTGCGGCATTTTGCCTTCCTGTTTTTGCTCACCCAGAAACGCTGGTGAAAGTAAAAGATGCTGAAGATCAGTTGGGTGCACGAGTGGGTTACATCGAGCTGGATCTCAACAGCGGTAAGATCCTTGAGAGTTTTCGCCCCGAAGAACGTTTTCCAATGATGAGCACTTTTAAAGTTCTGCTATGTGGTGCGGTATTATCCCGTGTTGACGCCGGGCAAGAGCAACTCGGTCGCCGCATACACTATTCTCAGAATGACTTGGTTGAGTACTCACCAGTCACAGAAAAGCATCTTACGGATGGCATGACAGTAAGAGAATTATGCAGTGCTGCCATAACCATGAGTGATAACACTGCGGCCAACTTACTTCTGACAACGATCGGAGGACCGAAGGAGCTAACCGCTTTTTTGCACAACATGGGGGATCATGTAACCCGCCTTGATCGTTGGGAACCGGAGCTGAATGAAGCCATACCAAACGACGAGCGTGACACCACGATGCCTGCAGCAATGGCAACAACGTTGCGCAAACTATTAACTGGCGAACTACTTACTCTAGCTTCCCGGCAACAATTAATAGACTGGATGGAGGCGGATAAAGTTGCAGGACCACTTCTGCGCTCGGCCCTTCCGGCTGGCTGGTTTATTGCTGATAAATCTGGAGCCGGTGAGCGTGGATCTCGCGGTATCATTGCAGCACTGGGGCCAGATGGTAAGCCCTCCCGTATCGTAGTTATCTACACGACGGGGAGTCAGGCAACTATGGA
425	gb|KP881234.1|+|0-1152|ARO:3003880|ADC-74	ATGCGATTTAAAAAAATTTCTTGTCTACTTTTATCCCCGCTTTTTATTTTTAGT...TAA	1152.0	63	1160	1097	1152	ATGCGATTTAAAAAAATTTCTTGTCTACTTTTATCCCCGCTTTTTATTTTTAGTACCTCAATTTATGCGGGCAATACACCAAAAGACCAAGAAATTAAAAAACTGGTAGATCAAAACTTTAAACCGTTATTAGAAAAATATGATGTGCCAGGTATGGCTGTGGGTGTTATTCAAAATAATAAAAAGTATGAAATGTATTATGGTCTTCAATCTGTTCAAGATAAAAAAGCCGTAAATAGCAGTACTATTTTTGAGCTAGGTTCTGTCAGTAAATTATTTACCGCGACAGCAGGTGGATATGCAAAAAATAAAGGAAAAATCTCTTTTGACGATACGCCTGGTAAGTATTGGAAAGAACTAAAAAATACACCGATTGACCAAGTTAACTTACTTCAACTCGCGACGTATACAAGTGGTAACCTTGCCTTGCAATTTCCAGATGAAGTAAAAACAGATCAGCAAGTTTTAACATTTTTTAAAGACTGGAAACCTAAAAACTCAATCGGTGAATATCGACAATATTCAAACCCAAGCATTGGTTTATTTGGAAAAGTTGTAGCTTTGTCTATGAATAAACCTTTCGACCAAGTCTTAGAAAAAACAATTTTTCCGGCCCTTGGCTTAAAACATAGCTATGTAAATGTACCTAAGACCCAGATGCAAAACTATGCTTTTGGCTATAACCAAGAAAATCAGCCGATTCGAGTTAACCCCGGCCCACTCGATGCCCCAGCATATGGCGTCAAATCGACACTACCCGACATGTTGAGTTTTATTCATGCCAACCTAAATCCACAAAAATATCCAGCAGATATTCAACGGGCAATTAATGAAACACATCAGGGTCGCTATCAAGTAAATACCATGTATCAGGCACTCGGTTGGGAAGAGTTTTCTTATCCGGCAACGTTACAAACTTTATTAGACAGTAATTCAGAACAGATTGTGATGAAACCTAATAAAGTGACTGCTATTTCAAAGGAACCTTCAGTTAAGATGTACCATAAAACTGGCTCAACTACCGGTTTCGGAACATATGTGGTGTTTATTCCTAAAGAAAATATTGGTTTAGTCATGTTAACCAATAAACGTATTCC
426	gb|KC292503|+|4334-5195|ARO:3000904|TEM-34	ATGAGTATTCAACATTTTCGTGTCGCCCTTATTCCCTTTTTTGCGGCATTTTGC...TAA	861.0	46	852	806	861	ATGAGTATTCAACATTTCCGTGTCGCCCTTATTCCCTTTTTTGCGGCATTTTGCCTTCCTGTTTTTGCTCACCCAGAAACGCTGGTGAAAGTAAAAGATGCTGAAGATCAGTTGGGTGCACGAGTGGGTTACATCGAGCTGGATCTCAACAGCGGTAAGATCCTTGAGAGTTTTCGCCCCGAAGAACGTTTTCCAATGATGAGCACTTTTAAAGTTCTGCTATGTGGTGCGGTATTATCCCGTGTTGACGCCGGGCAAGAGCAACTCGGTCGCCGCATACACTATTCTCAGAATGACTTGGTTGAGTACTCACCAGTCACAGAAAAGCATCTTACGGATGGCATGACAGTAAGAGAATTATGCAGTGCTGCCATAACCATGAGTGATAACACTGCGGCCAACTTACTTCTGACAACGATCGGAGGACCGAAGGAGCTAACCGCTTTTTTGCACAACATGGGGGATCATGTAACCCGCCTTGATCGTTGGGAACCGGAGCTGAATGAAGCCATACCAAACGACGAGCGTGACACCACGATGCCTGCAGCAATGGCAACAACGTTGCGCAAACTATTAACTGGCGAACTACTTACTCTAGCTTCCCGGCAACAATTAATAGACTGGATGGAGGCGGATAAAGTTGCAGGACCACTTCTGCGCTCGGCCCTTCCGGCTGGCTGGTTTATTGCTGATAAATCTGGAGCCGGTGAGCGTGGATCTCGCGGTATCATTGCAGCACTGGGGCCAGATGGTAAGCCCTCCCGTATCGTAGTTATCTACACGACGGGGAGTCAGGCAACTATGGA
427	gb|FJ919776|+|208-1069|ARO:3001034|TEM-168	ATGAGTATTCAACATTTCCGTGTCGCCCTTATTCCCTTTTTTGCGGCATTTTGC...TAA	861.0	46	852	806	861	ATGAGTATTCAACATTTCCGTGTCGCCCTTATTCCCTTTTTTGCGGCATTTTGCCTTCCTGTTTTTGCTCACCCAGAAACGCTGGTGAAAGTAAAAGATGCTGAAGATCAGTTGGGTGCACGAGTGGGTTACATCGAGCTGGATCTCAACAGCGGTAAGATCCTTGAGAGTTTTCGCCCCGAAGAACGTTTTCCAATGATGAGCACTTTTAAAGTTCTGCTATGTGGTGCGGTATTATCCCGTGTTGACGCCGGGCAAGAGCAACTCGGTCGCCGCATACACTATTCTCAGAATGACTTGGTTGAGTACTCACCAGTCACAGAAAAGCATCTTACGGATGGCATGACAGTAAGAGAATTATGCAGTGCTGCCATAACCATGAGTGATAACACTGCGGCCAACTTACTTCTGACAACGATCGGAGGACCGAAGGAGCTAACCGCTTTTTTGCACAACATGGGGGATCATGTAACCCGCCTTGATCGTTGGGAACCGGAGCTGAATGAAGCCATACCAAACGACGAGCGTGACACCACGATGCCTGCAGCAATGGCAACAACGTTGCGCAAACTATTAACTGGCGAACTACTTACTCTAGCTTCCCGGCAACAATTAATAGACTGGATGGAGGCGGATAAAGTTGCAGGACCACTTCTGCGCTCGGCCCTTCCGGCTGGCTGGTTTATTGCTGATAAATCTGGAGCCGGTGAGCGTGGATCTCGCGGTATCATTGCAGCACTGGGGCCAGATGGTAAGCCCTCCCGTATCGTAGTTATCTACACGACGGGGAGTCAGGCAACTATGGA
428	gb|KR057756.1|+|0-1116|ARO:3004350|PDC-87	GATGAGGCCCCGGCGGATCGCCTGAAGGCACTGGTCGACGCCGCCGTACAACCG...TGA	1116.0	35591	36652	1061	1116	GATGAGGCCCCGGCGGATCGCCTGAAGGCACTGGTCGACGCCGCCGTACAACCGGTGATGAAGGCCAATGACATTCCGGGCCTGGCCGTAGCCATCAGCCTGAAAGGAGAACCGCATTACTTCAGCTATGGGCTGGCCTCGAAAGAGGACGGCCGCCGGGTGACGCCGGAGACCCTGTTCGAGATCGGCTCGGTGAGCAAGACCTTCACCGTCACCCTCGCCGGCTATGCCCTGGCCCAGGACAAGATGCGCCTCGACGACCGCGCCAGCCAGCACTGGCCGGCACTGCAGGGCAGCCGCTTCGACGGCATCAGCCTGCTCGACCTCGCGACCTATACCGCCGGCGGCTTGCCGCTGCAGTTCCCCGACTCGGTGCAGAAGGACCAGGCACAGATCCGCGACTACTACCGCCAGTGGCAGCCGACCTACGCGCCGGGCAGCCAGCGCCTCTATTCCAACCCGAGCATCGGCCTGTTCGGCTATCTCGCCGCGCGCAGCCTGGGCCAGCCGTTCGAACGGCTCATGGAGCAGCAATTGTTCCCGGCACTGGGCCTCGAACAGACCCACCTCGACGTGCCCGAGGCGGCGCTGGCGCAGTACGCCCAGGGCTACGGCAAGGACGACCGCCCGCTACGGGTCGGTCCCGGCCCGCTGGATGCCGAAGGCTACGGGGTGAAGACCAGCGCGGCCGACCTGCTGCGCTTCGTCGATGCCAACCTGCATCCGGAGCGCCTGGACAGGCCCTGGGCGCAGGCGCTCGATGCCACCCATCGCGGTTACTACAAGGTCGGCGACATGACCCAGGGCCTGGGCTGGGAAGCCTACGACTGGCCGATCTCCCTGAAGCGCCTGCAGGCCGGCAACTCGACGCCGATGGCGCTGCAACCACACAGGATCGCCAGGCTGCCCGCGCCACAGGCGCTGGAGGGCCAGCGCCTGCTGAACAAGACCGGCTCCACCAACGGCTTCGGCGCCTACGTGGCGTTCGTCCCGGGCCGCGACCTGGGCCTGGTGATCCTGGCCAACCGCAACTATCCCAATGCCGAGCGGGTGAAGATCGC
429	gb|KF711993|+|0-801|ARO:3001807|OXA-246	ATGAAAACATTTGCCGCATATGTAATTATCGCGTGTCTTTCGAGTACGGCATTA...TAA	801.0	659	1405	746	801	ATGAAAACATTTGCCGCATATGTAATTATCGCGTGTCTTTCGAGTACGGCATTAGCTGGTTCAATTACAGAAAATACGTCTTGGAACAAAGAGTTCTCTGCCGAAGCCGTCAATGGTGTCTTCGTGCTTTGTAAAAGTAGCAGTAAATCCTGCGCTACCAATGACTTAGCTCGTGCATCAAAGGAATATCTTCCAGCATCAACATTTAAGATCCCCAACGCAATTATCGGCCTAGAAACTGGTGTCATAAAGAATGAGCATCAGGTTTTCAAATGGGACGGAAAGCCAAGAGCCATGAAGCAATGGGAAAGAGACTTGACCTTAAGAGGGGCAATACAAGTTTCAGCTGTTCCCGTATTTCAACAAATCGCCAGAGAAGTTGGCGAAGTAAGAATGCAGAAATACCTTAAAAAATTTTCCTATGGCAACCAGAATATCAGTGGTGGCATTGACAAATTCTGGTTGGAAGGCCAGCTTAGAATTTCCGCAGTTAATCAAGTGGAGTTTCTAGAGTCTCTATATTTAAATAAATTGTCAGCATCTAAAGAAAACCAGCTAATAGTAAAAGAGGCTTTGGTAACGGAGGCGGCACCTGAATATCTAGTGCATTCAAAAACTGGTTTTTCTGGTGTGGGAACTGAGTCAAATCCTGGTGTCGCATGGTGGGTTGGGTGGGTTGAGAAGGAGACAGAGGTTTACTTTTTCGCCTTTAACATGGATATAGACAACGAAAGTAAGTTGCCGCT
430	gb|FJ873740|+|0-858|ARO:3001035|TEM-169	ATGAGTATTCAACATTTCCGTGTCGCCCTTATTCCCTTTTTTGCGGCATTTTGC...TGG	858.0	46	849	803	858	ATGAGTATTCAACATTTCCGTGTCGCCCTTATTCCCTTTTTTGCGGCATTTTGCCTTCCTGTTTTTGCTCACCCAGAAACGCTGGTGAAAGTAAAAGATGCTGAAGATCAGTTGGGTGCACGAGTGGGTTACATCGAGCTGGATCTCAACAGCGGTAAGATCCTTGAGAGTTTTCGCCCCGAAGAACGTTTTCCAATGATGAGCACTTTTAAAGTTCTGCTATGTGGTGCGGTATTATCCCGTGTTGACGCCGGGCAAGAGCAACTCGGTCGCCGCATACACTATTCTCAGAATGACTTGGTTGAGTACTCACCAGTCACAGAAAAGCATCTTACGGATGGCATGACAGTAAGAGAATTATGCAGTGCTGCCATAACCATGAGTGATAACACTGCGGCCAACTTACTTCTGACAACGATCGGAGGACCGAAGGAGCTAACCGCTTTTTTGCACAACATGGGGGATCATGTAACCCGCCTTGATCGTTGGGAACCGGAGCTGAATGAAGCCATACCAAACGACGAGCGTGACACCACGATGCCTGCAGCAATGGCAACAACGTTGCGCAAACTATTAACTGGCGAACTACTTACTCTAGCTTCCCGGCAACAATTAATAGACTGGATGGAGGCGGATAAAGTTGCAGGACCACTTCTGCGCTCGGCCCTTCCGGCTGGCTGGTTTATTGCTGATAAATCTGGAGCCGGTGAGCGTGGATCTCGCGGTATCATTGCAGCACTGGGGCCAGATGGTAAGCCCTCCCGTATCGTAGTTATCTACACGACGGGGAGTCAGGCAACTAT
431	gb|AY628199|+|203-1064|ARO:3000988|TEM-126	ATGAGTATTCAACATTTTCGTGTCGCCCTTATTCCCTTTTTTGCGGCATTTTGC...TAA	861.0	46	852	806	861	ATGAGTATTCAACATTTCCGTGTCGCCCTTATTCCCTTTTTTGCGGCATTTTGCCTTCCTGTTTTTGCTCACCCAGAAACGCTGGTGAAAGTAAAAGATGCTGAAGATCAGTTGGGTGCACGAGTGGGTTACATCGAGCTGGATCTCAACAGCGGTAAGATCCTTGAGAGTTTTCGCCCCGAAGAACGTTTTCCAATGATGAGCACTTTTAAAGTTCTGCTATGTGGTGCGGTATTATCCCGTGTTGACGCCGGGCAAGAGCAACTCGGTCGCCGCATACACTATTCTCAGAATGACTTGGTTGAGTACTCACCAGTCACAGAAAAGCATCTTACGGATGGCATGACAGTAAGAGAATTATGCAGTGCTGCCATAACCATGAGTGATAACACTGCGGCCAACTTACTTCTGACAACGATCGGAGGACCGAAGGAGCTAACCGCTTTTTTGCACAACATGGGGGATCATGTAACCCGCCTTGATCGTTGGGAACCGGAGCTGAATGAAGCCATACCAAACGACGAGCGTGACACCACGATGCCTGCAGCAATGGCAACAACGTTGCGCAAACTATTAACTGGCGAACTACTTACTCTAGCTTCCCGGCAACAATTAATAGACTGGATGGAGGCGGATAAAGTTGCAGGACCACTTCTGCGCTCGGCCCTTCCGGCTGGCTGGTTTATTGCTGATAAATCTGGAGCCGGTGAGCGTGGATCTCGCGGTATCATTGCAGCACTGGGGCCAGATGGTAAGCCCTCCCGTATCGTAGTTATCTACACGACGGGGAGTCAGGCAACTATGGA
432	gb|AF143804|+|0-861|ARO:3000959|TEM-92	ATGAGTATTAAACATTTCCGTGTCGCCCTTATTCCCTTTTTTGCGGCATTTTGC...TAA	861.0	46	852	806	861	ATGAGTATTCAACATTTCCGTGTCGCCCTTATTCCCTTTTTTGCGGCATTTTGCCTTCCTGTTTTTGCTCACCCAGAAACGCTGGTGAAAGTAAAAGATGCTGAAGATCAGTTGGGTGCACGAGTGGGTTACATCGAGCTGGATCTCAACAGCGGTAAGATCCTTGAGAGTTTTCGCCCCGAAGAACGTTTTCCAATGATGAGCACTTTTAAAGTTCTGCTATGTGGTGCGGTATTATCCCGTGTTGACGCCGGGCAAGAGCAACTCGGTCGCCGCATACACTATTCTCAGAATGACTTGGTTGAGTACTCACCAGTCACAGAAAAGCATCTTACGGATGGCATGACAGTAAGAGAATTATGCAGTGCTGCCATAACCATGAGTGATAACACTGCGGCCAACTTACTTCTGACAACGATCGGAGGACCGAAGGAGCTAACCGCTTTTTTGCACAACATGGGGGATCATGTAACCCGCCTTGATCGTTGGGAACCGGAGCTGAATGAAGCCATACCAAACGACGAGCGTGACACCACGATGCCTGCAGCAATGGCAACAACGTTGCGCAAACTATTAACTGGCGAACTACTTACTCTAGCTTCCCGGCAACAATTAATAGACTGGATGGAGGCGGATAAAGTTGCAGGACCACTTCTGCGCTCGGCCCTTCCGGCTGGCTGGTTTATTGCTGATAAATCTGGAGCCGGTGAGCGTGGATCTCGCGGTATCATTGCAGCACTGGGGCCAGATGGTAAGCCCTCCCGTATCGTAGTTATCTACACGACGGGGAGTCAGGCAACTATGGA
433	gb|LK391770.1|+|19707-20568|ARO:3000876|TEM-4	ATGAGTATTCAACATTTCCGTGTCGCCCTTATTCCCTTTTTTGCGGCATTTTGC...TAA	861.0	46	852	806	861	ATGAGTATTCAACATTTCCGTGTCGCCCTTATTCCCTTTTTTGCGGCATTTTGCCTTCCTGTTTTTGCTCACCCAGAAACGCTGGTGAAAGTAAAAGATGCTGAAGATCAGTTGGGTGCACGAGTGGGTTACATCGAGCTGGATCTCAACAGCGGTAAGATCCTTGAGAGTTTTCGCCCCGAAGAACGTTTTCCAATGATGAGCACTTTTAAAGTTCTGCTATGTGGTGCGGTATTATCCCGTGTTGACGCCGGGCAAGAGCAACTCGGTCGCCGCATACACTATTCTCAGAATGACTTGGTTGAGTACTCACCAGTCACAGAAAAGCATCTTACGGATGGCATGACAGTAAGAGAATTATGCAGTGCTGCCATAACCATGAGTGATAACACTGCGGCCAACTTACTTCTGACAACGATCGGAGGACCGAAGGAGCTAACCGCTTTTTTGCACAACATGGGGGATCATGTAACCCGCCTTGATCGTTGGGAACCGGAGCTGAATGAAGCCATACCAAACGACGAGCGTGACACCACGATGCCTGCAGCAATGGCAACAACGTTGCGCAAACTATTAACTGGCGAACTACTTACTCTAGCTTCCCGGCAACAATTAATAGACTGGATGGAGGCGGATAAAGTTGCAGGACCACTTCTGCGCTCGGCCCTTCCGGCTGGCTGGTTTATTGCTGATAAATCTGGAGCCGGTGAGCGTGGATCTCGCGGTATCATTGCAGCACTGGGGCCAGATGGTAAGCCCTCCCGTATCGTAGTTATCTACACGACGGGGAGTCAGGCAACTATGGA
434	gb|AJ318093|+|0-861|ARO:3000960|TEM-93	ATGAGTATTCAACATTTCCGTGTCGCCCTTATTCCCTTTTTTGCGGCATTTTGC...TAA	861.0	46	852	806	861	ATGAGTATTCAACATTTCCGTGTCGCCCTTATTCCCTTTTTTGCGGCATTTTGCCTTCCTGTTTTTGCTCACCCAGAAACGCTGGTGAAAGTAAAAGATGCTGAAGATCAGTTGGGTGCACGAGTGGGTTACATCGAGCTGGATCTCAACAGCGGTAAGATCCTTGAGAGTTTTCGCCCCGAAGAACGTTTTCCAATGATGAGCACTTTTAAAGTTCTGCTATGTGGTGCGGTATTATCCCGTGTTGACGCCGGGCAAGAGCAACTCGGTCGCCGCATACACTATTCTCAGAATGACTTGGTTGAGTACTCACCAGTCACAGAAAAGCATCTTACGGATGGCATGACAGTAAGAGAATTATGCAGTGCTGCCATAACCATGAGTGATAACACTGCGGCCAACTTACTTCTGACAACGATCGGAGGACCGAAGGAGCTAACCGCTTTTTTGCACAACATGGGGGATCATGTAACCCGCCTTGATCGTTGGGAACCGGAGCTGAATGAAGCCATACCAAACGACGAGCGTGACACCACGATGCCTGCAGCAATGGCAACAACGTTGCGCAAACTATTAACTGGCGAACTACTTACTCTAGCTTCCCGGCAACAATTAATAGACTGGATGGAGGCGGATAAAGTTGCAGGACCACTTCTGCGCTCGGCCCTTCCGGCTGGCTGGTTTATTGCTGATAAATCTGGAGCCGGTGAGCGTGGATCTCGCGGTATCATTGCAGCACTGGGGCCAGATGGTAAGCCCTCCCGTATCGTAGTTATCTACACGACGGGGAGTCAGGCAACTATGGA
435	gb|Y14574|+|0-861|ARO:3000888|TEM-17	ATGAGTATTCAACATTTCCGTGTCGCCCTTATTCCCTTTTTTGCGGCATTTTGC...TAA	861.0	46	852	806	861	ATGAGTATTCAACATTTCCGTGTCGCCCTTATTCCCTTTTTTGCGGCATTTTGCCTTCCTGTTTTTGCTCACCCAGAAACGCTGGTGAAAGTAAAAGATGCTGAAGATCAGTTGGGTGCACGAGTGGGTTACATCGAGCTGGATCTCAACAGCGGTAAGATCCTTGAGAGTTTTCGCCCCGAAGAACGTTTTCCAATGATGAGCACTTTTAAAGTTCTGCTATGTGGTGCGGTATTATCCCGTGTTGACGCCGGGCAAGAGCAACTCGGTCGCCGCATACACTATTCTCAGAATGACTTGGTTGAGTACTCACCAGTCACAGAAAAGCATCTTACGGATGGCATGACAGTAAGAGAATTATGCAGTGCTGCCATAACCATGAGTGATAACACTGCGGCCAACTTACTTCTGACAACGATCGGAGGACCGAAGGAGCTAACCGCTTTTTTGCACAACATGGGGGATCATGTAACCCGCCTTGATCGTTGGGAACCGGAGCTGAATGAAGCCATACCAAACGACGAGCGTGACACCACGATGCCTGCAGCAATGGCAACAACGTTGCGCAAACTATTAACTGGCGAACTACTTACTCTAGCTTCCCGGCAACAATTAATAGACTGGATGGAGGCGGATAAAGTTGCAGGACCACTTCTGCGCTCGGCCCTTCCGGCTGGCTGGTTTATTGCTGATAAATCTGGAGCCGGTGAGCGTGGATCTCGCGGTATCATTGCAGCACTGGGGCCAGATGGTAAGCCCTCCCGTATCGTAGTTATCTACACGACGGGGAGTCAGGCAACTATGGA
436	gb|KF986254|-|34-859|ARO:3001572|OXA-386	ATGAAGATTAAAGCACTCTTACTTATAACAAGCGCTATTTTTATTTCAGCCTGC...TAG	825.0	54149	54919	770	825	ATGAACATTAAAGCACTCTTACTTATAACAAGCGCTATTTTTATTTCAGCCTGCTCACCTTATATAGTGACTGCTAATCCAAATCACAGCGCTTCAAAATCTGATGTAAAAGCAGAGAAAATTAAAAATTTATTTAACGAAGCACACACTACGGGTGTTTTAGTTATCCAACAAGGCCAAACTCAACAAAGCTATGGTAATGATCTTGCTCGTGCTTCGACCGAGTATGTACCTGCTTCGACCTTCAAAATGCTTAATGCTTTGATCGGCCTTGAGCACCATAAGGCAACCACCACAGAAGTATTTAAGTGGGATGGTAAAAAAAGGTTATTCCCAGAATGGGAAAAGGACATGACCCTAGGCGATGCCATGAAAGCTTCCGCTATTCCAGTTTATCAAGATTTAGCTCGTCGTATTGGACTTGAGCTCATGTCTAAGGAAGTGAAGCGTGTTGGTTATGGCAATGCAGATATCGGTACCCAAGTCGATAATTTTTGGCTGGTGGGTCCTTTAAAAATTACTCCTCAGCAAGAGGCACAGTTTGCTTACAAGCTAGCTAATAAAACGCTTCCATTTAGCCAAAAAGTCCAAGATGAAGTGCAATCCATGCTATTCATAGAAGAAAAGAATGGAAACAAAATATACGCAAAAAGTGGTTGGGGATGGGATGTAAACCCACAAGTAGGCTGGTTAACTGGATGGGTTGTTCAGCCTCAAGGGAATATTGTAGCGTTCTCCCTTAACTTAGAAATGAAAAAAGGAATACCTAG
437	gb|KP881235.1|+|0-1152|ARO:3003881|ADC-75	ATGCGATTTAAAAAAATTTCTTGTCTACTTTTATCCCCGCTTTTTATTTTTAGT...TAA	1152.0	63	1160	1097	1152	ATGCGATTTAAAAAAATTTCTTGTCTACTTTTATCCCCGCTTTTTATTTTTAGTACCTCAATTTATGCGGGCAATACACCAAAAGACCAAGAAATTAAAAAACTGGTAGATCAAAACTTTAAACCGTTATTAGAAAAATATGATGTGCCAGGTATGGCTGTGGGTGTTATTCAAAATAATAAAAAGTATGAAATGTATTATGGTCTTCAATCTGTTCAAGATAAAAAAGCCGTAAATAGCAGTACTATTTTTGAGCTAGGTTCTGTCAGTAAATTATTTACCGCGACAGCAGGTGGATATGCAAAAAATAAAGGAAAAATCTCTTTTGACGATACGCCTGGTAAGTATTGGAAAGAACTAAAAAATACACCGATTGACCAAGTTAACTTACTTCAACTCGCGACGTATACAAGTGGTAACCTTGCCTTGCAATTTCCAGATGAAGTAAAAACAGATCAGCAAGTTTTAACATTTTTTAAAGACTGGAAACCTAAAAACTCAATCGGTGAATATCGACAATATTCAAACCCAAGCATTGGTTTATTTGGAAAAGTTGTAGCTTTGTCTATGAATAAACCTTTCGACCAAGTCTTAGAAAAAACAATTTTTCCGGCCCTTGGCTTAAAACATAGCTATGTAAATGTACCTAAGACCCAGATGCAAAACTATGCTTTTGGCTATAACCAAGAAAATCAGCCGATTCGAGTTAACCCCGGCCCACTCGATGCCCCAGCATATGGCGTCAAATCGACACTACCCGACATGTTGAGTTTTATTCATGCCAACCTAAATCCACAAAAATATCCAGCAGATATTCAACGGGCAATTAATGAAACACATCAGGGTCGCTATCAAGTAAATACCATGTATCAGGCACTCGGTTGGGAAGAGTTTTCTTATCCGGCAACGTTACAAACTTTATTAGACAGTAATTCAGAACAGATTGTGATGAAACCTAATAAAGTGACTGCTATTTCAAAGGAACCTTCAGTTAAGATGTACCATAAAACTGGCTCAACTACCGGTTTCGGAACATATGTGGTGTTTATTCCTAAAGAAAATATTGGTTTAGTCATGTTAACCAATAAACGTATTCC
438	gb|HE963769|+|0-825|ARO:3001673|OXA-248	ATGAACATTAAAGCACTCTTACTTATAACAAGCGCTATTTTTATTTCAGCCTGC...TAG	825.0	54149	54919	770	825	ATGAACATTAAAGCACTCTTACTTATAACAAGCGCTATTTTTATTTCAGCCTGCTCACCTTATATAGTGACTGCTAATCCAAATCACAGCGCTTCAAAATCTGATGTAAAAGCAGAGAAAATTAAAAATTTATTTAACGAAGCACACACTACGGGTGTTTTAGTTATCCAACAAGGCCAAACTCAACAAAGCTATGGTAATGATCTTGCTCGTGCTTCGACCGAGTATGTACCTGCTTCGACCTTCAAAATGCTTAATGCTTTGATCGGCCTTGAGCACCATAAGGCAACCACCACAGAAGTATTTAAGTGGGATGGTAAAAAAAGGTTATTCCCAGAATGGGAAAAGGACATGACCCTAGGCGATGCCATGAAAGCTTCCGCTATTCCAGTTTATCAAGATTTAGCTCGTCGTATTGGACTTGAGCTCATGTCTAAGGAAGTGAAGCGTGTTGGTTATGGCAATGCAGATATCGGTACCCAAGTCGATAATTTTTGGCTGGTGGGTCCTTTAAAAATTACTCCTCAGCAAGAGGCACAGTTTGCTTACAAGCTAGCTAATAAAACGCTTCCATTTAGCCAAAAAGTCCAAGATGAAGTGCAATCCATGCTATTCATAGAAGAAAAGAATGGAAACAAAATATACGCAAAAAGTGGTTGGGGATGGGATGTAAACCCACAAGTAGGCTGGTTAACTGGATGGGTTGTTCAGCCTCAAGGGAATATTGTAGCGTTCTCCCTTAACTTAGAAATGAAAAAAGGAATACCTAG
439	gb|AJ318094|+|0-861|ARO:3000961|TEM-94	ATGAGTATTCAACATTTCCGTGTCGCCCTTATTCCCTTTTTTGCGGCATTTTGC...TAA	861.0	46	852	806	861	ATGAGTATTCAACATTTCCGTGTCGCCCTTATTCCCTTTTTTGCGGCATTTTGCCTTCCTGTTTTTGCTCACCCAGAAACGCTGGTGAAAGTAAAAGATGCTGAAGATCAGTTGGGTGCACGAGTGGGTTACATCGAGCTGGATCTCAACAGCGGTAAGATCCTTGAGAGTTTTCGCCCCGAAGAACGTTTTCCAATGATGAGCACTTTTAAAGTTCTGCTATGTGGTGCGGTATTATCCCGTGTTGACGCCGGGCAAGAGCAACTCGGTCGCCGCATACACTATTCTCAGAATGACTTGGTTGAGTACTCACCAGTCACAGAAAAGCATCTTACGGATGGCATGACAGTAAGAGAATTATGCAGTGCTGCCATAACCATGAGTGATAACACTGCGGCCAACTTACTTCTGACAACGATCGGAGGACCGAAGGAGCTAACCGCTTTTTTGCACAACATGGGGGATCATGTAACCCGCCTTGATCGTTGGGAACCGGAGCTGAATGAAGCCATACCAAACGACGAGCGTGACACCACGATGCCTGCAGCAATGGCAACAACGTTGCGCAAACTATTAACTGGCGAACTACTTACTCTAGCTTCCCGGCAACAATTAATAGACTGGATGGAGGCGGATAAAGTTGCAGGACCACTTCTGCGCTCGGCCCTTCCGGCTGGCTGGTTTATTGCTGATAAATCTGGAGCCGGTGAGCGTGGATCTCGCGGTATCATTGCAGCACTGGGGCCAGATGGTAAGCCCTCCCGTATCGTAGTTATCTACACGACGGGGAGTCAGGCAACTATGGA
440	gb|GQ149347|+|5269-6130|ARO:3001037|TEM-171	ATGAGTATTCAACATTTCCGTGTCGCCCTTATTCCCTTTTTTGCGGCATTTTGC...TAA	861.0	46	852	806	861	ATGAGTATTCAACATTTCCGTGTCGCCCTTATTCCCTTTTTTGCGGCATTTTGCCTTCCTGTTTTTGCTCACCCAGAAACGCTGGTGAAAGTAAAAGATGCTGAAGATCAGTTGGGTGCACGAGTGGGTTACATCGAGCTGGATCTCAACAGCGGTAAGATCCTTGAGAGTTTTCGCCCCGAAGAACGTTTTCCAATGATGAGCACTTTTAAAGTTCTGCTATGTGGTGCGGTATTATCCCGTGTTGACGCCGGGCAAGAGCAACTCGGTCGCCGCATACACTATTCTCAGAATGACTTGGTTGAGTACTCACCAGTCACAGAAAAGCATCTTACGGATGGCATGACAGTAAGAGAATTATGCAGTGCTGCCATAACCATGAGTGATAACACTGCGGCCAACTTACTTCTGACAACGATCGGAGGACCGAAGGAGCTAACCGCTTTTTTGCACAACATGGGGGATCATGTAACCCGCCTTGATCGTTGGGAACCGGAGCTGAATGAAGCCATACCAAACGACGAGCGTGACACCACGATGCCTGCAGCAATGGCAACAACGTTGCGCAAACTATTAACTGGCGAACTACTTACTCTAGCTTCCCGGCAACAATTAATAGACTGGATGGAGGCGGATAAAGTTGCAGGACCACTTCTGCGCTCGGCCCTTCCGGCTGGCTGGTTTATTGCTGATAAATCTGGAGCCGGTGAGCGTGGATCTCGCGGTATCATTGCAGCACTGGGGCCAGATGGTAAGCCCTCCCGTATCGTAGTTATCTACACGACGGGGAGTCAGGCAACTATGGA
441	gb|FR717535|+|0-861|ARO:3000910|TEM-40	ATGAGTATTCAACATTTCCGTGTCGCCCTTATTCCCTTTTTTGCGGCATTTTGC...TAA	861.0	46	852	806	861	ATGAGTATTCAACATTTCCGTGTCGCCCTTATTCCCTTTTTTGCGGCATTTTGCCTTCCTGTTTTTGCTCACCCAGAAACGCTGGTGAAAGTAAAAGATGCTGAAGATCAGTTGGGTGCACGAGTGGGTTACATCGAGCTGGATCTCAACAGCGGTAAGATCCTTGAGAGTTTTCGCCCCGAAGAACGTTTTCCAATGATGAGCACTTTTAAAGTTCTGCTATGTGGTGCGGTATTATCCCGTGTTGACGCCGGGCAAGAGCAACTCGGTCGCCGCATACACTATTCTCAGAATGACTTGGTTGAGTACTCACCAGTCACAGAAAAGCATCTTACGGATGGCATGACAGTAAGAGAATTATGCAGTGCTGCCATAACCATGAGTGATAACACTGCGGCCAACTTACTTCTGACAACGATCGGAGGACCGAAGGAGCTAACCGCTTTTTTGCACAACATGGGGGATCATGTAACCCGCCTTGATCGTTGGGAACCGGAGCTGAATGAAGCCATACCAAACGACGAGCGTGACACCACGATGCCTGCAGCAATGGCAACAACGTTGCGCAAACTATTAACTGGCGAACTACTTACTCTAGCTTCCCGGCAACAATTAATAGACTGGATGGAGGCGGATAAAGTTGCAGGACCACTTCTGCGCTCGGCCCTTCCGGCTGGCTGGTTTATTGCTGATAAATCTGGAGCCGGTGAGCGTGGATCTCGCGGTATCATTGCAGCACTGGGGCCAGATGGTAAGCCCTCCCGTATCGTAGTTATCTACACGACGGGGAGTCAGGCAACTATGGA
442	gb|AY368236|+|0-861|ARO:3000989|TEM-127	ATGAGTATTCAACATTTTCGTGTCGCCCTTATTCCCTTTTTTGCGGCATTTTGC...TAA	861.0	46	852	806	861	ATGAGTATTCAACATTTCCGTGTCGCCCTTATTCCCTTTTTTGCGGCATTTTGCCTTCCTGTTTTTGCTCACCCAGAAACGCTGGTGAAAGTAAAAGATGCTGAAGATCAGTTGGGTGCACGAGTGGGTTACATCGAGCTGGATCTCAACAGCGGTAAGATCCTTGAGAGTTTTCGCCCCGAAGAACGTTTTCCAATGATGAGCACTTTTAAAGTTCTGCTATGTGGTGCGGTATTATCCCGTGTTGACGCCGGGCAAGAGCAACTCGGTCGCCGCATACACTATTCTCAGAATGACTTGGTTGAGTACTCACCAGTCACAGAAAAGCATCTTACGGATGGCATGACAGTAAGAGAATTATGCAGTGCTGCCATAACCATGAGTGATAACACTGCGGCCAACTTACTTCTGACAACGATCGGAGGACCGAAGGAGCTAACCGCTTTTTTGCACAACATGGGGGATCATGTAACCCGCCTTGATCGTTGGGAACCGGAGCTGAATGAAGCCATACCAAACGACGAGCGTGACACCACGATGCCTGCAGCAATGGCAACAACGTTGCGCAAACTATTAACTGGCGAACTACTTACTCTAGCTTCCCGGCAACAATTAATAGACTGGATGGAGGCGGATAAAGTTGCAGGACCACTTCTGCGCTCGGCCCTTCCGGCTGGCTGGTTTATTGCTGATAAATCTGGAGCCGGTGAGCGTGGATCTCGCGGTATCATTGCAGCACTGGGGCCAGATGGTAAGCCCTCCCGTATCGTAGTTATCTACACGACGGGGAGTCAGGCAACTATGGA
443	gb|AJ308558|+|181-1042|ARO:3000962|TEM-95	ATGAGTATTCAACATTTTCGTGTCGCCCTTATTCCCTTTTTTGCGGCATTTTGC...TAA	861.0	46	852	806	861	ATGAGTATTCAACATTTCCGTGTCGCCCTTATTCCCTTTTTTGCGGCATTTTGCCTTCCTGTTTTTGCTCACCCAGAAACGCTGGTGAAAGTAAAAGATGCTGAAGATCAGTTGGGTGCACGAGTGGGTTACATCGAGCTGGATCTCAACAGCGGTAAGATCCTTGAGAGTTTTCGCCCCGAAGAACGTTTTCCAATGATGAGCACTTTTAAAGTTCTGCTATGTGGTGCGGTATTATCCCGTGTTGACGCCGGGCAAGAGCAACTCGGTCGCCGCATACACTATTCTCAGAATGACTTGGTTGAGTACTCACCAGTCACAGAAAAGCATCTTACGGATGGCATGACAGTAAGAGAATTATGCAGTGCTGCCATAACCATGAGTGATAACACTGCGGCCAACTTACTTCTGACAACGATCGGAGGACCGAAGGAGCTAACCGCTTTTTTGCACAACATGGGGGATCATGTAACCCGCCTTGATCGTTGGGAACCGGAGCTGAATGAAGCCATACCAAACGACGAGCGTGACACCACGATGCCTGCAGCAATGGCAACAACGTTGCGCAAACTATTAACTGGCGAACTACTTACTCTAGCTTCCCGGCAACAATTAATAGACTGGATGGAGGCGGATAAAGTTGCAGGACCACTTCTGCGCTCGGCCCTTCCGGCTGGCTGGTTTATTGCTGATAAATCTGGAGCCGGTGAGCGTGGATCTCGCGGTATCATTGCAGCACTGGGGCCAGATGGTAAGCCCTCCCGTATCGTAGTTATCTACACGACGGGGAGTCAGGCAACTATGGA
444	gb|X98047|+|0-844|ARO:3000911|TEM-42	CAACATTTCCGTGTCGCCCTTATTCCCTTTTTTGCGGCATTTTGCCTTCCTGTT...AAG	843.0	55	843	788	843	CAACATTTCCGTGTCGCCCTTATTCCCTTTTTTGCGGCATTTTGCCTTCCTGTTTTTGCTCACCCAGAAACGCTGGTGAAAGTAAAAGATGCTGAAGATCAGTTGGGTGCACGAGTGGGTTACATCGAGCTGGATCTCAACAGCGGTAAGATCCTTGAGAGTTTTCGCCCCGAAGAACGTTTTCCAATGATGAGCACTTTTAAAGTTCTGCTATGTGGTGCGGTATTATCCCGTGTTGACGCCGGGCAAGAGCAACTCGGTCGCCGCATACACTATTCTCAGAATGACTTGGTTGAGTACTCACCAGTCACAGAAAAGCATCTTACGGATGGCATGACAGTAAGAGAATTATGCAGTGCTGCCATAACCATGAGTGATAACACTGCGGCCAACTTACTTCTGACAACGATCGGAGGACCGAAGGAGCTAACCGCTTTTTTGCACAACATGGGGGATCATGTAACCCGCCTTGATCGTTGGGAACCGGAGCTGAATGAAGCCATACCAAACGACGAGCGTGACACCACGATGCCTGCAGCAATGGCAACAACGTTGCGCAAACTATTAACTGGCGAACTACTTACTCTAGCTTCCCGGCAACAATTAATAGACTGGATGGAGGCGGATAAAGTTGCAGGACCACTTCTGCGCTCGGCCCTTCCGGCTGGCTGGTTTATTGCTGATAAATCTGGAGCCGGTGAGCGTGGATCTCGCGGTATCATTGCAGCACTGGGGCCAGATGGTAAGCCCTCCCGTATCGTAGTTATCTACACGACGGGGAGTCAGGC
445	gb|HE963770|+|0-825|ARO:3001674|OXA-249	ATGAACATTAAAGCACTCTTACTTATAACAAGCGCTATTTTTATTTCAGCCTGC...TAG	825.0	54149	54919	770	825	ATGAACATTAAAGCACTCTTACTTATAACAAGCGCTATTTTTATTTCAGCCTGCTCACCTTATATAGTGACTGCTAATCCAAATCACAGCGCTTCAAAATCTGATGTAAAAGCAGAGAAAATTAAAAATTTATTTAACGAAGCACACACTACGGGTGTTTTAGTTATCCAACAAGGCCAAACTCAACAAAGCTATGGTAATGATCTTGCTCGTGCTTCGACCGAGTATGTACCTGCTTCGACCTTCAAAATGCTTAATGCTTTGATCGGCCTTGAGCACCATAAGGCAACCACCACAGAAGTATTTAAGTGGGATGGTAAAAAAAGGTTATTCCCAGAATGGGAAAAGGACATGACCCTAGGCGATGCCATGAAAGCTTCCGCTATTCCAGTTTATCAAGATTTAGCTCGTCGTATTGGACTTGAGCTCATGTCTAAGGAAGTGAAGCGTGTTGGTTATGGCAATGCAGATATCGGTACCCAAGTCGATAATTTTTGGCTGGTGGGTCCTTTAAAAATTACTCCTCAGCAAGAGGCACAGTTTGCTTACAAGCTAGCTAATAAAACGCTTCCATTTAGCCAAAAAGTCCAAGATGAAGTGCAATCCATGCTATTCATAGAAGAAAAGAATGGAAACAAAATATACGCAAAAAGTGGTTGGGGATGGGATGTAAACCCACAAGTAGGCTGGTTAACTGGATGGGTTGTTCAGCCTCAAGGGAATATTGTAGCGTTCTCCCTTAACTTAGAAATGAAAAAAGGAATACCTAG
446	gb|AY368237|+|0-861|ARO:3000990|TEM-128	ATGAGTATTCAACATTTTCGTGTCGCCCTTATTCCCTTTTTTGCGGCATTTTGC...TAA	861.0	46	852	806	861	ATGAGTATTCAACATTTCCGTGTCGCCCTTATTCCCTTTTTTGCGGCATTTTGCCTTCCTGTTTTTGCTCACCCAGAAACGCTGGTGAAAGTAAAAGATGCTGAAGATCAGTTGGGTGCACGAGTGGGTTACATCGAGCTGGATCTCAACAGCGGTAAGATCCTTGAGAGTTTTCGCCCCGAAGAACGTTTTCCAATGATGAGCACTTTTAAAGTTCTGCTATGTGGTGCGGTATTATCCCGTGTTGACGCCGGGCAAGAGCAACTCGGTCGCCGCATACACTATTCTCAGAATGACTTGGTTGAGTACTCACCAGTCACAGAAAAGCATCTTACGGATGGCATGACAGTAAGAGAATTATGCAGTGCTGCCATAACCATGAGTGATAACACTGCGGCCAACTTACTTCTGACAACGATCGGAGGACCGAAGGAGCTAACCGCTTTTTTGCACAACATGGGGGATCATGTAACCCGCCTTGATCGTTGGGAACCGGAGCTGAATGAAGCCATACCAAACGACGAGCGTGACACCACGATGCCTGCAGCAATGGCAACAACGTTGCGCAAACTATTAACTGGCGAACTACTTACTCTAGCTTCCCGGCAACAATTAATAGACTGGATGGAGGCGGATAAAGTTGCAGGACCACTTCTGCGCTCGGCCCTTCCGGCTGGCTGGTTTATTGCTGATAAATCTGGAGCCGGTGAGCGTGGATCTCGCGGTATCATTGCAGCACTGGGGCCAGATGGTAAGCCCTCCCGTATCGTAGTTATCTACACGACGGGGAGTCAGGCAACTATGGA
447	gb|AY092401|+|0-861|ARO:3000963|TEM-96	ATGAGTATTCAACATTTCCGTGTCGCCCTTATTCCCTTTTTTGCGGCATTTTGC...TAA	861.0	46	852	806	861	ATGAGTATTCAACATTTCCGTGTCGCCCTTATTCCCTTTTTTGCGGCATTTTGCCTTCCTGTTTTTGCTCACCCAGAAACGCTGGTGAAAGTAAAAGATGCTGAAGATCAGTTGGGTGCACGAGTGGGTTACATCGAGCTGGATCTCAACAGCGGTAAGATCCTTGAGAGTTTTCGCCCCGAAGAACGTTTTCCAATGATGAGCACTTTTAAAGTTCTGCTATGTGGTGCGGTATTATCCCGTGTTGACGCCGGGCAAGAGCAACTCGGTCGCCGCATACACTATTCTCAGAATGACTTGGTTGAGTACTCACCAGTCACAGAAAAGCATCTTACGGATGGCATGACAGTAAGAGAATTATGCAGTGCTGCCATAACCATGAGTGATAACACTGCGGCCAACTTACTTCTGACAACGATCGGAGGACCGAAGGAGCTAACCGCTTTTTTGCACAACATGGGGGATCATGTAACCCGCCTTGATCGTTGGGAACCGGAGCTGAATGAAGCCATACCAAACGACGAGCGTGACACCACGATGCCTGCAGCAATGGCAACAACGTTGCGCAAACTATTAACTGGCGAACTACTTACTCTAGCTTCCCGGCAACAATTAATAGACTGGATGGAGGCGGATAAAGTTGCAGGACCACTTCTGCGCTCGGCCCTTCCGGCTGGCTGGTTTATTGCTGATAAATCTGGAGCCGGTGAGCGTGGATCTCGCGGTATCATTGCAGCACTGGGGCCAGATGGTAAGCCCTCCCGTATCGTAGTTATCTACACGACGGGGAGTCAGGCAACTATGGA
448	gb|KJ173478|+|0-825|ARO:3001573|OXA-387	ATGAACATTAAAACACTCTTACTTATAACAAGCGCTATTTTTATTTCAGCCTGC...TAG	825.0	54149	54919	770	825	ATGAACATTAAAGCACTCTTACTTATAACAAGCGCTATTTTTATTTCAGCCTGCTCACCTTATATAGTGACTGCTAATCCAAATCACAGCGCTTCAAAATCTGATGTAAAAGCAGAGAAAATTAAAAATTTATTTAACGAAGCACACACTACGGGTGTTTTAGTTATCCAACAAGGCCAAACTCAACAAAGCTATGGTAATGATCTTGCTCGTGCTTCGACCGAGTATGTACCTGCTTCGACCTTCAAAATGCTTAATGCTTTGATCGGCCTTGAGCACCATAAGGCAACCACCACAGAAGTATTTAAGTGGGATGGTAAAAAAAGGTTATTCCCAGAATGGGAAAAGGACATGACCCTAGGCGATGCCATGAAAGCTTCCGCTATTCCAGTTTATCAAGATTTAGCTCGTCGTATTGGACTTGAGCTCATGTCTAAGGAAGTGAAGCGTGTTGGTTATGGCAATGCAGATATCGGTACCCAAGTCGATAATTTTTGGCTGGTGGGTCCTTTAAAAATTACTCCTCAGCAAGAGGCACAGTTTGCTTACAAGCTAGCTAATAAAACGCTTCCATTTAGCCAAAAAGTCCAAGATGAAGTGCAATCCATGCTATTCATAGAAGAAAAGAATGGAAACAAAATATACGCAAAAAGTGGTTGGGGATGGGATGTAAACCCACAAGTAGGCTGGTTAACTGGATGGGTTGTTCAGCCTCAAGGGAATATTGTAGCGTTCTCCCTTAACTTAGAAATGAAAAAAGGAATACCTAG
449	gb|AJ746225|+|0-861|ARO:3000993|TEM-129	ATGAGTATTCAACATTTTCGTGTCGCCCTTATTCCCTTTTTTGCGGCATTTTGC...TAA	861.0	46	852	806	861	ATGAGTATTCAACATTTCCGTGTCGCCCTTATTCCCTTTTTTGCGGCATTTTGCCTTCCTGTTTTTGCTCACCCAGAAACGCTGGTGAAAGTAAAAGATGCTGAAGATCAGTTGGGTGCACGAGTGGGTTACATCGAGCTGGATCTCAACAGCGGTAAGATCCTTGAGAGTTTTCGCCCCGAAGAACGTTTTCCAATGATGAGCACTTTTAAAGTTCTGCTATGTGGTGCGGTATTATCCCGTGTTGACGCCGGGCAAGAGCAACTCGGTCGCCGCATACACTATTCTCAGAATGACTTGGTTGAGTACTCACCAGTCACAGAAAAGCATCTTACGGATGGCATGACAGTAAGAGAATTATGCAGTGCTGCCATAACCATGAGTGATAACACTGCGGCCAACTTACTTCTGACAACGATCGGAGGACCGAAGGAGCTAACCGCTTTTTTGCACAACATGGGGGATCATGTAACCCGCCTTGATCGTTGGGAACCGGAGCTGAATGAAGCCATACCAAACGACGAGCGTGACACCACGATGCCTGCAGCAATGGCAACAACGTTGCGCAAACTATTAACTGGCGAACTACTTACTCTAGCTTCCCGGCAACAATTAATAGACTGGATGGAGGCGGATAAAGTTGCAGGACCACTTCTGCGCTCGGCCCTTCCGGCTGGCTGGTTTATTGCTGATAAATCTGGAGCCGGTGAGCGTGGATCTCGCGGTATCATTGCAGCACTGGGGCCAGATGGTAAGCCCTCCCGTATCGTAGTTATCTACACGACGGGGAGTCAGGCAACTATGGA
450	gb|U95363|+|0-861|ARO:3000912|TEM-43	ATGAGTATTCAACATTTCCGTGTCGCCCTTATTCCCTTTTTTGCGGCATTTTGC...TAA	861.0	46	852	806	861	ATGAGTATTCAACATTTCCGTGTCGCCCTTATTCCCTTTTTTGCGGCATTTTGCCTTCCTGTTTTTGCTCACCCAGAAACGCTGGTGAAAGTAAAAGATGCTGAAGATCAGTTGGGTGCACGAGTGGGTTACATCGAGCTGGATCTCAACAGCGGTAAGATCCTTGAGAGTTTTCGCCCCGAAGAACGTTTTCCAATGATGAGCACTTTTAAAGTTCTGCTATGTGGTGCGGTATTATCCCGTGTTGACGCCGGGCAAGAGCAACTCGGTCGCCGCATACACTATTCTCAGAATGACTTGGTTGAGTACTCACCAGTCACAGAAAAGCATCTTACGGATGGCATGACAGTAAGAGAATTATGCAGTGCTGCCATAACCATGAGTGATAACACTGCGGCCAACTTACTTCTGACAACGATCGGAGGACCGAAGGAGCTAACCGCTTTTTTGCACAACATGGGGGATCATGTAACCCGCCTTGATCGTTGGGAACCGGAGCTGAATGAAGCCATACCAAACGACGAGCGTGACACCACGATGCCTGCAGCAATGGCAACAACGTTGCGCAAACTATTAACTGGCGAACTACTTACTCTAGCTTCCCGGCAACAATTAATAGACTGGATGGAGGCGGATAAAGTTGCAGGACCACTTCTGCGCTCGGCCCTTCCGGCTGGCTGGTTTATTGCTGATAAATCTGGAGCCGGTGAGCGTGGATCTCGCGGTATCATTGCAGCACTGGGGCCAGATGGTAAGCCCTCCCGTATCGTAGTTATCTACACGACGGGGAGTCAGGCAACTATGGA
451	gb|GU550123|+|144-1005|ARO:3001041|TEM-176	ATGAGTATTCAACATTTTCGTGTCGCCCTTATTCCCTTTTTTGCGGCATTTTGC...TAA	861.0	46	852	806	861	ATGAGTATTCAACATTTCCGTGTCGCCCTTATTCCCTTTTTTGCGGCATTTTGCCTTCCTGTTTTTGCTCACCCAGAAACGCTGGTGAAAGTAAAAGATGCTGAAGATCAGTTGGGTGCACGAGTGGGTTACATCGAGCTGGATCTCAACAGCGGTAAGATCCTTGAGAGTTTTCGCCCCGAAGAACGTTTTCCAATGATGAGCACTTTTAAAGTTCTGCTATGTGGTGCGGTATTATCCCGTGTTGACGCCGGGCAAGAGCAACTCGGTCGCCGCATACACTATTCTCAGAATGACTTGGTTGAGTACTCACCAGTCACAGAAAAGCATCTTACGGATGGCATGACAGTAAGAGAATTATGCAGTGCTGCCATAACCATGAGTGATAACACTGCGGCCAACTTACTTCTGACAACGATCGGAGGACCGAAGGAGCTAACCGCTTTTTTGCACAACATGGGGGATCATGTAACCCGCCTTGATCGTTGGGAACCGGAGCTGAATGAAGCCATACCAAACGACGAGCGTGACACCACGATGCCTGCAGCAATGGCAACAACGTTGCGCAAACTATTAACTGGCGAACTACTTACTCTAGCTTCCCGGCAACAATTAATAGACTGGATGGAGGCGGATAAAGTTGCAGGACCACTTCTGCGCTCGGCCCTTCCGGCTGGCTGGTTTATTGCTGATAAATCTGGAGCCGGTGAGCGTGGATCTCGCGGTATCATTGCAGCACTGGGGCCAGATGGTAAGCCCTCCCGTATCGTAGTTATCTACACGACGGGGAGTCAGGCAACTATGGA
452	gb|X95401|+|208-1069|ARO:3000914|TEM-45	ATGAGTATTCAACATTTCCGTGTCGCCCTTATTCCCTTTTTTGCGGCATTTTGC...TAA	861.0	46	852	806	861	ATGAGTATTCAACATTTCCGTGTCGCCCTTATTCCCTTTTTTGCGGCATTTTGCCTTCCTGTTTTTGCTCACCCAGAAACGCTGGTGAAAGTAAAAGATGCTGAAGATCAGTTGGGTGCACGAGTGGGTTACATCGAGCTGGATCTCAACAGCGGTAAGATCCTTGAGAGTTTTCGCCCCGAAGAACGTTTTCCAATGATGAGCACTTTTAAAGTTCTGCTATGTGGTGCGGTATTATCCCGTGTTGACGCCGGGCAAGAGCAACTCGGTCGCCGCATACACTATTCTCAGAATGACTTGGTTGAGTACTCACCAGTCACAGAAAAGCATCTTACGGATGGCATGACAGTAAGAGAATTATGCAGTGCTGCCATAACCATGAGTGATAACACTGCGGCCAACTTACTTCTGACAACGATCGGAGGACCGAAGGAGCTAACCGCTTTTTTGCACAACATGGGGGATCATGTAACCCGCCTTGATCGTTGGGAACCGGAGCTGAATGAAGCCATACCAAACGACGAGCGTGACACCACGATGCCTGCAGCAATGGCAACAACGTTGCGCAAACTATTAACTGGCGAACTACTTACTCTAGCTTCCCGGCAACAATTAATAGACTGGATGGAGGCGGATAAAGTTGCAGGACCACTTCTGCGCTCGGCCCTTCCGGCTGGCTGGTTTATTGCTGATAAATCTGGAGCCGGTGAGCGTGGATCTCGCGGTATCATTGCAGCACTGGGGCCAGATGGTAAGCCCTCCCGTATCGTAGTTATCTACACGACGGGGAGTCAGGCAACTATGGA
453	gb|AF441287|+|260-1007|ARO:3000844|TUS-1_beta-lactamase	ATGTACCACTACTTTAGCAGTTTATTTGTACTGATTTTTTCTACTTTGGTCTAT...TAA	747.0	12189	12881	692	747	ATGTACCACTACTTTAGCAGTTTATTTGTACTGATTTTTTCTACTTTGGTCTATCCTCAATCGGATAAATTAAAAATTGAGCCGTTGAACGATCATATGTATGTCTATACGACCTACCAAGTATTTCAAGGCGTCGAATATTCTTCCAATGCTTTATATGTAGTGACGGATGAAGGAGTAATTCTCATTGATACCCCTTGGGATAAAGATCAGTACGCCCCTTTAGTAGAACACATCAGACGTGAACATAACAAAGAAATAAAATGGGTCATTACCACTCACTTCCACGAAGATCGTTCGGGTGGACTTGATTACTTCAATAAAGCTGGAGCAGAAACCTATACTTATGCTTTGACCAACGAAATCTTAAAACAGCGCAATGAACCACAAGCGACTTTTACTTTTGGTTCAACAAAGCAGTTCAACTTGGGCAAAGAAAAAATAGAGGTCTATTTCTTAGGAGAAGGTCATAGTAAAGATAATACGGTGGTTTGGTTTCCAGAAGAAGCGATTTTATACGGTGGTTGTTTGATTAAAAGTGCAGAGGCAACGACTATCGGCAATATCGTCGATGGCAATGTAGAGGCTTGGCCTACGACAATCAAAGCCGTAAAGCGCAAATTCAAAAAGGCCAAAGTGATTATTCCAGGGCATGATGCCTGGAATCAATCCGGTCATCTTGAAAATACAGC
454	gb|AJ866988|+|0-861|ARO:3000994|TEM-130	ATGAGTATTCAACATTTTCGTGTCGCCCTTATTCCCTTTTTTGCGGCATTTTGC...TAA	861.0	46	852	806	861	ATGAGTATTCAACATTTCCGTGTCGCCCTTATTCCCTTTTTTGCGGCATTTTGCCTTCCTGTTTTTGCTCACCCAGAAACGCTGGTGAAAGTAAAAGATGCTGAAGATCAGTTGGGTGCACGAGTGGGTTACATCGAGCTGGATCTCAACAGCGGTAAGATCCTTGAGAGTTTTCGCCCCGAAGAACGTTTTCCAATGATGAGCACTTTTAAAGTTCTGCTATGTGGTGCGGTATTATCCCGTGTTGACGCCGGGCAAGAGCAACTCGGTCGCCGCATACACTATTCTCAGAATGACTTGGTTGAGTACTCACCAGTCACAGAAAAGCATCTTACGGATGGCATGACAGTAAGAGAATTATGCAGTGCTGCCATAACCATGAGTGATAACACTGCGGCCAACTTACTTCTGACAACGATCGGAGGACCGAAGGAGCTAACCGCTTTTTTGCACAACATGGGGGATCATGTAACCCGCCTTGATCGTTGGGAACCGGAGCTGAATGAAGCCATACCAAACGACGAGCGTGACACCACGATGCCTGCAGCAATGGCAACAACGTTGCGCAAACTATTAACTGGCGAACTACTTACTCTAGCTTCCCGGCAACAATTAATAGACTGGATGGAGGCGGATAAAGTTGCAGGACCACTTCTGCGCTCGGCCCTTCCGGCTGGCTGGTTTATTGCTGATAAATCTGGAGCCGGTGAGCGTGGATCTCGCGGTATCATTGCAGCACTGGGGCCAGATGGTAAGCCCTCCCGTATCGTAGTTATCTACACGACGGGGAGTCAGGCAACTATGGA
455	gb|KR057757.1|+|0-1110|ARO:3004351|PDC-88	GATGAGGCCCCGGCGGATCGCCTGAAGGCACTGGTCGACGCCGCCGTACAACCG...TGA	1110.0	35591	36652	1061	1110	GATGAGGCCCCGGCGGATCGCCTGAAGGCACTGGTCGACGCCGCCGTACAACCGGTGATGAAGGCCAATGACATTCCGGGCCTGGCCGTAGCCATCAGCCTGAAAGGAGAACCGCATTACTTCAGCTATGGGCTGGCCTCGAAAGAGGACGGCCGCCGGGTGACGCCGGAGACCCTGTTCGAGATCGGCTCGGTGAGCAAGACCTTCACCGTCACCCTCGCCGGCTATGCCCTGGCCCAGGACAAGATGCGCCTCGACGACCGCGCCAGCCAGCACTGGCCGGCACTGCAGGGCAGCCGCTTCGACGGCATCAGCCTGCTCGACCTCGCGACCTATACCGCCGGCGGCTTGCCGCTGCAGTTCCCCGACTCGGTGCAGAAGGACCAGGCACAGATCCGCGACTACTACCGCCAGTGGCAGCCGACCTACGCGCCGGGCAGCCAGCGCCTCTATTCCAACCCGAGCATCGGCCTGTTCGGCTATCTCGCCGCGCGCAGCCTGGGCCAGCCGTTCGAACGGCTCATGGAGCAGCAATTGTTCCCGGCACTGGGCCTCGAACAGACCCACCTCGACGTGCCCGAGGCGGCGCTGGCGCAGTACGCCCAGGGCTACGGCAAGGACGACCGCCCGCTACGGGTCGGTCCCGGCCCGCTGGATGCCGAAGGCTACGGGGTGAAGACCAGCGCGGCCGACCTGCTGCGCTTCGTCGATGCCAACCTGCATCCGGAGCGCCTGGACAGGCCCTGGGCGCAGGCGCTCGATGCCACCCATCGCGGTTACTACAAGGTCGGCGACATGACCCAGGGCCTGGGCTGGGAAGCCTACGACTGGCCGATCTCCCTGAAGCGCCTGCAGGCCGGCAACTCGACGCCGATGGCGCTGCAACCACACAGGATCGCCAGGCTGCCCGCGCCACAGGCGCTGGAGGGCCAGCGCCTGCTGAACAAGACCGGCTCCACCAACGGCTTCGGCGCCTACGTGGCGTTCGTCCCGGGCCGCGACCTGGGCCTGGTGATCCTGGCCAACCGCAACTATCCCAATGCCGAGCGGGTGAAGATCGC
456	gb|AY436361|+|131-992|ARO:3000995|TEM-131	ATGAGTATTCAACATTTCCGTGTCGCCCTTATTCCCTTTTTTGCGGCATTTTGC...TAA	861.0	46	852	806	861	ATGAGTATTCAACATTTCCGTGTCGCCCTTATTCCCTTTTTTGCGGCATTTTGCCTTCCTGTTTTTGCTCACCCAGAAACGCTGGTGAAAGTAAAAGATGCTGAAGATCAGTTGGGTGCACGAGTGGGTTACATCGAGCTGGATCTCAACAGCGGTAAGATCCTTGAGAGTTTTCGCCCCGAAGAACGTTTTCCAATGATGAGCACTTTTAAAGTTCTGCTATGTGGTGCGGTATTATCCCGTGTTGACGCCGGGCAAGAGCAACTCGGTCGCCGCATACACTATTCTCAGAATGACTTGGTTGAGTACTCACCAGTCACAGAAAAGCATCTTACGGATGGCATGACAGTAAGAGAATTATGCAGTGCTGCCATAACCATGAGTGATAACACTGCGGCCAACTTACTTCTGACAACGATCGGAGGACCGAAGGAGCTAACCGCTTTTTTGCACAACATGGGGGATCATGTAACCCGCCTTGATCGTTGGGAACCGGAGCTGAATGAAGCCATACCAAACGACGAGCGTGACACCACGATGCCTGCAGCAATGGCAACAACGTTGCGCAAACTATTAACTGGCGAACTACTTACTCTAGCTTCCCGGCAACAATTAATAGACTGGATGGAGGCGGATAAAGTTGCAGGACCACTTCTGCGCTCGGCCCTTCCGGCTGGCTGGTTTATTGCTGATAAATCTGGAGCCGGTGAGCGTGGATCTCGCGGTATCATTGCAGCACTGGGGCCAGATGGTAAGCCCTCCCGTATCGTAGTTATCTACACGACGGGGAGTCAGGCAACTATGGA
457	gb|HE963771|+|0-825|ARO:3001675|OXA-250	ATGAACATTAAAGCACTCTTACTTATAACAAGCGCTATTTTTATTTCAGCCTGC...TAG	825.0	54149	54919	770	825	ATGAACATTAAAGCACTCTTACTTATAACAAGCGCTATTTTTATTTCAGCCTGCTCACCTTATATAGTGACTGCTAATCCAAATCACAGCGCTTCAAAATCTGATGTAAAAGCAGAGAAAATTAAAAATTTATTTAACGAAGCACACACTACGGGTGTTTTAGTTATCCAACAAGGCCAAACTCAACAAAGCTATGGTAATGATCTTGCTCGTGCTTCGACCGAGTATGTACCTGCTTCGACCTTCAAAATGCTTAATGCTTTGATCGGCCTTGAGCACCATAAGGCAACCACCACAGAAGTATTTAAGTGGGATGGTAAAAAAAGGTTATTCCCAGAATGGGAAAAGGACATGACCCTAGGCGATGCCATGAAAGCTTCCGCTATTCCAGTTTATCAAGATTTAGCTCGTCGTATTGGACTTGAGCTCATGTCTAAGGAAGTGAAGCGTGTTGGTTATGGCAATGCAGATATCGGTACCCAAGTCGATAATTTTTGGCTGGTGGGTCCTTTAAAAATTACTCCTCAGCAAGAGGCACAGTTTGCTTACAAGCTAGCTAATAAAACGCTTCCATTTAGCCAAAAAGTCCAAGATGAAGTGCAATCCATGCTATTCATAGAAGAAAAGAATGGAAACAAAATATACGCAAAAAGTGGTTGGGGATGGGATGTAAACCCACAAGTAGGCTGGTTAACTGGATGGGTTGTTCAGCCTCAAGGGAATATTGTAGCGTTCTCCCTTAACTTAGAAATGAAAAAAGGAATACCTAG
458	gb|AE003852.1|+|1674272-1675445|ARO:3004289|Vibrio_cholerae_varG	ATGTTTGTTTCTCATTTATCTTTTCCCCACCTGATTGAGGAGAGAAAAATGAAA...TAA	1173.0	676	1794	1118	1173	ATGTTTGTTTCTCATTTATCTTTTCCCCACCTGATTGAGGAGAGAAAAATGAAACTATCCACCTTAGCTTTAGCCCCTATTACTGCAGCACTACTTACTTTTAATGCAAGTGCTAAAGGCCATGACCACGACAATCAACGCGCGATTTTTTTCCCTGGTGAAACTGTTCAAGACACTGTGAAAGTCGAAGTTGAGCCTTCTGCGACTCAGTCTCTGAAACTGGGACAAAAAATTAATAATCTGTATGAGCGCCAGTTTGATAACAGCCAAGCCACCGTTCAAAAATTGGGCAAGAATACCTACTGGATAGGGGTCAATTATTACAACGCTACCGTTGTGGTTAACGAAGACTCTGTCTTGCTGATTGACCCACTAGGCGATGGTCGTATTGATGCGCTTTTTAAAGGGGTGCAATCCATCACGAATAAACCGATCACTACGATTATGTATTCTCACTACCACTTAGATCATTTAGGTGGTGGCAACCAACTGGTTGACTTAATTAAGAAAAATTATCCAAAAGTAGATAAAATCCGCGTTATTGCTAGCCAAACCGTTGCGGACAAGATCAACCAACACGCCGAAGTAGGCGAAAACGGTGTGAAAACCCCGAAAGTTCCAGCGCCGAATGACATATACGACCTGACGAAGCCTCAAACGGTTCAATTTGGCTCAATGAAAATCAAGATGATGGCACCAAAAGGCTCTGGCCATACACCTGATAACACCATGATTCTGATCCCAAGCGATCGCGTGTTGCATTTCGCGGACATGATTAATCCCGATCAACTACCGTTTTACAATTTCGCGGGAGCAGAACATTTCCACGGTTACGAAGAAGATCTACAAAGCCTTCTGAGCAAACCGCTGAGCAAACAGTGGGACTTTATTAACGGTGGCCATGGCAATATAGGTTCGAAACAGGATGTAAAAGATCTGCTTGAGTATATTGCGGACATCAGAACTGAAGTGGGCAAGCAGCTAGAAGTCGCCCCCTACACTCCAGTGTTGAGTGACGGTAACCACTTTGTTTGGTTCAAACGCTGGCAAGATGAGATCACTAACAATGTACATACCGCACTGGCAAACAAGTATGGCCACATGTACGGTTTCGATTC
459	gb|Y10279|+|0-861|ARO:3000916|TEM-47	ATGAGTATTCAACATTTTCGTGTCGCCCTTATTCCCTTTTTTGCGGCATTTTGC...TAA	861.0	46	852	806	861	ATGAGTATTCAACATTTCCGTGTCGCCCTTATTCCCTTTTTTGCGGCATTTTGCCTTCCTGTTTTTGCTCACCCAGAAACGCTGGTGAAAGTAAAAGATGCTGAAGATCAGTTGGGTGCACGAGTGGGTTACATCGAGCTGGATCTCAACAGCGGTAAGATCCTTGAGAGTTTTCGCCCCGAAGAACGTTTTCCAATGATGAGCACTTTTAAAGTTCTGCTATGTGGTGCGGTATTATCCCGTGTTGACGCCGGGCAAGAGCAACTCGGTCGCCGCATACACTATTCTCAGAATGACTTGGTTGAGTACTCACCAGTCACAGAAAAGCATCTTACGGATGGCATGACAGTAAGAGAATTATGCAGTGCTGCCATAACCATGAGTGATAACACTGCGGCCAACTTACTTCTGACAACGATCGGAGGACCGAAGGAGCTAACCGCTTTTTTGCACAACATGGGGGATCATGTAACCCGCCTTGATCGTTGGGAACCGGAGCTGAATGAAGCCATACCAAACGACGAGCGTGACACCACGATGCCTGCAGCAATGGCAACAACGTTGCGCAAACTATTAACTGGCGAACTACTTACTCTAGCTTCCCGGCAACAATTAATAGACTGGATGGAGGCGGATAAAGTTGCAGGACCACTTCTGCGCTCGGCCCTTCCGGCTGGCTGGTTTATTGCTGATAAATCTGGAGCCGGTGAGCGTGGATCTCGCGGTATCATTGCAGCACTGGGGCCAGATGGTAAGCCCTCCCGTATCGTAGTTATCTACACGACGGGGAGTCAGGCAACTATGGA
460	gb|AY491682|+|0-861|ARO:3000996|TEM-132	ATGAGTATTCAACATTTTCGTGTCGCCCTTATTCCCTTTTTTGCGGCATTTTGC...TAA	861.0	46	852	806	861	ATGAGTATTCAACATTTCCGTGTCGCCCTTATTCCCTTTTTTGCGGCATTTTGCCTTCCTGTTTTTGCTCACCCAGAAACGCTGGTGAAAGTAAAAGATGCTGAAGATCAGTTGGGTGCACGAGTGGGTTACATCGAGCTGGATCTCAACAGCGGTAAGATCCTTGAGAGTTTTCGCCCCGAAGAACGTTTTCCAATGATGAGCACTTTTAAAGTTCTGCTATGTGGTGCGGTATTATCCCGTGTTGACGCCGGGCAAGAGCAACTCGGTCGCCGCATACACTATTCTCAGAATGACTTGGTTGAGTACTCACCAGTCACAGAAAAGCATCTTACGGATGGCATGACAGTAAGAGAATTATGCAGTGCTGCCATAACCATGAGTGATAACACTGCGGCCAACTTACTTCTGACAACGATCGGAGGACCGAAGGAGCTAACCGCTTTTTTGCACAACATGGGGGATCATGTAACCCGCCTTGATCGTTGGGAACCGGAGCTGAATGAAGCCATACCAAACGACGAGCGTGACACCACGATGCCTGCAGCAATGGCAACAACGTTGCGCAAACTATTAACTGGCGAACTACTTACTCTAGCTTCCCGGCAACAATTAATAGACTGGATGGAGGCGGATAAAGTTGCAGGACCACTTCTGCGCTCGGCCCTTCCGGCTGGCTGGTTTATTGCTGATAAATCTGGAGCCGGTGAGCGTGGATCTCGCGGTATCATTGCAGCACTGGGGCCAGATGGTAAGCCCTCCCGTATCGTAGTTATCTACACGACGGGGAGTCAGGCAACTATGGA
461	gb|KJ135343|+|14-839|ARO:3001574|OXA-388	ATGAACATTCAAGCACTCTTACTTATAACAAGCGCTATTTTTATTTCAGCCTGC...TAG	825.0	54149	54919	770	825	ATGAACATTAAAGCACTCTTACTTATAACAAGCGCTATTTTTATTTCAGCCTGCTCACCTTATATAGTGACTGCTAATCCAAATCACAGCGCTTCAAAATCTGATGTAAAAGCAGAGAAAATTAAAAATTTATTTAACGAAGCACACACTACGGGTGTTTTAGTTATCCAACAAGGCCAAACTCAACAAAGCTATGGTAATGATCTTGCTCGTGCTTCGACCGAGTATGTACCTGCTTCGACCTTCAAAATGCTTAATGCTTTGATCGGCCTTGAGCACCATAAGGCAACCACCACAGAAGTATTTAAGTGGGATGGTAAAAAAAGGTTATTCCCAGAATGGGAAAAGGACATGACCCTAGGCGATGCCATGAAAGCTTCCGCTATTCCAGTTTATCAAGATTTAGCTCGTCGTATTGGACTTGAGCTCATGTCTAAGGAAGTGAAGCGTGTTGGTTATGGCAATGCAGATATCGGTACCCAAGTCGATAATTTTTGGCTGGTGGGTCCTTTAAAAATTACTCCTCAGCAAGAGGCACAGTTTGCTTACAAGCTAGCTAATAAAACGCTTCCATTTAGCCAAAAAGTCCAAGATGAAGTGCAATCCATGCTATTCATAGAAGAAAAGAATGGAAACAAAATATACGCAAAAAGTGGTTGGGGATGGGATGTAAACCCACAAGTAGGCTGGTTAACTGGATGGGTTGTTCAGCCTCAAGGGAATATTGTAGCGTTCTCCCTTAACTTAGAAATGAAAAAAGGAATACCTAG
462	gb|Y10280|+|0-861|ARO:3000917|TEM-48	ATGAGTATTCAACATTTCCGTGTCGCCCTTATTCCCTTTTTTGCGGCATTTTGC...TAA	861.0	46	852	806	861	ATGAGTATTCAACATTTCCGTGTCGCCCTTATTCCCTTTTTTGCGGCATTTTGCCTTCCTGTTTTTGCTCACCCAGAAACGCTGGTGAAAGTAAAAGATGCTGAAGATCAGTTGGGTGCACGAGTGGGTTACATCGAGCTGGATCTCAACAGCGGTAAGATCCTTGAGAGTTTTCGCCCCGAAGAACGTTTTCCAATGATGAGCACTTTTAAAGTTCTGCTATGTGGTGCGGTATTATCCCGTGTTGACGCCGGGCAAGAGCAACTCGGTCGCCGCATACACTATTCTCAGAATGACTTGGTTGAGTACTCACCAGTCACAGAAAAGCATCTTACGGATGGCATGACAGTAAGAGAATTATGCAGTGCTGCCATAACCATGAGTGATAACACTGCGGCCAACTTACTTCTGACAACGATCGGAGGACCGAAGGAGCTAACCGCTTTTTTGCACAACATGGGGGATCATGTAACCCGCCTTGATCGTTGGGAACCGGAGCTGAATGAAGCCATACCAAACGACGAGCGTGACACCACGATGCCTGCAGCAATGGCAACAACGTTGCGCAAACTATTAACTGGCGAACTACTTACTCTAGCTTCCCGGCAACAATTAATAGACTGGATGGAGGCGGATAAAGTTGCAGGACCACTTCTGCGCTCGGCCCTTCCGGCTGGCTGGTTTATTGCTGATAAATCTGGAGCCGGTGAGCGTGGATCTCGCGGTATCATTGCAGCACTGGGGCCAGATGGTAAGCCCTCCCGTATCGTAGTTATCTACACGACGGGGAGTCAGGCAACTATGGA
463	gb|FN652295|+|0-861|ARO:3001042|TEM-177	ATGAGTATTAAACATTTCCGTGTCGCCCTTATTCCCTTTTTTGCGGCATTTTGC...TAA	861.0	46	852	806	861	ATGAGTATTCAACATTTCCGTGTCGCCCTTATTCCCTTTTTTGCGGCATTTTGCCTTCCTGTTTTTGCTCACCCAGAAACGCTGGTGAAAGTAAAAGATGCTGAAGATCAGTTGGGTGCACGAGTGGGTTACATCGAGCTGGATCTCAACAGCGGTAAGATCCTTGAGAGTTTTCGCCCCGAAGAACGTTTTCCAATGATGAGCACTTTTAAAGTTCTGCTATGTGGTGCGGTATTATCCCGTGTTGACGCCGGGCAAGAGCAACTCGGTCGCCGCATACACTATTCTCAGAATGACTTGGTTGAGTACTCACCAGTCACAGAAAAGCATCTTACGGATGGCATGACAGTAAGAGAATTATGCAGTGCTGCCATAACCATGAGTGATAACACTGCGGCCAACTTACTTCTGACAACGATCGGAGGACCGAAGGAGCTAACCGCTTTTTTGCACAACATGGGGGATCATGTAACCCGCCTTGATCGTTGGGAACCGGAGCTGAATGAAGCCATACCAAACGACGAGCGTGACACCACGATGCCTGCAGCAATGGCAACAACGTTGCGCAAACTATTAACTGGCGAACTACTTACTCTAGCTTCCCGGCAACAATTAATAGACTGGATGGAGGCGGATAAAGTTGCAGGACCACTTCTGCGCTCGGCCCTTCCGGCTGGCTGGTTTATTGCTGATAAATCTGGAGCCGGTGAGCGTGGATCTCGCGGTATCATTGCAGCACTGGGGCCAGATGGTAAGCCCTCCCGTATCGTAGTTATCTACACGACGGGGAGTCAGGCAACTATGGA
464	gb|JN118546|+|1761-2562|ARO:3001500|OXA-251	ATGAAAACATTTGCCGCATATGTAATTATCGCGTGTCTTTCGAGTACGGCATTA...TAA	801.0	659	1405	746	801	ATGAAAACATTTGCCGCATATGTAATTATCGCGTGTCTTTCGAGTACGGCATTAGCTGGTTCAATTACAGAAAATACGTCTTGGAACAAAGAGTTCTCTGCCGAAGCCGTCAATGGTGTCTTCGTGCTTTGTAAAAGTAGCAGTAAATCCTGCGCTACCAATGACTTAGCTCGTGCATCAAAGGAATATCTTCCAGCATCAACATTTAAGATCCCCAACGCAATTATCGGCCTAGAAACTGGTGTCATAAAGAATGAGCATCAGGTTTTCAAATGGGACGGAAAGCCAAGAGCCATGAAGCAATGGGAAAGAGACTTGACCTTAAGAGGGGCAATACAAGTTTCAGCTGTTCCCGTATTTCAACAAATCGCCAGAGAAGTTGGCGAAGTAAGAATGCAGAAATACCTTAAAAAATTTTCCTATGGCAACCAGAATATCAGTGGTGGCATTGACAAATTCTGGTTGGAAGGCCAGCTTAGAATTTCCGCAGTTAATCAAGTGGAGTTTCTAGAGTCTCTATATTTAAATAAATTGTCAGCATCTAAAGAAAACCAGCTAATAGTAAAAGAGGCTTTGGTAACGGAGGCGGCACCTGAATATCTAGTGCATTCAAAAACTGGTTTTTCTGGTGTGGGAACTGAGTCAAATCCTGGTGTCGCATGGTGGGTTGGGTGGGTTGAGAAGGAGACAGAGGTTTACTTTTTCGCCTTTAACATGGATATAGACAACGAAAGTAAGTTGCCGCT
465	gb|AF550679.1|-|80976-81768|ARO:3002601|aadA	ATGAGGGAAGCGGTGATCGCCGAAGTATCGACTCAACTATCAGAGGTAGTTGGC...TAA	792.0	10	747	737	792	ATGAGGGAAGCGGTGATCGCCGAAGTATCGACTCAACTATCAGAGGTAGTTGGCGTCATCGAGCGCCATCTCGAACCGACGTTGCTGGCCGTACATTTGTACGGCTCCGCAGTGGATGGCGGCCTGAAGCCACACAGTGATATTGATTTGCTGGTTACGGTGACCGTAAGGCTTGATGAAACAACGCGGCGAGCTTTGATCAACGACCTTTTGGAAACTTCGGCTTCCCCTGGAGAGAGCGAGATTCTCCGCGCTGTAGAAGTCACCATTGTTGTGCACGACGACATCATTCCGTGGCGTTATCCAGCTAAGCGCGAACTGCAATTTGGAGAATGGCAGCGCAATGACATTCTTGCAGGTATCTTCGAGCCAGCCACGATCGACATTGATCTGGCTATCTTGCTGACAAAAGCAAGAGAACATAGCGTTGCCTTGGTAGGTCCAGCGGCGGAGGAACTCTTTGATCCGGTTCCTGAACAGGATCTATTTGAGGCGCTAAATGAAACCTTAACGCTATGGAACTCGCCGCCCGACTGGGCTGGCGATGAGCGAAATGTAGTGCTTACGTTGTCCCGCATTTGGTACAGCGCAGTAACCGGCAAAATCGCGCCGAAGGATGTCGCTGCCGACTGGGCAATGGAGCGCCTGCCGGCCCAGTATCAGCCCGTCATACTTGAAGCTAGACAGGCTTATCTTGGACAAGAAGAAGATCGCTTGGCCTCGCGCGCAGATCAGTT
466	gb|AY528425|+|0-861|ARO:3000997|TEM-133	ATGAGTATTCAACATTTCCGTGTCGCCCTTATTCCCTTTTTTGCGGCATTTTGC...TAA	861.0	46	852	806	861	ATGAGTATTCAACATTTCCGTGTCGCCCTTATTCCCTTTTTTGCGGCATTTTGCCTTCCTGTTTTTGCTCACCCAGAAACGCTGGTGAAAGTAAAAGATGCTGAAGATCAGTTGGGTGCACGAGTGGGTTACATCGAGCTGGATCTCAACAGCGGTAAGATCCTTGAGAGTTTTCGCCCCGAAGAACGTTTTCCAATGATGAGCACTTTTAAAGTTCTGCTATGTGGTGCGGTATTATCCCGTGTTGACGCCGGGCAAGAGCAACTCGGTCGCCGCATACACTATTCTCAGAATGACTTGGTTGAGTACTCACCAGTCACAGAAAAGCATCTTACGGATGGCATGACAGTAAGAGAATTATGCAGTGCTGCCATAACCATGAGTGATAACACTGCGGCCAACTTACTTCTGACAACGATCGGAGGACCGAAGGAGCTAACCGCTTTTTTGCACAACATGGGGGATCATGTAACCCGCCTTGATCGTTGGGAACCGGAGCTGAATGAAGCCATACCAAACGACGAGCGTGACACCACGATGCCTGCAGCAATGGCAACAACGTTGCGCAAACTATTAACTGGCGAACTACTTACTCTAGCTTCCCGGCAACAATTAATAGACTGGATGGAGGCGGATAAAGTTGCAGGACCACTTCTGCGCTCGGCCCTTCCGGCTGGCTGGTTTATTGCTGATAAATCTGGAGCCGGTGAGCGTGGATCTCGCGGTATCATTGCAGCACTGGGGCCAGATGGTAAGCCCTCCCGTATCGTAGTTATCTACACGACGGGGAGTCAGGCAACTATGGA
467	gb|KP881236.1|+|0-1152|ARO:3003882|ADC-76	ATGCGATTTAAAAAAATTTCTTGTCTACTTTTATCCCCGCTTTTTATTTTTAGT...TAA	1152.0	63	1160	1097	1152	ATGCGATTTAAAAAAATTTCTTGTCTACTTTTATCCCCGCTTTTTATTTTTAGTACCTCAATTTATGCGGGCAATACACCAAAAGACCAAGAAATTAAAAAACTGGTAGATCAAAACTTTAAACCGTTATTAGAAAAATATGATGTGCCAGGTATGGCTGTGGGTGTTATTCAAAATAATAAAAAGTATGAAATGTATTATGGTCTTCAATCTGTTCAAGATAAAAAAGCCGTAAATAGCAGTACTATTTTTGAGCTAGGTTCTGTCAGTAAATTATTTACCGCGACAGCAGGTGGATATGCAAAAAATAAAGGAAAAATCTCTTTTGACGATACGCCTGGTAAGTATTGGAAAGAACTAAAAAATACACCGATTGACCAAGTTAACTTACTTCAACTCGCGACGTATACAAGTGGTAACCTTGCCTTGCAATTTCCAGATGAAGTAAAAACAGATCAGCAAGTTTTAACATTTTTTAAAGACTGGAAACCTAAAAACTCAATCGGTGAATATCGACAATATTCAAACCCAAGCATTGGTTTATTTGGAAAAGTTGTAGCTTTGTCTATGAATAAACCTTTCGACCAAGTCTTAGAAAAAACAATTTTTCCGGCCCTTGGCTTAAAACATAGCTATGTAAATGTACCTAAGACCCAGATGCAAAACTATGCTTTTGGCTATAACCAAGAAAATCAGCCGATTCGAGTTAACCCCGGCCCACTCGATGCCCCAGCATATGGCGTCAAATCGACACTACCCGACATGTTGAGTTTTATTCATGCCAACCTAAATCCACAAAAATATCCAGCAGATATTCAACGGGCAATTAATGAAACACATCAGGGTCGCTATCAAGTAAATACCATGTATCAGGCACTCGGTTGGGAAGAGTTTTCTTATCCGGCAACGTTACAAACTTTATTAGACAGTAATTCAGAACAGATTGTGATGAAACCTAATAAAGTGACTGCTATTTCAAAGGAACCTTCAGTTAAGATGTACCATAAAACTGGCTCAACTACCGGTTTCGGAACATATGTGGTGTTTATTCCTAAAGAAAATATTGGTTTAGTCATGTTAACCAATAAACGTATTCC
468	gb|AY574271|+|0-861|ARO:3000998|TEM-134	ATGAGTATTCAACATTTCCGTGTCGCCCTTATTCCCTTTTTTGCGGCATTTTGC...TAA	861.0	46	852	806	861	ATGAGTATTCAACATTTCCGTGTCGCCCTTATTCCCTTTTTTGCGGCATTTTGCCTTCCTGTTTTTGCTCACCCAGAAACGCTGGTGAAAGTAAAAGATGCTGAAGATCAGTTGGGTGCACGAGTGGGTTACATCGAGCTGGATCTCAACAGCGGTAAGATCCTTGAGAGTTTTCGCCCCGAAGAACGTTTTCCAATGATGAGCACTTTTAAAGTTCTGCTATGTGGTGCGGTATTATCCCGTGTTGACGCCGGGCAAGAGCAACTCGGTCGCCGCATACACTATTCTCAGAATGACTTGGTTGAGTACTCACCAGTCACAGAAAAGCATCTTACGGATGGCATGACAGTAAGAGAATTATGCAGTGCTGCCATAACCATGAGTGATAACACTGCGGCCAACTTACTTCTGACAACGATCGGAGGACCGAAGGAGCTAACCGCTTTTTTGCACAACATGGGGGATCATGTAACCCGCCTTGATCGTTGGGAACCGGAGCTGAATGAAGCCATACCAAACGACGAGCGTGACACCACGATGCCTGCAGCAATGGCAACAACGTTGCGCAAACTATTAACTGGCGAACTACTTACTCTAGCTTCCCGGCAACAATTAATAGACTGGATGGAGGCGGATAAAGTTGCAGGACCACTTCTGCGCTCGGCCCTTCCGGCTGGCTGGTTTATTGCTGATAAATCTGGAGCCGGTGAGCGTGGATCTCGCGGTATCATTGCAGCACTGGGGCCAGATGGTAAGCCCTCCCGTATCGTAGTTATCTACACGACGGGGAGTCAGGCAACTATGGA
469	gb|U37105.2|+|2806-3640|ARO:3004692|aadA10	ATGAGAAACACAGTGCCCGCCGAGATTTCGGTACAGTTATCACAGGCACTCAAC...TAA	834.0	1476	2255	779	834	ATGAGAAACACAGTGCCCGCCGAGATTTCGGTACGGTTATCACAGGCACTCAACGTCATCGAGCATCATCTGGGATCGACGTTGCTGGCCATGCATTTGTATGGCTCTGCACTCGACGGTGGCCTGAAGCCATACAGTGACATTGATTTGCTGGTTACTGTGACCGCACGGCTCGATGAGAGTGTGCGGCAAGCTCTGTTCGTCGATCTCTTGGGGGTTTCCGTTTTCCCTGGTCAAAGCAGAGTTCTCCGCGCCTTGGAAGTTACCATTGTCGTGCACAGTGACATCGTTCCTTGGCGCTATCCGGCCAGACGGGAACTGCAATTCGGGGAGTGGCAGCGCAAAGACATTCTTGCGGGCATCTTCGAGCCTGCGACAACCGATGTTGATCTAGCCATTCTGCTAACAAAAGCAAGGCAACATAGCCTTGCCTTGGCCGGTTCGGCTGCGGAAGATTTCTTCAACCCAGTCCCGGAAAGCGATCTGTTCAAGGCACTGGCCGACACCCTGAAACTATGGAACTCACAGCCGGATTGGATAGGTGACGAGCGGAATGTAGTGCTTACTTTGTCTCGTATTTGGTACAGCGCAGCAACCGGCAAGATCGCGCCGAAGGATGTTGCCGCCAACTGGGTAATGGAGCGTTTGCCAGTTCAACATCAGCCCGTGCTGCTTGAAGCCCGGCAGGCTTATCTTGGACAAGGAGAAGATTGCTTGGCTTCGCTCACGGATCAGTTAGAGGCGTTTGTTCACTTCGTGAAGCATGAAGCCACTAAACT
470	gb|X97254|+|153-1011|ARO:3001043|TEM-178	ATGAGTATTCAACATTTCCGTGTCGCCCTTATTCCCTTTTTTGCGGCATTTTGC...TAA	858.0	46	830	784	858	ATGAGTATTCAACATTTCCGTGTCGCCCTTATTCCCTTTTTTGCGGCATTTTGCCTTCCTGTTTTTGCTCACCCAGAAACGCTGGTGAAAGTAAAAGATGCTGAAGATCAGTTGGGTGCACGAGTGGGTTACATCGAGCTGGATCTCAACAGCGGTAAGATCCTTGAGAGTTTTCGCCCCGAAGAACGTTTTCCAATGATGAGCACTTTTAAAGTTCTGCTATGTGGTGCGGTATTATCCCGTGTTGACGCCGGGCAAGAGCAACTCGGTCGCCGCATACACTATTCTCAGAATGACTTGGTTGAGTACTCACCAGTCACAGAAAAGCATCTTACGGATGGCATGACAGTAAGAGAATTATGCAGTGCTGCCATAACCATGAGTGATAACACTGCGGCCAACTTACTTCTGACAACGATCGGAGGACCGAAGGAGCTAACCGCTTTTTTGCACAACATGGGGGATCATGTAACCCGCCTTGATCGTTGGGAACCGGAGCTGAATGAAGCCATACCAAACGACGAGCGTGACACCACGATGCCTGCAGCAATGGCAACAACGTTGCGCAAACTATTAACTGGCGAACTACTTACTCTAGCTTCCCGGCAACAATTAATAGACTGGATGGAGGCGGATAAAGTTGCAGGACCACTTCTGCGCTCGGCCCTTCCGGCTGGCTGGTTTATTGCTGATAAATCTGGAGCCGGTGAGCGTGGATCTCGCGGTATCATTGCAGCACTGGGGCCAGATGGTAAGCCCTCCCGTATCGTAGTTATCTACACGA
471	gb|Y10281|+|0-861|ARO:3000918|TEM-49	ATGAGTATTCAACATTTCCGTGTCGCCCTTATTCCCTTTTTTGCGGCATTTTGC...TAA	861.0	46	852	806	861	ATGAGTATTCAACATTTCCGTGTCGCCCTTATTCCCTTTTTTGCGGCATTTTGCCTTCCTGTTTTTGCTCACCCAGAAACGCTGGTGAAAGTAAAAGATGCTGAAGATCAGTTGGGTGCACGAGTGGGTTACATCGAGCTGGATCTCAACAGCGGTAAGATCCTTGAGAGTTTTCGCCCCGAAGAACGTTTTCCAATGATGAGCACTTTTAAAGTTCTGCTATGTGGTGCGGTATTATCCCGTGTTGACGCCGGGCAAGAGCAACTCGGTCGCCGCATACACTATTCTCAGAATGACTTGGTTGAGTACTCACCAGTCACAGAAAAGCATCTTACGGATGGCATGACAGTAAGAGAATTATGCAGTGCTGCCATAACCATGAGTGATAACACTGCGGCCAACTTACTTCTGACAACGATCGGAGGACCGAAGGAGCTAACCGCTTTTTTGCACAACATGGGGGATCATGTAACCCGCCTTGATCGTTGGGAACCGGAGCTGAATGAAGCCATACCAAACGACGAGCGTGACACCACGATGCCTGCAGCAATGGCAACAACGTTGCGCAAACTATTAACTGGCGAACTACTTACTCTAGCTTCCCGGCAACAATTAATAGACTGGATGGAGGCGGATAAAGTTGCAGGACCACTTCTGCGCTCGGCCCTTCCGGCTGGCTGGTTTATTGCTGATAAATCTGGAGCCGGTGAGCGTGGATCTCGCGGTATCATTGCAGCACTGGGGCCAGATGGTAAGCCCTCCCGTATCGTAGTTATCTACACGACGGGGAGTCAGGCAACTATGGA
472	gb|AJ634602.1|-|7839-8700|ARO:3000999|TEM-135	ATGAGTATTCAACATTTTCGTGTCGCCCTTATTCCCTTTTTTGCGGCATTTTGC...TAA	861.0	46	852	806	861	ATGAGTATTCAACATTTCCGTGTCGCCCTTATTCCCTTTTTTGCGGCATTTTGCCTTCCTGTTTTTGCTCACCCAGAAACGCTGGTGAAAGTAAAAGATGCTGAAGATCAGTTGGGTGCACGAGTGGGTTACATCGAGCTGGATCTCAACAGCGGTAAGATCCTTGAGAGTTTTCGCCCCGAAGAACGTTTTCCAATGATGAGCACTTTTAAAGTTCTGCTATGTGGTGCGGTATTATCCCGTGTTGACGCCGGGCAAGAGCAACTCGGTCGCCGCATACACTATTCTCAGAATGACTTGGTTGAGTACTCACCAGTCACAGAAAAGCATCTTACGGATGGCATGACAGTAAGAGAATTATGCAGTGCTGCCATAACCATGAGTGATAACACTGCGGCCAACTTACTTCTGACAACGATCGGAGGACCGAAGGAGCTAACCGCTTTTTTGCACAACATGGGGGATCATGTAACCCGCCTTGATCGTTGGGAACCGGAGCTGAATGAAGCCATACCAAACGACGAGCGTGACACCACGATGCCTGCAGCAATGGCAACAACGTTGCGCAAACTATTAACTGGCGAACTACTTACTCTAGCTTCCCGGCAACAATTAATAGACTGGATGGAGGCGGATAAAGTTGCAGGACCACTTCTGCGCTCGGCCCTTCCGGCTGGCTGGTTTATTGCTGATAAATCTGGAGCCGGTGAGCGTGGATCTCGCGGTATCATTGCAGCACTGGGGCCAGATGGTAAGCCCTCCCGTATCGTAGTTATCTACACGACGGGGAGTCAGGCAACTATGGA
473	gb|KJ135346|+|14-839|ARO:3001575|OXA-389	ATGAACATTAAAACACTCTTACTTATAACAAGCGCTATTTTTATTTCAGCCTGC...TAG	825.0	54149	54919	770	825	ATGAACATTAAAGCACTCTTACTTATAACAAGCGCTATTTTTATTTCAGCCTGCTCACCTTATATAGTGACTGCTAATCCAAATCACAGCGCTTCAAAATCTGATGTAAAAGCAGAGAAAATTAAAAATTTATTTAACGAAGCACACACTACGGGTGTTTTAGTTATCCAACAAGGCCAAACTCAACAAAGCTATGGTAATGATCTTGCTCGTGCTTCGACCGAGTATGTACCTGCTTCGACCTTCAAAATGCTTAATGCTTTGATCGGCCTTGAGCACCATAAGGCAACCACCACAGAAGTATTTAAGTGGGATGGTAAAAAAAGGTTATTCCCAGAATGGGAAAAGGACATGACCCTAGGCGATGCCATGAAAGCTTCCGCTATTCCAGTTTATCAAGATTTAGCTCGTCGTATTGGACTTGAGCTCATGTCTAAGGAAGTGAAGCGTGTTGGTTATGGCAATGCAGATATCGGTACCCAAGTCGATAATTTTTGGCTGGTGGGTCCTTTAAAAATTACTCCTCAGCAAGAGGCACAGTTTGCTTACAAGCTAGCTAATAAAACGCTTCCATTTAGCCAAAAAGTCCAAGATGAAGTGCAATCCATGCTATTCATAGAAGAAAAGAATGGAAACAAAATATACGCAAAAAGTGGTTGGGGATGGGATGTAAACCCACAAGTAGGCTGGTTAACTGGATGGGTTGTTCAGCCTCAAGGGAATATTGTAGCGTTCTCCCTTAACTTAGAAATGAAAAAAGGAATACCTAG
474	gb|DQ393783|+|1799-2591|ARO:3002615|aadA15	ATGAGGGAAGCGGTGATCGCCGAAGTATCGACTCAACTATCAGAGGTAGTTGGC...TGA	792.0	10	727	717	792	ATGAGGGAAGCGGTGATCGCCGAAGTATCGACTCAACTATCAGAGGTAGTTGGCGTCATCGAGCGCCATCTCGAACCGACGTTGCTGGCCGTACATTTGTACGGCTCCGCAGTGGATGGCGGCCTGAAGCCACACAGTGATATTGATTTGCTGGTTACGGTGACCGTAAGGCTTGATGAAACAACGCGGCGAGCTTTGATCAACGACCTTTTGGAAACTTCGGCTTCCCCTGGAGAGAGCGAGATTCTCCGCGCTGTAGAAGTCACCATTGTTGTGCACGACGACATCATTCCGTGGCGTTATCCAGCTAAGCGCGAACTGCAATTTGGAGAATGGCAGCGCAATGACATTCTTGCAGGTATCTTCGAGCCAGCCACGATCGACATTGATCTGGCTATCTTGCTGACAAAAGCAAGAGAACATAGCGTTGCCTTGGTAGGTCCAGCGGCGGAGGAACTCTTTGATCCGGTTCCTGAACAGGATCTATTTGAGGCGCTAAATGAAACCTTAACGCTATGGAACTCGCCGCCCGACTGGGCTGGCGATGAGCGAAATGTAGTGCTTACGTTGTCCCGCATTTGGTACAGCGCAGTAACCGGCAAAATCGCGCCGAAGGATGTCGCTGCCGACTGGGCAATGGAGCGCCTGCCGGCCCAGTATCAGCCCGTCATACTTGAAGCTAGACAGGCTTATCTTGGACAAGAAGAAGATCGCTTG
475	gb|Y13612|+|0-861|ARO:3000921|TEM-52	ATGAGTATTCAACATTTCCGTGTCGCCCTTATTCCCTTTTTTGCGGCATTTTGC...TAA	861.0	46	852	806	861	ATGAGTATTCAACATTTCCGTGTCGCCCTTATTCCCTTTTTTGCGGCATTTTGCCTTCCTGTTTTTGCTCACCCAGAAACGCTGGTGAAAGTAAAAGATGCTGAAGATCAGTTGGGTGCACGAGTGGGTTACATCGAGCTGGATCTCAACAGCGGTAAGATCCTTGAGAGTTTTCGCCCCGAAGAACGTTTTCCAATGATGAGCACTTTTAAAGTTCTGCTATGTGGTGCGGTATTATCCCGTGTTGACGCCGGGCAAGAGCAACTCGGTCGCCGCATACACTATTCTCAGAATGACTTGGTTGAGTACTCACCAGTCACAGAAAAGCATCTTACGGATGGCATGACAGTAAGAGAATTATGCAGTGCTGCCATAACCATGAGTGATAACACTGCGGCCAACTTACTTCTGACAACGATCGGAGGACCGAAGGAGCTAACCGCTTTTTTGCACAACATGGGGGATCATGTAACCCGCCTTGATCGTTGGGAACCGGAGCTGAATGAAGCCATACCAAACGACGAGCGTGACACCACGATGCCTGCAGCAATGGCAACAACGTTGCGCAAACTATTAACTGGCGAACTACTTACTCTAGCTTCCCGGCAACAATTAATAGACTGGATGGAGGCGGATAAAGTTGCAGGACCACTTCTGCGCTCGGCCCTTCCGGCTGGCTGGTTTATTGCTGATAAATCTGGAGCCGGTGAGCGTGGATCTCGCGGTATCATTGCAGCACTGGGGCCAGATGGTAAGCCCTCCCGTATCGTAGTTATCTACACGACGGGGAGTCAGGCAACTATGGA
476	gb|AB781687|+|0-825|ARO:3001682|OXA-254	ATGAACATTAAAGCACTCTTACTTATAACAAGCGCTATTTTTATTTCAGCCTGC...TAG	825.0	54149	54919	770	825	ATGAACATTAAAGCACTCTTACTTATAACAAGCGCTATTTTTATTTCAGCCTGCTCACCTTATATAGTGACTGCTAATCCAAATCACAGCGCTTCAAAATCTGATGTAAAAGCAGAGAAAATTAAAAATTTATTTAACGAAGCACACACTACGGGTGTTTTAGTTATCCAACAAGGCCAAACTCAACAAAGCTATGGTAATGATCTTGCTCGTGCTTCGACCGAGTATGTACCTGCTTCGACCTTCAAAATGCTTAATGCTTTGATCGGCCTTGAGCACCATAAGGCAACCACCACAGAAGTATTTAAGTGGGATGGTAAAAAAAGGTTATTCCCAGAATGGGAAAAGGACATGACCCTAGGCGATGCCATGAAAGCTTCCGCTATTCCAGTTTATCAAGATTTAGCTCGTCGTATTGGACTTGAGCTCATGTCTAAGGAAGTGAAGCGTGTTGGTTATGGCAATGCAGATATCGGTACCCAAGTCGATAATTTTTGGCTGGTGGGTCCTTTAAAAATTACTCCTCAGCAAGAGGCACAGTTTGCTTACAAGCTAGCTAATAAAACGCTTCCATTTAGCCAAAAAGTCCAAGATGAAGTGCAATCCATGCTATTCATAGAAGAAAAGAATGGAAACAAAATATACGCAAAAAGTGGTTGGGGATGGGATGTAAACCCACAAGTAGGCTGGTTAACTGGATGGGTTGTTCAGCCTCAAGGGAATATTGTAGCGTTCTCCCTTAACTTAGAAATGAAAAAAGGAATACCTAG
477	gb|AF104441|+|193-1054|ARO:3000922|TEM-53	ATGAGTATTCAACATTTCCGTGTCGCCCTTATTCCCTTTTTTGCGGCATTTTGC...TAA	861.0	46	852	806	861	ATGAGTATTCAACATTTCCGTGTCGCCCTTATTCCCTTTTTTGCGGCATTTTGCCTTCCTGTTTTTGCTCACCCAGAAACGCTGGTGAAAGTAAAAGATGCTGAAGATCAGTTGGGTGCACGAGTGGGTTACATCGAGCTGGATCTCAACAGCGGTAAGATCCTTGAGAGTTTTCGCCCCGAAGAACGTTTTCCAATGATGAGCACTTTTAAAGTTCTGCTATGTGGTGCGGTATTATCCCGTGTTGACGCCGGGCAAGAGCAACTCGGTCGCCGCATACACTATTCTCAGAATGACTTGGTTGAGTACTCACCAGTCACAGAAAAGCATCTTACGGATGGCATGACAGTAAGAGAATTATGCAGTGCTGCCATAACCATGAGTGATAACACTGCGGCCAACTTACTTCTGACAACGATCGGAGGACCGAAGGAGCTAACCGCTTTTTTGCACAACATGGGGGATCATGTAACCCGCCTTGATCGTTGGGAACCGGAGCTGAATGAAGCCATACCAAACGACGAGCGTGACACCACGATGCCTGCAGCAATGGCAACAACGTTGCGCAAACTATTAACTGGCGAACTACTTACTCTAGCTTCCCGGCAACAATTAATAGACTGGATGGAGGCGGATAAAGTTGCAGGACCACTTCTGCGCTCGGCCCTTCCGGCTGGCTGGTTTATTGCTGATAAATCTGGAGCCGGTGAGCGTGGATCTCGCGGTATCATTGCAGCACTGGGGCCAGATGGTAAGCCCTCCCGTATCGTAGTTATCTACACGACGGGGAGTCAGGCAACTATGGA
478	gb|KR057758.1|+|0-1107|ARO:3004352|PDC-89	GATGAGGCCCCGGCGGATCGCCTGAAGGCACTGGTCGACGCCGCCGTACAACCG...TGA	1107.0	35591	36652	1061	1107	GATGAGGCCCCGGCGGATCGCCTGAAGGCACTGGTCGACGCCGCCGTACAACCGGTGATGAAGGCCAATGACATTCCGGGCCTGGCCGTAGCCATCAGCCTGAAAGGAGAACCGCATTACTTCAGCTATGGGCTGGCCTCGAAAGAGGACGGCCGCCGGGTGACGCCGGAGACCCTGTTCGAGATCGGCTCGGTGAGCAAGACCTTCACCGTCACCCTCGCCGGCTATGCCCTGGCCCAGGACAAGATGCGCCTCGACGACCGCGCCAGCCAGCACTGGCCGGCACTGCAGGGCAGCCGCTTCGACGGCATCAGCCTGCTCGACCTCGCGACCTATACCGCCGGCGGCTTGCCGCTGCAGTTCCCCGACTCGGTGCAGAAGGACCAGGCACAGATCCGCGACTACTACCGCCAGTGGCAGCCGACCTACGCGCCGGGCAGCCAGCGCCTCTATTCCAACCCGAGCATCGGCCTGTTCGGCTATCTCGCCGCGCGCAGCCTGGGCCAGCCGTTCGAACGGCTCATGGAGCAGCAATTGTTCCCGGCACTGGGCCTCGAACAGACCCACCTCGACGTGCCCGAGGCGGCGCTGGCGCAGTACGCCCAGGGCTACGGCAAGGACGACCGCCCGCTACGGGTCGGTCCCGGCCCGCTGGATGCCGAAGGCTACGGGGTGAAGACCAGCGCGGCCGACCTGCTGCGCTTCGTCGATGCCAACCTGCATCCGGAGCGCCTGGACAGGCCCTGGGCGCAGGCGCTCGATGCCACCCATCGCGGTTACTACAAGGTCGGCGACATGACCCAGGGCCTGGGCTGGGAAGCCTACGACTGGCCGATCTCCCTGAAGCGCCTGCAGGCCGGCAACTCGACGCCGATGGCGCTGCAACCACACAGGATCGCCAGGCTGCCCGCGCCACAGGCGCTGGAGGGCCAGCGCCTGCTGAACAAGACCGGCTCCACCAACGGCTTCGGCGCCTACGTGGCGTTCGTCCCGGGCCGCGACCTGGGCCTGGTGATCCTGGCCAACCGCAACTATCCCAATGCCGAGCGGGTGAAGATCGC
479	gb|FJ460181|+|1790-2582|ARO:3002617|aadA17	ATGAGGGTAGCGGTGACCATCGAAATTTCGAACCAACTATCAGAGGTGCTAAGC...TGA	792.0	10	727	717	792	ATGAGGGAAGCGGTGATCGCCGAAGTATCGACTCAACTATCAGAGGTAGTTGGCGTCATCGAGCGCCATCTCGAACCGACGTTGCTGGCCGTACATTTGTACGGCTCCGCAGTGGATGGCGGCCTGAAGCCACACAGTGATATTGATTTGCTGGTTACGGTGACCGTAAGGCTTGATGAAACAACGCGGCGAGCTTTGATCAACGACCTTTTGGAAACTTCGGCTTCCCCTGGAGAGAGCGAGATTCTCCGCGCTGTAGAAGTCACCATTGTTGTGCACGACGACATCATTCCGTGGCGTTATCCAGCTAAGCGCGAACTGCAATTTGGAGAATGGCAGCGCAATGACATTCTTGCAGGTATCTTCGAGCCAGCCACGATCGACATTGATCTGGCTATCTTGCTGACAAAAGCAAGAGAACATAGCGTTGCCTTGGTAGGTCCAGCGGCGGAGGAACTCTTTGATCCGGTTCCTGAACAGGATCTATTTGAGGCGCTAAATGAAACCTTAACGCTATGGAACTCGCCGCCCGACTGGGCTGGCGATGAGCGAAATGTAGTGCTTACGTTGTCCCGCATTTGGTACAGCGCAGTAACCGGCAAAATCGCGCCGAAGGATGTCGCTGCCGACTGGGCAATGGAGCGCCTGCCGGCCCAGTATCAGCCCGTCATACTTGAAGCTAGACAGGCTTATCTTGGACAAGAAGAAGATCGCTTG
480	gb|KJ135342.1|-|48-873|ARO:3001576|OXA-390	ATGAACATTAAAGCACTCTTACTTATAACAAGCGCTATTTTTATTTCAGCCTGC...TAG	825.0	54149	54919	770	825	ATGAACATTAAAGCACTCTTACTTATAACAAGCGCTATTTTTATTTCAGCCTGCTCACCTTATATAGTGACTGCTAATCCAAATCACAGCGCTTCAAAATCTGATGTAAAAGCAGAGAAAATTAAAAATTTATTTAACGAAGCACACACTACGGGTGTTTTAGTTATCCAACAAGGCCAAACTCAACAAAGCTATGGTAATGATCTTGCTCGTGCTTCGACCGAGTATGTACCTGCTTCGACCTTCAAAATGCTTAATGCTTTGATCGGCCTTGAGCACCATAAGGCAACCACCACAGAAGTATTTAAGTGGGATGGTAAAAAAAGGTTATTCCCAGAATGGGAAAAGGACATGACCCTAGGCGATGCCATGAAAGCTTCCGCTATTCCAGTTTATCAAGATTTAGCTCGTCGTATTGGACTTGAGCTCATGTCTAAGGAAGTGAAGCGTGTTGGTTATGGCAATGCAGATATCGGTACCCAAGTCGATAATTTTTGGCTGGTGGGTCCTTTAAAAATTACTCCTCAGCAAGAGGCACAGTTTGCTTACAAGCTAGCTAATAAAACGCTTCCATTTAGCCAAAAAGTCCAAGATGAAGTGCAATCCATGCTATTCATAGAAGAAAAGAATGGAAACAAAATATACGCAAAAAGTGGTTGGGGATGGGATGTAAACCCACAAGTAGGCTGGTTAACTGGATGGGTTGTTCAGCCTCAAGGGAATATTGTAGCGTTCTCCCTTAACTTAGAAATGAAAAAAGGAATACCTAG
481	gb|AY826417|+|0-861|ARO:3001000|TEM-136	ATGAGTATTCAACATTTCCGTGTCGCCCTTATTCCCTTTTTTGCGGCATTTTGC...TAA	861.0	46	852	806	861	ATGAGTATTCAACATTTCCGTGTCGCCCTTATTCCCTTTTTTGCGGCATTTTGCCTTCCTGTTTTTGCTCACCCAGAAACGCTGGTGAAAGTAAAAGATGCTGAAGATCAGTTGGGTGCACGAGTGGGTTACATCGAGCTGGATCTCAACAGCGGTAAGATCCTTGAGAGTTTTCGCCCCGAAGAACGTTTTCCAATGATGAGCACTTTTAAAGTTCTGCTATGTGGTGCGGTATTATCCCGTGTTGACGCCGGGCAAGAGCAACTCGGTCGCCGCATACACTATTCTCAGAATGACTTGGTTGAGTACTCACCAGTCACAGAAAAGCATCTTACGGATGGCATGACAGTAAGAGAATTATGCAGTGCTGCCATAACCATGAGTGATAACACTGCGGCCAACTTACTTCTGACAACGATCGGAGGACCGAAGGAGCTAACCGCTTTTTTGCACAACATGGGGGATCATGTAACCCGCCTTGATCGTTGGGAACCGGAGCTGAATGAAGCCATACCAAACGACGAGCGTGACACCACGATGCCTGCAGCAATGGCAACAACGTTGCGCAAACTATTAACTGGCGAACTACTTACTCTAGCTTCCCGGCAACAATTAATAGACTGGATGGAGGCGGATAAAGTTGCAGGACCACTTCTGCGCTCGGCCCTTCCGGCTGGCTGGTTTATTGCTGATAAATCTGGAGCCGGTGAGCGTGGATCTCGCGGTATCATTGCAGCACTGGGGCCAGATGGTAAGCCCTCCCGTATCGTAGTTATCTACACGACGGGGAGTCAGGCAACTATGGA
482	gb|NG_050218.1|+|0-1061|ARO:3001044|TEM-181  Partial			0	870	870	1061	ACAATAACCCTGATAAATGCTTCAATAATATTGAAAAAGGAAGAGTATGAGTATTCAACATTTCCGTGTCGCCCTTATTCCCTTTTTTGCGGCATTTTGCCTTCCTGTTTTTGCTCACCCAGAAACGCTGGTGAAAGTAAAAGATGCTGAAGATCAGTTGGGTGCACGAGTGGGTTACATCGAGCTGGATCTCAACAGCGGTAAGATCCTTGAGAGTTTTCGCCCCGAAGAACGTTTTCCAATGATGAGCACTTTTAAAGTTCTGCTATGTGGTGCGGTATTATCCCGTGTTGACGCCGGGCAAGAGCAACTCGGTCGCCGCATACACTATTCTCAGAATGACTTGGTTGAGTACTCACCAGTCACAGAAAAGCATCTTACGGATGGCATGACAGTAAGAGAATTATGCAGTGCTGCCATAACCATGAGTGATAACACTGCGGCCAACTTACTTCTGACAACGATCGGAGGACCGAAGGAGCTAACCGCTTTTTTGCACAACATGGGGGATCATGTAACCCGCCTTGATCGTTGGGAACCGGAGCTGAATGAAGCCATACCAAACGACGAGCGTGACACCACGATGCCTGCAGCAATGGCAACAACGTTGCGCAAACTATTAACTGGCGAACTACTTACTCTAGCTTCCCGGCAACAATTAATAGACTGGATGGAGGCGGATAAAGTTGCAGGACCACTTCTGCGCTCGGCCCTTCCGGCTGGCTGGTTTATTGCTGATAAATCTGGAGCCGGTGAGCGTGGATCTCGCGGTATCATTGCAGCACTGGGGCCAGATGGTAAGCCCTCCCGTATCGTAGTTATCTACACGACGGGGAGTCAGGCAACTATGGATGAACGAAATAGACAGAT
483	gb|HE616889|+|1826-2627|ARO:3001502|OXA-256	ATGAAAACATTTGCCGCATATGTAATTATCGCGTGTCTTTCGAGTACGGCATTA...TAA	801.0	659	1405	746	801	ATGAAAACATTTGCCGCATATGTAATTATCGCGTGTCTTTCGAGTACGGCATTAGCTGGTTCAATTACAGAAAATACGTCTTGGAACAAAGAGTTCTCTGCCGAAGCCGTCAATGGTGTCTTCGTGCTTTGTAAAAGTAGCAGTAAATCCTGCGCTACCAATGACTTAGCTCGTGCATCAAAGGAATATCTTCCAGCATCAACATTTAAGATCCCCAACGCAATTATCGGCCTAGAAACTGGTGTCATAAAGAATGAGCATCAGGTTTTCAAATGGGACGGAAAGCCAAGAGCCATGAAGCAATGGGAAAGAGACTTGACCTTAAGAGGGGCAATACAAGTTTCAGCTGTTCCCGTATTTCAACAAATCGCCAGAGAAGTTGGCGAAGTAAGAATGCAGAAATACCTTAAAAAATTTTCCTATGGCAACCAGAATATCAGTGGTGGCATTGACAAATTCTGGTTGGAAGGCCAGCTTAGAATTTCCGCAGTTAATCAAGTGGAGTTTCTAGAGTCTCTATATTTAAATAAATTGTCAGCATCTAAAGAAAACCAGCTAATAGTAAAAGAGGCTTTGGTAACGGAGGCGGCACCTGAATATCTAGTGCATTCAAAAACTGGTTTTTCTGGTGTGGGAACTGAGTCAAATCCTGGTGTCGCATGGTGGGTTGGGTGGGTTGAGAAGGAGACAGAGGTTTACTTTTTCGCCTTTAACATGGATATAGACAACGAAAGTAAGTTGCCGCT
484	gb|AM286274|+|0-861|ARO:3001001|TEM-137	ATGAGTATTCAACATTTCCGTGTCGCCCTTATTCCCTTTTTTGCGGCATTTTGC...TAA	861.0	46	852	806	861	ATGAGTATTCAACATTTCCGTGTCGCCCTTATTCCCTTTTTTGCGGCATTTTGCCTTCCTGTTTTTGCTCACCCAGAAACGCTGGTGAAAGTAAAAGATGCTGAAGATCAGTTGGGTGCACGAGTGGGTTACATCGAGCTGGATCTCAACAGCGGTAAGATCCTTGAGAGTTTTCGCCCCGAAGAACGTTTTCCAATGATGAGCACTTTTAAAGTTCTGCTATGTGGTGCGGTATTATCCCGTGTTGACGCCGGGCAAGAGCAACTCGGTCGCCGCATACACTATTCTCAGAATGACTTGGTTGAGTACTCACCAGTCACAGAAAAGCATCTTACGGATGGCATGACAGTAAGAGAATTATGCAGTGCTGCCATAACCATGAGTGATAACACTGCGGCCAACTTACTTCTGACAACGATCGGAGGACCGAAGGAGCTAACCGCTTTTTTGCACAACATGGGGGATCATGTAACCCGCCTTGATCGTTGGGAACCGGAGCTGAATGAAGCCATACCAAACGACGAGCGTGACACCACGATGCCTGCAGCAATGGCAACAACGTTGCGCAAACTATTAACTGGCGAACTACTTACTCTAGCTTCCCGGCAACAATTAATAGACTGGATGGAGGCGGATAAAGTTGCAGGACCACTTCTGCGCTCGGCCCTTCCGGCTGGCTGGTTTATTGCTGATAAATCTGGAGCCGGTGAGCGTGGATCTCGCGGTATCATTGCAGCACTGGGGCCAGATGGTAAGCCCTCCCGTATCGTAGTTATCTACACGACGGGGAGTCAGGCAACTATGGA
485	gb|AF104442|+|193-1054|ARO:3000923|TEM-54	ATGAGTATTCAACATTTCCGTGTCGCCCTTATTCCCTTTTTTGCGGCATTTTGC...TAA	861.0	46	852	806	861	ATGAGTATTCAACATTTCCGTGTCGCCCTTATTCCCTTTTTTGCGGCATTTTGCCTTCCTGTTTTTGCTCACCCAGAAACGCTGGTGAAAGTAAAAGATGCTGAAGATCAGTTGGGTGCACGAGTGGGTTACATCGAGCTGGATCTCAACAGCGGTAAGATCCTTGAGAGTTTTCGCCCCGAAGAACGTTTTCCAATGATGAGCACTTTTAAAGTTCTGCTATGTGGTGCGGTATTATCCCGTGTTGACGCCGGGCAAGAGCAACTCGGTCGCCGCATACACTATTCTCAGAATGACTTGGTTGAGTACTCACCAGTCACAGAAAAGCATCTTACGGATGGCATGACAGTAAGAGAATTATGCAGTGCTGCCATAACCATGAGTGATAACACTGCGGCCAACTTACTTCTGACAACGATCGGAGGACCGAAGGAGCTAACCGCTTTTTTGCACAACATGGGGGATCATGTAACCCGCCTTGATCGTTGGGAACCGGAGCTGAATGAAGCCATACCAAACGACGAGCGTGACACCACGATGCCTGCAGCAATGGCAACAACGTTGCGCAAACTATTAACTGGCGAACTACTTACTCTAGCTTCCCGGCAACAATTAATAGACTGGATGGAGGCGGATAAAGTTGCAGGACCACTTCTGCGCTCGGCCCTTCCGGCTGGCTGGTTTATTGCTGATAAATCTGGAGCCGGTGAGCGTGGATCTCGCGGTATCATTGCAGCACTGGGGCCAGATGGTAAGCCCTCCCGTATCGTAGTTATCTACACGACGGGGAGTCAGGCAACTATGGA
486	gb|HQ317449|+|0-861|ARO:3001373|TEM-182	ATGAGTATTCAACATTTTCGTGTCGCCCTTATTCCCTTTTTTGCGGCATTTTGC...TAA	861.0	46	852	806	861	ATGAGTATTCAACATTTCCGTGTCGCCCTTATTCCCTTTTTTGCGGCATTTTGCCTTCCTGTTTTTGCTCACCCAGAAACGCTGGTGAAAGTAAAAGATGCTGAAGATCAGTTGGGTGCACGAGTGGGTTACATCGAGCTGGATCTCAACAGCGGTAAGATCCTTGAGAGTTTTCGCCCCGAAGAACGTTTTCCAATGATGAGCACTTTTAAAGTTCTGCTATGTGGTGCGGTATTATCCCGTGTTGACGCCGGGCAAGAGCAACTCGGTCGCCGCATACACTATTCTCAGAATGACTTGGTTGAGTACTCACCAGTCACAGAAAAGCATCTTACGGATGGCATGACAGTAAGAGAATTATGCAGTGCTGCCATAACCATGAGTGATAACACTGCGGCCAACTTACTTCTGACAACGATCGGAGGACCGAAGGAGCTAACCGCTTTTTTGCACAACATGGGGGATCATGTAACCCGCCTTGATCGTTGGGAACCGGAGCTGAATGAAGCCATACCAAACGACGAGCGTGACACCACGATGCCTGCAGCAATGGCAACAACGTTGCGCAAACTATTAACTGGCGAACTACTTACTCTAGCTTCCCGGCAACAATTAATAGACTGGATGGAGGCGGATAAAGTTGCAGGACCACTTCTGCGCTCGGCCCTTCCGGCTGGCTGGTTTATTGCTGATAAATCTGGAGCCGGTGAGCGTGGATCTCGCGGTATCATTGCAGCACTGGGGCCAGATGGTAAGCCCTCCCGTATCGTAGTTATCTACACGACGGGGAGTCAGGCAACTATGGA
487	gb|AF156486|+|5012-5792|ARO:3002602|aadA2	GTGACCATCGAAATTTCGAACCAACTATCAGAGGTGCTAAGCGTCATTGAGCGC...TGA	780.0	0	267	267	780	GTGACCATCGAAATTTCGAACCAACTATCAGAGGTGCTAAGCGTCATTGAGCGCCATCTGGAATCAACGTTGCTGGCCGTGCATTTGTACGGCTCCGCAGTGGATGGCGGCCTGAAGCCATACAGCGATATTGATTTGTTGGTTACTGTGGCCGTAAAGCTTGATGAAACGACGCGGCGAGCATTGCTCAATGACCTTATGGAGGCTTCGGCTTTCCCTGGCGAGAGCGAGACGCTCCGCGCTATAGAAGTCACCCTTGTCGTGCAT
488	gb|AY853593|+|214-1075|ARO:3001002|TEM-138	ATGAGTATTCAACATTTCCGTGTCGCCCTTATTCCCTTTTTTGCGGCATTTTGC...TAA	861.0	46	852	806	861	ATGAGTATTCAACATTTCCGTGTCGCCCTTATTCCCTTTTTTGCGGCATTTTGCCTTCCTGTTTTTGCTCACCCAGAAACGCTGGTGAAAGTAAAAGATGCTGAAGATCAGTTGGGTGCACGAGTGGGTTACATCGAGCTGGATCTCAACAGCGGTAAGATCCTTGAGAGTTTTCGCCCCGAAGAACGTTTTCCAATGATGAGCACTTTTAAAGTTCTGCTATGTGGTGCGGTATTATCCCGTGTTGACGCCGGGCAAGAGCAACTCGGTCGCCGCATACACTATTCTCAGAATGACTTGGTTGAGTACTCACCAGTCACAGAAAAGCATCTTACGGATGGCATGACAGTAAGAGAATTATGCAGTGCTGCCATAACCATGAGTGATAACACTGCGGCCAACTTACTTCTGACAACGATCGGAGGACCGAAGGAGCTAACCGCTTTTTTGCACAACATGGGGGATCATGTAACCCGCCTTGATCGTTGGGAACCGGAGCTGAATGAAGCCATACCAAACGACGAGCGTGACACCACGATGCCTGCAGCAATGGCAACAACGTTGCGCAAACTATTAACTGGCGAACTACTTACTCTAGCTTCCCGGCAACAATTAATAGACTGGATGGAGGCGGATAAAGTTGCAGGACCACTTCTGCGCTCGGCCCTTCCGGCTGGCTGGTTTATTGCTGATAAATCTGGAGCCGGTGAGCGTGGATCTCGCGGTATCATTGCAGCACTGGGGCCAGATGGTAAGCCCTCCCGTATCGTAGTTATCTACACGACGGGGAGTCAGGCAACTATGGA
489	gb|HQ529916|+|110-971|ARO:3001045|TEM-183	ATGAGTATTCAACATTTCCGTGTCGCCCTTATTCCCTTTTTTGCGGCATTTTGC...TAA	861.0	46	852	806	861	ATGAGTATTCAACATTTCCGTGTCGCCCTTATTCCCTTTTTTGCGGCATTTTGCCTTCCTGTTTTTGCTCACCCAGAAACGCTGGTGAAAGTAAAAGATGCTGAAGATCAGTTGGGTGCACGAGTGGGTTACATCGAGCTGGATCTCAACAGCGGTAAGATCCTTGAGAGTTTTCGCCCCGAAGAACGTTTTCCAATGATGAGCACTTTTAAAGTTCTGCTATGTGGTGCGGTATTATCCCGTGTTGACGCCGGGCAAGAGCAACTCGGTCGCCGCATACACTATTCTCAGAATGACTTGGTTGAGTACTCACCAGTCACAGAAAAGCATCTTACGGATGGCATGACAGTAAGAGAATTATGCAGTGCTGCCATAACCATGAGTGATAACACTGCGGCCAACTTACTTCTGACAACGATCGGAGGACCGAAGGAGCTAACCGCTTTTTTGCACAACATGGGGGATCATGTAACCCGCCTTGATCGTTGGGAACCGGAGCTGAATGAAGCCATACCAAACGACGAGCGTGACACCACGATGCCTGCAGCAATGGCAACAACGTTGCGCAAACTATTAACTGGCGAACTACTTACTCTAGCTTCCCGGCAACAATTAATAGACTGGATGGAGGCGGATAAAGTTGCAGGACCACTTCTGCGCTCGGCCCTTCCGGCTGGCTGGTTTATTGCTGATAAATCTGGAGCCGGTGAGCGTGGATCTCGCGGTATCATTGCAGCACTGGGGCCAGATGGTAAGCCCTCCCGTATCGTAGTTATCTACACGACGGGGAGTCAGGCAACTATGGA
490	gb|DQ072853|+|0-861|ARO:3001003|TEM-139	ATGAGTATTCAACATTTTCGTGTCGCCCTTATTCCCTTTTTTGCGGCATTTTGC...TAA	861.0	46	852	806	861	ATGAGTATTCAACATTTCCGTGTCGCCCTTATTCCCTTTTTTGCGGCATTTTGCCTTCCTGTTTTTGCTCACCCAGAAACGCTGGTGAAAGTAAAAGATGCTGAAGATCAGTTGGGTGCACGAGTGGGTTACATCGAGCTGGATCTCAACAGCGGTAAGATCCTTGAGAGTTTTCGCCCCGAAGAACGTTTTCCAATGATGAGCACTTTTAAAGTTCTGCTATGTGGTGCGGTATTATCCCGTGTTGACGCCGGGCAAGAGCAACTCGGTCGCCGCATACACTATTCTCAGAATGACTTGGTTGAGTACTCACCAGTCACAGAAAAGCATCTTACGGATGGCATGACAGTAAGAGAATTATGCAGTGCTGCCATAACCATGAGTGATAACACTGCGGCCAACTTACTTCTGACAACGATCGGAGGACCGAAGGAGCTAACCGCTTTTTTGCACAACATGGGGGATCATGTAACCCGCCTTGATCGTTGGGAACCGGAGCTGAATGAAGCCATACCAAACGACGAGCGTGACACCACGATGCCTGCAGCAATGGCAACAACGTTGCGCAAACTATTAACTGGCGAACTACTTACTCTAGCTTCCCGGCAACAATTAATAGACTGGATGGAGGCGGATAAAGTTGCAGGACCACTTCTGCGCTCGGCCCTTCCGGCTGGCTGGTTTATTGCTGATAAATCTGGAGCCGGTGAGCGTGGATCTCGCGGTATCATTGCAGCACTGGGGCCAGATGGTAAGCCCTCCCGTATCGTAGTTATCTACACGACGGGGAGTCAGGCAACTATGGA
491	gb|AY171244|+|46-838|ARO:3002618|aadA21	ATGAGGGTAGCGGTGACCATCGAAATTTCGAACCAACTATCAGAGGTGCTAAGC...TAA	792.0	10	747	737	792	ATGAGGGAAGCGGTGATCGCCGAAGTATCGACTCAACTATCAGAGGTAGTTGGCGTCATCGAGCGCCATCTCGAACCGACGTTGCTGGCCGTACATTTGTACGGCTCCGCAGTGGATGGCGGCCTGAAGCCACACAGTGATATTGATTTGCTGGTTACGGTGACCGTAAGGCTTGATGAAACAACGCGGCGAGCTTTGATCAACGACCTTTTGGAAACTTCGGCTTCCCCTGGAGAGAGCGAGATTCTCCGCGCTGTAGAAGTCACCATTGTTGTGCACGACGACATCATTCCGTGGCGTTATCCAGCTAAGCGCGAACTGCAATTTGGAGAATGGCAGCGCAATGACATTCTTGCAGGTATCTTCGAGCCAGCCACGATCGACATTGATCTGGCTATCTTGCTGACAAAAGCAAGAGAACATAGCGTTGCCTTGGTAGGTCCAGCGGCGGAGGAACTCTTTGATCCGGTTCCTGAACAGGATCTATTTGAGGCGCTAAATGAAACCTTAACGCTATGGAACTCGCCGCCCGACTGGGCTGGCGATGAGCGAAATGTAGTGCTTACGTTGTCCCGCATTTGGTACAGCGCAGTAACCGGCAAAATCGCGCCGAAGGATGTCGCTGCCGACTGGGCAATGGAGCGCCTGCCGGCCCAGTATCAGCCCGTCATACTTGAAGCTAGACAGGCTTATCTTGGACAAGAAGAAGATCGCTTGGCCTCGCGCGCAGATCAGTT
492	gb|KJ427797|+|0-825|ARO:3001577|OXA-391	ATGAACATTAAAGCACTCTTACTTATAACAAGCGCTATTTTTATTTCAGCCTGC...TAG	825.0	54149	54919	770	825	ATGAACATTAAAGCACTCTTACTTATAACAAGCGCTATTTTTATTTCAGCCTGCTCACCTTATATAGTGACTGCTAATCCAAATCACAGCGCTTCAAAATCTGATGTAAAAGCAGAGAAAATTAAAAATTTATTTAACGAAGCACACACTACGGGTGTTTTAGTTATCCAACAAGGCCAAACTCAACAAAGCTATGGTAATGATCTTGCTCGTGCTTCGACCGAGTATGTACCTGCTTCGACCTTCAAAATGCTTAATGCTTTGATCGGCCTTGAGCACCATAAGGCAACCACCACAGAAGTATTTAAGTGGGATGGTAAAAAAAGGTTATTCCCAGAATGGGAAAAGGACATGACCCTAGGCGATGCCATGAAAGCTTCCGCTATTCCAGTTTATCAAGATTTAGCTCGTCGTATTGGACTTGAGCTCATGTCTAAGGAAGTGAAGCGTGTTGGTTATGGCAATGCAGATATCGGTACCCAAGTCGATAATTTTTGGCTGGTGGGTCCTTTAAAAATTACTCCTCAGCAAGAGGCACAGTTTGCTTACAAGCTAGCTAATAAAACGCTTCCATTTAGCCAAAAAGTCCAAGATGAAGTGCAATCCATGCTATTCATAGAAGAAAAGAATGGAAACAAAATATACGCAAAAAGTGGTTGGGGATGGGATGTAAACCCACAAGTAGGCTGGTTAACTGGATGGGTTGTTCAGCCTCAAGGGAATATTGTAGCGTTCTCCCTTAACTTAGAAATGAAAAAAGGAATACCTAG
493	gb|KP881237.1|+|53-1205|ARO:3003883|ADC-77	ATGCGATTTAAAAAAATTTCTTGTCTACTTTTATCTCCGCTTTTTATTTTTAGT...TAA	1152.0	63	1160	1097	1152	ATGCGATTTAAAAAAATTTCTTGTCTACTTTTATCCCCGCTTTTTATTTTTAGTACCTCAATTTATGCGGGCAATACACCAAAAGACCAAGAAATTAAAAAACTGGTAGATCAAAACTTTAAACCGTTATTAGAAAAATATGATGTGCCAGGTATGGCTGTGGGTGTTATTCAAAATAATAAAAAGTATGAAATGTATTATGGTCTTCAATCTGTTCAAGATAAAAAAGCCGTAAATAGCAGTACTATTTTTGAGCTAGGTTCTGTCAGTAAATTATTTACCGCGACAGCAGGTGGATATGCAAAAAATAAAGGAAAAATCTCTTTTGACGATACGCCTGGTAAGTATTGGAAAGAACTAAAAAATACACCGATTGACCAAGTTAACTTACTTCAACTCGCGACGTATACAAGTGGTAACCTTGCCTTGCAATTTCCAGATGAAGTAAAAACAGATCAGCAAGTTTTAACATTTTTTAAAGACTGGAAACCTAAAAACTCAATCGGTGAATATCGACAATATTCAAACCCAAGCATTGGTTTATTTGGAAAAGTTGTAGCTTTGTCTATGAATAAACCTTTCGACCAAGTCTTAGAAAAAACAATTTTTCCGGCCCTTGGCTTAAAACATAGCTATGTAAATGTACCTAAGACCCAGATGCAAAACTATGCTTTTGGCTATAACCAAGAAAATCAGCCGATTCGAGTTAACCCCGGCCCACTCGATGCCCCAGCATATGGCGTCAAATCGACACTACCCGACATGTTGAGTTTTATTCATGCCAACCTAAATCCACAAAAATATCCAGCAGATATTCAACGGGCAATTAATGAAACACATCAGGGTCGCTATCAAGTAAATACCATGTATCAGGCACTCGGTTGGGAAGAGTTTTCTTATCCGGCAACGTTACAAACTTTATTAGACAGTAATTCAGAACAGATTGTGATGAAACCTAATAAAGTGACTGCTATTTCAAAGGAACCTTCAGTTAAGATGTACCATAAAACTGGCTCAACTACCGGTTTCGGAACATATGTGGTGTTTATTCCTAAAGAAAATATTGGTTTAGTCATGTTAACCAATAAACGTATTCC
494	gb|FR848831|+|0-861|ARO:3001375|TEM-184	ATGAGTATTAAACATTTCCGTGTCGCCCTTATTCCCTTTTTTGCGGCATTTTGC...TAA	861.0	46	852	806	861	ATGAGTATTCAACATTTCCGTGTCGCCCTTATTCCCTTTTTTGCGGCATTTTGCCTTCCTGTTTTTGCTCACCCAGAAACGCTGGTGAAAGTAAAAGATGCTGAAGATCAGTTGGGTGCACGAGTGGGTTACATCGAGCTGGATCTCAACAGCGGTAAGATCCTTGAGAGTTTTCGCCCCGAAGAACGTTTTCCAATGATGAGCACTTTTAAAGTTCTGCTATGTGGTGCGGTATTATCCCGTGTTGACGCCGGGCAAGAGCAACTCGGTCGCCGCATACACTATTCTCAGAATGACTTGGTTGAGTACTCACCAGTCACAGAAAAGCATCTTACGGATGGCATGACAGTAAGAGAATTATGCAGTGCTGCCATAACCATGAGTGATAACACTGCGGCCAACTTACTTCTGACAACGATCGGAGGACCGAAGGAGCTAACCGCTTTTTTGCACAACATGGGGGATCATGTAACCCGCCTTGATCGTTGGGAACCGGAGCTGAATGAAGCCATACCAAACGACGAGCGTGACACCACGATGCCTGCAGCAATGGCAACAACGTTGCGCAAACTATTAACTGGCGAACTACTTACTCTAGCTTCCCGGCAACAATTAATAGACTGGATGGAGGCGGATAAAGTTGCAGGACCACTTCTGCGCTCGGCCCTTCCGGCTGGCTGGTTTATTGCTGATAAATCTGGAGCCGGTGAGCGTGGATCTCGCGGTATCATTGCAGCACTGGGGCCAGATGGTAAGCCCTCCCGTATCGTAGTTATCTACACGACGGGGAGTCAGGCAACTATGGA
495	gb|AM261837|+|73-865|ARO:3002619|aadA22	ATGAGGGTAGCGGTGACCATCGAAATTTCGAACCAACTATCAGAGGTGCTAAGC...TAA	792.0	10	747	737	792	ATGAGGGAAGCGGTGATCGCCGAAGTATCGACTCAACTATCAGAGGTAGTTGGCGTCATCGAGCGCCATCTCGAACCGACGTTGCTGGCCGTACATTTGTACGGCTCCGCAGTGGATGGCGGCCTGAAGCCACACAGTGATATTGATTTGCTGGTTACGGTGACCGTAAGGCTTGATGAAACAACGCGGCGAGCTTTGATCAACGACCTTTTGGAAACTTCGGCTTCCCCTGGAGAGAGCGAGATTCTCCGCGCTGTAGAAGTCACCATTGTTGTGCACGACGACATCATTCCGTGGCGTTATCCAGCTAAGCGCGAACTGCAATTTGGAGAATGGCAGCGCAATGACATTCTTGCAGGTATCTTCGAGCCAGCCACGATCGACATTGATCTGGCTATCTTGCTGACAAAAGCAAGAGAACATAGCGTTGCCTTGGTAGGTCCAGCGGCGGAGGAACTCTTTGATCCGGTTCCTGAACAGGATCTATTTGAGGCGCTAAATGAAACCTTAACGCTATGGAACTCGCCGCCCGACTGGGCTGGCGATGAGCGAAATGTAGTGCTTACGTTGTCCCGCATTTGGTACAGCGCAGTAACCGGCAAAATCGCGCCGAAGGATGTCGCTGCCGACTGGGCAATGGAGCGCCTGCCGGCCCAGTATCAGCCCGTCATACTTGAAGCTAGACAGGCTTATCTTGGACAAGAAGAAGATCGCTTGGCCTCGCGCGCAGATCAGTT
496	gb|FJ666072|+|0-1194|ARO:3002508|PDC-9	ATGCGCGATACCAGATTCCCCTGCCTGTGCGGCATCGCCGCTTCCACACTGCTG...TGA	1194.0	35513	36652	1139	1194	ATGCGCGATACCAGATTCCCCTGCCTGTGCGGCATCGCCGCTTCCACACTGCTGTTCGCCACCACCCCGGCCATTGCCGATGAGGCCCCGGCGGATCGCCTGAAGGCACTGGTCGACGCCGCCGTACAACCGGTGATGAAGGCCAATGACATTCCGGGCCTGGCCGTAGCCATCAGCCTGAAAGGAGAACCGCATTACTTCAGCTATGGGCTGGCCTCGAAAGAGGACGGCCGCCGGGTGACGCCGGAGACCCTGTTCGAGATCGGCTCGGTGAGCAAGACCTTCACCGTCACCCTCGCCGGCTATGCCCTGGCCCAGGACAAGATGCGCCTCGACGACCGCGCCAGCCAGCACTGGCCGGCACTGCAGGGCAGCCGCTTCGACGGCATCAGCCTGCTCGACCTCGCGACCTATACCGCCGGCGGCTTGCCGCTGCAGTTCCCCGACTCGGTGCAGAAGGACCAGGCACAGATCCGCGACTACTACCGCCAGTGGCAGCCGACCTACGCGCCGGGCAGCCAGCGCCTCTATTCCAACCCGAGCATCGGCCTGTTCGGCTATCTCGCCGCGCGCAGCCTGGGCCAGCCGTTCGAACGGCTCATGGAGCAGCAATTGTTCCCGGCACTGGGCCTCGAACAGACCCACCTCGACGTGCCCGAGGCGGCGCTGGCGCAGTACGCCCAGGGCTACGGCAAGGACGACCGCCCGCTACGGGTCGGTCCCGGCCCGCTGGATGCCGAAGGCTACGGGGTGAAGACCAGCGCGGCCGACCTGCTGCGCTTCGTCGATGCCAACCTGCATCCGGAGCGCCTGGACAGGCCCTGGGCGCAGGCGCTCGATGCCACCCATCGCGGTTACTACAAGGTCGGCGACATGACCCAGGGCCTGGGCTGGGAAGCCTACGACTGGCCGATCTCCCTGAAGCGCCTGCAGGCCGGCAACTCGACGCCGATGGCGCTGCAACCACACAGGATCGCCAGGCTGCCCGCGCCACAGGCGCTGGAGGGCCAGCGCCTGCTGAACAAGACCGGCTCCACCAACGGCTTCGGCGCCTACGTGGCGTTCGTCCCGGGCCGCGACCTGGGCCTGGTGATCCTGGCCAACCGCAACTATCCCAATGCCGAGCGGGTGAAGATCGC
497	gb|AY956335|+|38-899|ARO:3001004|TEM-141	ATGAGTATTCAACATTTCCGTGTCGCCCTTATTCCCTTTTTTGCGGCATTTTGC...TAA	861.0	46	852	806	861	ATGAGTATTCAACATTTCCGTGTCGCCCTTATTCCCTTTTTTGCGGCATTTTGCCTTCCTGTTTTTGCTCACCCAGAAACGCTGGTGAAAGTAAAAGATGCTGAAGATCAGTTGGGTGCACGAGTGGGTTACATCGAGCTGGATCTCAACAGCGGTAAGATCCTTGAGAGTTTTCGCCCCGAAGAACGTTTTCCAATGATGAGCACTTTTAAAGTTCTGCTATGTGGTGCGGTATTATCCCGTGTTGACGCCGGGCAAGAGCAACTCGGTCGCCGCATACACTATTCTCAGAATGACTTGGTTGAGTACTCACCAGTCACAGAAAAGCATCTTACGGATGGCATGACAGTAAGAGAATTATGCAGTGCTGCCATAACCATGAGTGATAACACTGCGGCCAACTTACTTCTGACAACGATCGGAGGACCGAAGGAGCTAACCGCTTTTTTGCACAACATGGGGGATCATGTAACCCGCCTTGATCGTTGGGAACCGGAGCTGAATGAAGCCATACCAAACGACGAGCGTGACACCACGATGCCTGCAGCAATGGCAACAACGTTGCGCAAACTATTAACTGGCGAACTACTTACTCTAGCTTCCCGGCAACAATTAATAGACTGGATGGAGGCGGATAAAGTTGCAGGACCACTTCTGCGCTCGGCCCTTCCGGCTGGCTGGTTTATTGCTGATAAATCTGGAGCCGGTGAGCGTGGATCTCGCGGTATCATTGCAGCACTGGGGCCAGATGGTAAGCCCTCCCGTATCGTAGTTATCTACACGACGGGGAGTCAGGCAACTATGGA
498	gb|JF795538|+|0-861|ARO:3001374|TEM-185	ATGAGTATTCAACATTTCCGTGTCGCCCTTATTCCCTTTTTTGCGGCATTTTGC...TAA	861.0	46	852	806	861	ATGAGTATTCAACATTTCCGTGTCGCCCTTATTCCCTTTTTTGCGGCATTTTGCCTTCCTGTTTTTGCTCACCCAGAAACGCTGGTGAAAGTAAAAGATGCTGAAGATCAGTTGGGTGCACGAGTGGGTTACATCGAGCTGGATCTCAACAGCGGTAAGATCCTTGAGAGTTTTCGCCCCGAAGAACGTTTTCCAATGATGAGCACTTTTAAAGTTCTGCTATGTGGTGCGGTATTATCCCGTGTTGACGCCGGGCAAGAGCAACTCGGTCGCCGCATACACTATTCTCAGAATGACTTGGTTGAGTACTCACCAGTCACAGAAAAGCATCTTACGGATGGCATGACAGTAAGAGAATTATGCAGTGCTGCCATAACCATGAGTGATAACACTGCGGCCAACTTACTTCTGACAACGATCGGAGGACCGAAGGAGCTAACCGCTTTTTTGCACAACATGGGGGATCATGTAACCCGCCTTGATCGTTGGGAACCGGAGCTGAATGAAGCCATACCAAACGACGAGCGTGACACCACGATGCCTGCAGCAATGGCAACAACGTTGCGCAAACTATTAACTGGCGAACTACTTACTCTAGCTTCCCGGCAACAATTAATAGACTGGATGGAGGCGGATAAAGTTGCAGGACCACTTCTGCGCTCGGCCCTTCCGGCTGGCTGGTTTATTGCTGATAAATCTGGAGCCGGTGAGCGTGGATCTCGCGGTATCATTGCAGCACTGGGGCCAGATGGTAAGCCCTCCCGTATCGTAGTTATCTACACGACGGGGAGTCAGGCAACTATGGA
499	gb|AJ809407|+|118-898|ARO:3002620|aadA23	GTGACCATCGAAATTTCGAACCAACTATCAGAGGTGCTAAGCGTCATTGAGCGC...TAA	780.0	37	747	710	780	TCGACTCAACTATCAGAGGTAGTTGGCGTCATCGAGCGCCATCTCGAACCGACGTTGCTGGCCGTACATTTGTACGGCTCCGCAGTGGATGGCGGCCTGAAGCCACACAGTGATATTGATTTGCTGGTTACGGTGACCGTAAGGCTTGATGAAACAACGCGGCGAGCTTTGATCAACGACCTTTTGGAAACTTCGGCTTCCCCTGGAGAGAGCGAGATTCTCCGCGCTGTAGAAGTCACCATTGTTGTGCACGACGACATCATTCCGTGGCGTTATCCAGCTAAGCGCGAACTGCAATTTGGAGAATGGCAGCGCAATGACATTCTTGCAGGTATCTTCGAGCCAGCCACGATCGACATTGATCTGGCTATCTTGCTGACAAAAGCAAGAGAACATAGCGTTGCCTTGGTAGGTCCAGCGGCGGAGGAACTCTTTGATCCGGTTCCTGAACAGGATCTATTTGAGGCGCTAAATGAAACCTTAACGCTATGGAACTCGCCGCCCGACTGGGCTGGCGATGAGCGAAATGTAGTGCTTACGTTGTCCCGCATTTGGTACAGCGCAGTAACCGGCAAAATCGCGCCGAAGGATGTCGCTGCCGACTGGGCAATGGAGCGCCTGCCGGCCCAGTATCAGCCCGTCATACTTGAAGCTAGACAGGCTTATCTTGGACAAGAAGAAGATCGCTTGGCCTCGCGCGCAGATCAGTT
500	gb|KM087842|+|0-822|ARO:3001584|OXA-398	ATGAATAAATATTTTACTTGCTATGTGGTTGCTTCTCTTTTTCTTTCTGGTTGT...TAA	822.0	80	847	767	822	ATGAATAAATATTTTACTTGCTATGTGGTTGCTTCTCTTTTTCTTTCTGGTTGTACGGTTCAGCATAATTTAATAAATGAAACCCCGAGTCAGATTGTTCAAGGACATAATCAGGTGATTCATCAATACTTTGATGAAAAAAACACCTCAGGTGTGCTGGTTATTCAAACAGATAAAAAAATTAATCTATATGGTAATGCTCTAAGCCGCGCAAATACAGAATATGTGCCAGCCTCTACATTTAAAATGTTGAATGCCCTGATCGGATTGGAGAACCAGAAAACGGATATTAATGAAATATTTAAATGGAAGGGCGAGAAAAGGTCATTTACCGCTTGGGAAAAAGACATGACACTAGGAGAAGCCATGAAGCTTTCTGCAGTCCCAGTCTATCAGGAACTTGCGCGACGTATCGGTCTTGATCTCATGCAAAAAGAAGTAAAACGTATTGGTTTCGGTAATGCTGAAATTGGACAGCAGGTTGATAATTTCTGGTTGGTAGGACCATTAAAGGTTACGCCTATTCAAGAGGTAGAGTTTGTTTCCCAATTAGCACATACACAGCTTCCATTTAGTGAAAAAGTGCAGGCTAATGTAAAAAATATGCTTCTTTTAGAAGAGAGTAATGGCTACAAAATTTTTGGAAAGACTGGTTGGGCAATGGATATAAAACCACAAGTGGGCTGGTTGACCGGCTGGGTTGAGCAGCCAGATGGAAAAATTGTCGCTTTTGCATTAAATATGGAAATGCGGTCAGAAATGCCGGC
501	gb|JN227084|+|308-1169|ARO:3001046|TEM-186	ATGAGTATTCAACATTTTCGTGTCGCCCTTATTCCCTTTTTTGCGGCATTTTGC...TAA	861.0	46	852	806	861	ATGAGTATTCAACATTTCCGTGTCGCCCTTATTCCCTTTTTTGCGGCATTTTGCCTTCCTGTTTTTGCTCACCCAGAAACGCTGGTGAAAGTAAAAGATGCTGAAGATCAGTTGGGTGCACGAGTGGGTTACATCGAGCTGGATCTCAACAGCGGTAAGATCCTTGAGAGTTTTCGCCCCGAAGAACGTTTTCCAATGATGAGCACTTTTAAAGTTCTGCTATGTGGTGCGGTATTATCCCGTGTTGACGCCGGGCAAGAGCAACTCGGTCGCCGCATACACTATTCTCAGAATGACTTGGTTGAGTACTCACCAGTCACAGAAAAGCATCTTACGGATGGCATGACAGTAAGAGAATTATGCAGTGCTGCCATAACCATGAGTGATAACACTGCGGCCAACTTACTTCTGACAACGATCGGAGGACCGAAGGAGCTAACCGCTTTTTTGCACAACATGGGGGATCATGTAACCCGCCTTGATCGTTGGGAACCGGAGCTGAATGAAGCCATACCAAACGACGAGCGTGACACCACGATGCCTGCAGCAATGGCAACAACGTTGCGCAAACTATTAACTGGCGAACTACTTACTCTAGCTTCCCGGCAACAATTAATAGACTGGATGGAGGCGGATAAAGTTGCAGGACCACTTCTGCGCTCGGCCCTTCCGGCTGGCTGGTTTATTGCTGATAAATCTGGAGCCGGTGAGCGTGGATCTCGCGGTATCATTGCAGCACTGGGGCCAGATGGTAAGCCCTCCCGTATCGTAGTTATCTACACGACGGGGAGTCAGGCAACTATGGA
502	gb|DQ388882|+|0-861|ARO:3001005|TEM-142	ATGAGTATTCAACATTTCCGTGTCGCCCTTATTCCCTTTTTTGCGGCATTTTGC...TAA	861.0	46	852	806	861	ATGAGTATTCAACATTTCCGTGTCGCCCTTATTCCCTTTTTTGCGGCATTTTGCCTTCCTGTTTTTGCTCACCCAGAAACGCTGGTGAAAGTAAAAGATGCTGAAGATCAGTTGGGTGCACGAGTGGGTTACATCGAGCTGGATCTCAACAGCGGTAAGATCCTTGAGAGTTTTCGCCCCGAAGAACGTTTTCCAATGATGAGCACTTTTAAAGTTCTGCTATGTGGTGCGGTATTATCCCGTGTTGACGCCGGGCAAGAGCAACTCGGTCGCCGCATACACTATTCTCAGAATGACTTGGTTGAGTACTCACCAGTCACAGAAAAGCATCTTACGGATGGCATGACAGTAAGAGAATTATGCAGTGCTGCCATAACCATGAGTGATAACACTGCGGCCAACTTACTTCTGACAACGATCGGAGGACCGAAGGAGCTAACCGCTTTTTTGCACAACATGGGGGATCATGTAACCCGCCTTGATCGTTGGGAACCGGAGCTGAATGAAGCCATACCAAACGACGAGCGTGACACCACGATGCCTGCAGCAATGGCAACAACGTTGCGCAAACTATTAACTGGCGAACTACTTACTCTAGCTTCCCGGCAACAATTAATAGACTGGATGGAGGCGGATAAAGTTGCAGGACCACTTCTGCGCTCGGCCCTTCCGGCTGGCTGGTTTATTGCTGATAAATCTGGAGCCGGTGAGCGTGGATCTCGCGGTATCATTGCAGCACTGGGGCCAGATGGTAAGCCCTCCCGTATCGTAGTTATCTACACGACGGGGAGTCAGGCAACTATGGA
503	gb|DQ286729|+|0-861|ARO:3000924|TEM-55	ATGAGTATTCAACATTTCCGTGTCGCCCTTATTCCCTTTTTTGCGGCATTTTGC...TAA	861.0	46	852	806	861	ATGAGTATTCAACATTTCCGTGTCGCCCTTATTCCCTTTTTTGCGGCATTTTGCCTTCCTGTTTTTGCTCACCCAGAAACGCTGGTGAAAGTAAAAGATGCTGAAGATCAGTTGGGTGCACGAGTGGGTTACATCGAGCTGGATCTCAACAGCGGTAAGATCCTTGAGAGTTTTCGCCCCGAAGAACGTTTTCCAATGATGAGCACTTTTAAAGTTCTGCTATGTGGTGCGGTATTATCCCGTGTTGACGCCGGGCAAGAGCAACTCGGTCGCCGCATACACTATTCTCAGAATGACTTGGTTGAGTACTCACCAGTCACAGAAAAGCATCTTACGGATGGCATGACAGTAAGAGAATTATGCAGTGCTGCCATAACCATGAGTGATAACACTGCGGCCAACTTACTTCTGACAACGATCGGAGGACCGAAGGAGCTAACCGCTTTTTTGCACAACATGGGGGATCATGTAACCCGCCTTGATCGTTGGGAACCGGAGCTGAATGAAGCCATACCAAACGACGAGCGTGACACCACGATGCCTGCAGCAATGGCAACAACGTTGCGCAAACTATTAACTGGCGAACTACTTACTCTAGCTTCCCGGCAACAATTAATAGACTGGATGGAGGCGGATAAAGTTGCAGGACCACTTCTGCGCTCGGCCCTTCCGGCTGGCTGGTTTATTGCTGATAAATCTGGAGCCGGTGAGCGTGGATCTCGCGGTATCATTGCAGCACTGGGGCCAGATGGTAAGCCCTCCCGTATCGTAGTTATCTACACGACGGGGAGTCAGGCAACTATGGA
504	gb|DQ677333|+|0-780|ARO:3002621|aadA24	GTGACCATCGAAATTTCGAACCAACTATCAGAGGTGCTAAGCGTCATTGAGCGC...TAA	780.0	37	747	710	780	TCGACTCAACTATCAGAGGTAGTTGGCGTCATCGAGCGCCATCTCGAACCGACGTTGCTGGCCGTACATTTGTACGGCTCCGCAGTGGATGGCGGCCTGAAGCCACACAGTGATATTGATTTGCTGGTTACGGTGACCGTAAGGCTTGATGAAACAACGCGGCGAGCTTTGATCAACGACCTTTTGGAAACTTCGGCTTCCCCTGGAGAGAGCGAGATTCTCCGCGCTGTAGAAGTCACCATTGTTGTGCACGACGACATCATTCCGTGGCGTTATCCAGCTAAGCGCGAACTGCAATTTGGAGAATGGCAGCGCAATGACATTCTTGCAGGTATCTTCGAGCCAGCCACGATCGACATTGATCTGGCTATCTTGCTGACAAAAGCAAGAGAACATAGCGTTGCCTTGGTAGGTCCAGCGGCGGAGGAACTCTTTGATCCGGTTCCTGAACAGGATCTATTTGAGGCGCTAAATGAAACCTTAACGCTATGGAACTCGCCGCCCGACTGGGCTGGCGATGAGCGAAATGTAGTGCTTACGTTGTCCCGCATTTGGTACAGCGCAGTAACCGGCAAAATCGCGCCGAAGGATGTCGCTGCCGACTGGGCAATGGAGCGCCTGCCGGCCCAGTATCAGCCCGTCATACTTGAAGCTAGACAGGCTTATCTTGGACAAGAAGAAGATCGCTTGGCCTCGCGCGCAGATCAGTT
505	gb|KP881238.1|+|0-1152|ARO:3003884|ADC-78	ATGCGATTTAAAAAAATTTCTTGTCTACTTTTATCCCCGCTTTTTATTTTTAGT...TAA	1152.0	63	1160	1097	1152	ATGCGATTTAAAAAAATTTCTTGTCTACTTTTATCCCCGCTTTTTATTTTTAGTACCTCAATTTATGCGGGCAATACACCAAAAGACCAAGAAATTAAAAAACTGGTAGATCAAAACTTTAAACCGTTATTAGAAAAATATGATGTGCCAGGTATGGCTGTGGGTGTTATTCAAAATAATAAAAAGTATGAAATGTATTATGGTCTTCAATCTGTTCAAGATAAAAAAGCCGTAAATAGCAGTACTATTTTTGAGCTAGGTTCTGTCAGTAAATTATTTACCGCGACAGCAGGTGGATATGCAAAAAATAAAGGAAAAATCTCTTTTGACGATACGCCTGGTAAGTATTGGAAAGAACTAAAAAATACACCGATTGACCAAGTTAACTTACTTCAACTCGCGACGTATACAAGTGGTAACCTTGCCTTGCAATTTCCAGATGAAGTAAAAACAGATCAGCAAGTTTTAACATTTTTTAAAGACTGGAAACCTAAAAACTCAATCGGTGAATATCGACAATATTCAAACCCAAGCATTGGTTTATTTGGAAAAGTTGTAGCTTTGTCTATGAATAAACCTTTCGACCAAGTCTTAGAAAAAACAATTTTTCCGGCCCTTGGCTTAAAACATAGCTATGTAAATGTACCTAAGACCCAGATGCAAAACTATGCTTTTGGCTATAACCAAGAAAATCAGCCGATTCGAGTTAACCCCGGCCCACTCGATGCCCCAGCATATGGCGTCAAATCGACACTACCCGACATGTTGAGTTTTATTCATGCCAACCTAAATCCACAAAAATATCCAGCAGATATTCAACGGGCAATTAATGAAACACATCAGGGTCGCTATCAAGTAAATACCATGTATCAGGCACTCGGTTGGGAAGAGTTTTCTTATCCGGCAACGTTACAAACTTTATTAGACAGTAATTCAGAACAGATTGTGATGAAACCTAATAAAGTGACTGCTATTTCAAAGGAACCTTCAGTTAAGATGTACCATAAAACTGGCTCAACTACCGGTTTCGGAACATATGTGGTGTTTATTCCTAAAGAAAATATTGGTTTAGTCATGTTAACCAATAAACGTATTCC
506	gb|KR057759.1|+|0-1107|ARO:3004353|PDC-90	GATGAGGCCCCGGCGGATCGCCTGAAGGCACTGGTCGACGCCGCCGTACAACCG...TGA	1107.0	35591	36652	1061	1107	GATGAGGCCCCGGCGGATCGCCTGAAGGCACTGGTCGACGCCGCCGTACAACCGGTGATGAAGGCCAATGACATTCCGGGCCTGGCCGTAGCCATCAGCCTGAAAGGAGAACCGCATTACTTCAGCTATGGGCTGGCCTCGAAAGAGGACGGCCGCCGGGTGACGCCGGAGACCCTGTTCGAGATCGGCTCGGTGAGCAAGACCTTCACCGTCACCCTCGCCGGCTATGCCCTGGCCCAGGACAAGATGCGCCTCGACGACCGCGCCAGCCAGCACTGGCCGGCACTGCAGGGCAGCCGCTTCGACGGCATCAGCCTGCTCGACCTCGCGACCTATACCGCCGGCGGCTTGCCGCTGCAGTTCCCCGACTCGGTGCAGAAGGACCAGGCACAGATCCGCGACTACTACCGCCAGTGGCAGCCGACCTACGCGCCGGGCAGCCAGCGCCTCTATTCCAACCCGAGCATCGGCCTGTTCGGCTATCTCGCCGCGCGCAGCCTGGGCCAGCCGTTCGAACGGCTCATGGAGCAGCAATTGTTCCCGGCACTGGGCCTCGAACAGACCCACCTCGACGTGCCCGAGGCGGCGCTGGCGCAGTACGCCCAGGGCTACGGCAAGGACGACCGCCCGCTACGGGTCGGTCCCGGCCCGCTGGATGCCGAAGGCTACGGGGTGAAGACCAGCGCGGCCGACCTGCTGCGCTTCGTCGATGCCAACCTGCATCCGGAGCGCCTGGACAGGCCCTGGGCGCAGGCGCTCGATGCCACCCATCGCGGTTACTACAAGGTCGGCGACATGACCCAGGGCCTGGGCTGGGAAGCCTACGACTGGCCGATCTCCCTGAAGCGCCTGCAGGCCGGCAACTCGACGCCGATGGCGCTGCAACCACACAGGATCGCCAGGCTGCCCGCGCCACAGGCGCTGGAGGGCCAGCGCCTGCTGAACAAGACCGGCTCCACCAACGGCTTCGGCGCCTACGTGGCGTTCGTCCCGGGCCGCGACCTGGGCCTGGTGATCCTGGCCAACCGCAACTATCCCAATGCCGAGCGGGTGAAGATCGC
507	gb|CP003022|+|336788-337580|ARO:3003197|aadA25	ATGAGGGAAGCGGTGACCATCGAAATTTCGAACCAACTATCAGAGGTGCTAAGC...TAA	792.0	10	747	737	792	ATGAGGGAAGCGGTGATCGCCGAAGTATCGACTCAACTATCAGAGGTAGTTGGCGTCATCGAGCGCCATCTCGAACCGACGTTGCTGGCCGTACATTTGTACGGCTCCGCAGTGGATGGCGGCCTGAAGCCACACAGTGATATTGATTTGCTGGTTACGGTGACCGTAAGGCTTGATGAAACAACGCGGCGAGCTTTGATCAACGACCTTTTGGAAACTTCGGCTTCCCCTGGAGAGAGCGAGATTCTCCGCGCTGTAGAAGTCACCATTGTTGTGCACGACGACATCATTCCGTGGCGTTATCCAGCTAAGCGCGAACTGCAATTTGGAGAATGGCAGCGCAATGACATTCTTGCAGGTATCTTCGAGCCAGCCACGATCGACATTGATCTGGCTATCTTGCTGACAAAAGCAAGAGAACATAGCGTTGCCTTGGTAGGTCCAGCGGCGGAGGAACTCTTTGATCCGGTTCCTGAACAGGATCTATTTGAGGCGCTAAATGAAACCTTAACGCTATGGAACTCGCCGCCCGACTGGGCTGGCGATGAGCGAAATGTAGTGCTTACGTTGTCCCGCATTTGGTACAGCGCAGTAACCGGCAAAATCGCGCCGAAGGATGTCGCTGCCGACTGGGCAATGGAGCGCCTGCCGGCCCAGTATCAGCCCGTCATACTTGAAGCTAGACAGGCTTATCTTGGACAAGAAGAAGATCGCTTGGCCTCGCGCGCAGATCAGTT
508	gb|HM246246|+|211-1069|ARO:3001047|TEM-187	ATGAGTATTCAACATTTCCGTGTCGCCCTTATTCCCTTTTTTGCGGCATTTTGC...TGA	858.0	46	848	802	858	ATGAGTATTCAACATTTCCGTGTCGCCCTTATTCCCTTTTTTGCGGCATTTTGCCTTCCTGTTTTTGCTCACCCAGAAACGCTGGTGAAAGTAAAAGATGCTGAAGATCAGTTGGGTGCACGAGTGGGTTACATCGAGCTGGATCTCAACAGCGGTAAGATCCTTGAGAGTTTTCGCCCCGAAGAACGTTTTCCAATGATGAGCACTTTTAAAGTTCTGCTATGTGGTGCGGTATTATCCCGTGTTGACGCCGGGCAAGAGCAACTCGGTCGCCGCATACACTATTCTCAGAATGACTTGGTTGAGTACTCACCAGTCACAGAAAAGCATCTTACGGATGGCATGACAGTAAGAGAATTATGCAGTGCTGCCATAACCATGAGTGATAACACTGCGGCCAACTTACTTCTGACAACGATCGGAGGACCGAAGGAGCTAACCGCTTTTTTGCACAACATGGGGGATCATGTAACCCGCCTTGATCGTTGGGAACCGGAGCTGAATGAAGCCATACCAAACGACGAGCGTGACACCACGATGCCTGCAGCAATGGCAACAACGTTGCGCAAACTATTAACTGGCGAACTACTTACTCTAGCTTCCCGGCAACAATTAATAGACTGGATGGAGGCGGATAAAGTTGCAGGACCACTTCTGCGCTCGGCCCTTCCGGCTGGCTGGTTTATTGCTGATAAATCTGGAGCCGGTGAGCGTGGATCTCGCGGTATCATTGCAGCACTGGGGCCAGATGGTAAGCCCTCCCGTATCGTAGTTATCTACACGACGGGGAGTCAGGCAACTA
509	gb|KJ780078.1|+|0-825|ARO:3001586|OXA-400	ATGAACATTAAAACACTCTTACTTATAACAAGCGCTATTTTTATTTCAGCCTGT...TAG	825.0	54149	54919	770	825	ATGAACATTAAAGCACTCTTACTTATAACAAGCGCTATTTTTATTTCAGCCTGCTCACCTTATATAGTGACTGCTAATCCAAATCACAGCGCTTCAAAATCTGATGTAAAAGCAGAGAAAATTAAAAATTTATTTAACGAAGCACACACTACGGGTGTTTTAGTTATCCAACAAGGCCAAACTCAACAAAGCTATGGTAATGATCTTGCTCGTGCTTCGACCGAGTATGTACCTGCTTCGACCTTCAAAATGCTTAATGCTTTGATCGGCCTTGAGCACCATAAGGCAACCACCACAGAAGTATTTAAGTGGGATGGTAAAAAAAGGTTATTCCCAGAATGGGAAAAGGACATGACCCTAGGCGATGCCATGAAAGCTTCCGCTATTCCAGTTTATCAAGATTTAGCTCGTCGTATTGGACTTGAGCTCATGTCTAAGGAAGTGAAGCGTGTTGGTTATGGCAATGCAGATATCGGTACCCAAGTCGATAATTTTTGGCTGGTGGGTCCTTTAAAAATTACTCCTCAGCAAGAGGCACAGTTTGCTTACAAGCTAGCTAATAAAACGCTTCCATTTAGCCAAAAAGTCCAAGATGAAGTGCAATCCATGCTATTCATAGAAGAAAAGAATGGAAACAAAATATACGCAAAAAGTGGTTGGGGATGGGATGTAAACCCACAAGTAGGCTGGTTAACTGGATGGGTTGTTCAGCCTCAAGGGAATATTGTAGCGTTCTCCCTTAACTTAGAAATGAAAAAAGGAATACCTAG
510	gb|FJ405211|+|0-861|ARO:3000926|TEM-57	ATGAGTATTCAACATTTCCGTGTCGCCCTTATTCCCTTTTTTGCGGCATTTTGC...TAA	861.0	46	852	806	861	ATGAGTATTCAACATTTCCGTGTCGCCCTTATTCCCTTTTTTGCGGCATTTTGCCTTCCTGTTTTTGCTCACCCAGAAACGCTGGTGAAAGTAAAAGATGCTGAAGATCAGTTGGGTGCACGAGTGGGTTACATCGAGCTGGATCTCAACAGCGGTAAGATCCTTGAGAGTTTTCGCCCCGAAGAACGTTTTCCAATGATGAGCACTTTTAAAGTTCTGCTATGTGGTGCGGTATTATCCCGTGTTGACGCCGGGCAAGAGCAACTCGGTCGCCGCATACACTATTCTCAGAATGACTTGGTTGAGTACTCACCAGTCACAGAAAAGCATCTTACGGATGGCATGACAGTAAGAGAATTATGCAGTGCTGCCATAACCATGAGTGATAACACTGCGGCCAACTTACTTCTGACAACGATCGGAGGACCGAAGGAGCTAACCGCTTTTTTGCACAACATGGGGGATCATGTAACCCGCCTTGATCGTTGGGAACCGGAGCTGAATGAAGCCATACCAAACGACGAGCGTGACACCACGATGCCTGCAGCAATGGCAACAACGTTGCGCAAACTATTAACTGGCGAACTACTTACTCTAGCTTCCCGGCAACAATTAATAGACTGGATGGAGGCGGATAAAGTTGCAGGACCACTTCTGCGCTCGGCCCTTCCGGCTGGCTGGTTTATTGCTGATAAATCTGGAGCCGGTGAGCGTGGATCTCGCGGTATCATTGCAGCACTGGGGCCAGATGGTAAGCCCTCCCGTATCGTAGTTATCTACACGACGGGGAGTCAGGCAACTATGGA
511	gb|JN211012|+|213-1074|ARO:3001048|TEM-188	ATGAGTATTCAACATTTCCGTGTCGCCCTTATTCCCTTTTTTGCGGCATTTTGC...TAA	861.0	46	852	806	861	ATGAGTATTCAACATTTCCGTGTCGCCCTTATTCCCTTTTTTGCGGCATTTTGCCTTCCTGTTTTTGCTCACCCAGAAACGCTGGTGAAAGTAAAAGATGCTGAAGATCAGTTGGGTGCACGAGTGGGTTACATCGAGCTGGATCTCAACAGCGGTAAGATCCTTGAGAGTTTTCGCCCCGAAGAACGTTTTCCAATGATGAGCACTTTTAAAGTTCTGCTATGTGGTGCGGTATTATCCCGTGTTGACGCCGGGCAAGAGCAACTCGGTCGCCGCATACACTATTCTCAGAATGACTTGGTTGAGTACTCACCAGTCACAGAAAAGCATCTTACGGATGGCATGACAGTAAGAGAATTATGCAGTGCTGCCATAACCATGAGTGATAACACTGCGGCCAACTTACTTCTGACAACGATCGGAGGACCGAAGGAGCTAACCGCTTTTTTGCACAACATGGGGGATCATGTAACCCGCCTTGATCGTTGGGAACCGGAGCTGAATGAAGCCATACCAAACGACGAGCGTGACACCACGATGCCTGCAGCAATGGCAACAACGTTGCGCAAACTATTAACTGGCGAACTACTTACTCTAGCTTCCCGGCAACAATTAATAGACTGGATGGAGGCGGATAAAGTTGCAGGACCACTTCTGCGCTCGGCCCTTCCGGCTGGCTGGTTTATTGCTGATAAATCTGGAGCCGGTGAGCGTGGATCTCGCGGTATCATTGCAGCACTGGGGCCAGATGGTAAGCCCTCCCGTATCGTAGTTATCTACACGACGGGGAGTCAGGCAACTATGGA
512	gb|AF047479|+|1295-2087|ARO:3002603|aadA3	ATGAGGGTAGCGGTGACCATCGAAATTTCGAACCAACTATCAGAGGTGCTAAGC...TAA	792.0	0	267	267	792	GTGACCATCGAAATTTCGAACCAACTATCAGAGGTGCTAAGCGTCATTGAGCGCCATCTGGAATCAACGTTGCTGGCCGTGCATTTGTACGGCTCCGCAGTGGATGGCGGCCTGAAGCCATACAGCGATATTGATTTGTTGGTTACTGTGGCCGTAAAGCTTGATGAAACGACGCGGCGAGCATTGCTCAATGACCTTATGGAGGCTTCGGCTTTCCCTGGCGAGAGCGAGACGCTCCGCGCTATAGAAGTCACCCTTGTCGTGCAT
513	gb|AF062386|+|30-862|ARO:3000928|TEM-59	ATGAGTATTCAACATTTCCGTGTCGCCCTTATTCCCTTTTTTGCGGCATTTTGC...GAG	831.0	46	822	776	831	ATGAGTATTCAACATTTCCGTGTCGCCCTTATTCCCTTTTTTGCGGCATTTTGCCTTCCTGTTTTTGCTCACCCAGAAACGCTGGTGAAAGTAAAAGATGCTGAAGATCAGTTGGGTGCACGAGTGGGTTACATCGAGCTGGATCTCAACAGCGGTAAGATCCTTGAGAGTTTTCGCCCCGAAGAACGTTTTCCAATGATGAGCACTTTTAAAGTTCTGCTATGTGGTGCGGTATTATCCCGTGTTGACGCCGGGCAAGAGCAACTCGGTCGCCGCATACACTATTCTCAGAATGACTTGGTTGAGTACTCACCAGTCACAGAAAAGCATCTTACGGATGGCATGACAGTAAGAGAATTATGCAGTGCTGCCATAACCATGAGTGATAACACTGCGGCCAACTTACTTCTGACAACGATCGGAGGACCGAAGGAGCTAACCGCTTTTTTGCACAACATGGGGGATCATGTAACCCGCCTTGATCGTTGGGAACCGGAGCTGAATGAAGCCATACCAAACGACGAGCGTGACACCACGATGCCTGCAGCAATGGCAACAACGTTGCGCAAACTATTAACTGGCGAACTACTTACTCTAGCTTCCCGGCAACAATTAATAGACTGGATGGAGGCGGATAAAGTTGCAGGACCACTTCTGCGCTCGGCCCTTCCGGCTGGCTGGTTTATTGCTGATAAATCTGGAGCCGGTGAGCGTGGATCTCGCGGTATCATTGCAGCACTGGGGCCAGATGGTAAGCCCTCCCGTATCGTAGTTAT
514	gb|DQ075245|+|217-1078|ARO:3001006|TEM-143	ATGAGTATTCAACATTTTCGTGTCGCCCTTATTCCCTTTTTTGCGGCATTTTGC...TAA	861.0	46	852	806	861	ATGAGTATTCAACATTTCCGTGTCGCCCTTATTCCCTTTTTTGCGGCATTTTGCCTTCCTGTTTTTGCTCACCCAGAAACGCTGGTGAAAGTAAAAGATGCTGAAGATCAGTTGGGTGCACGAGTGGGTTACATCGAGCTGGATCTCAACAGCGGTAAGATCCTTGAGAGTTTTCGCCCCGAAGAACGTTTTCCAATGATGAGCACTTTTAAAGTTCTGCTATGTGGTGCGGTATTATCCCGTGTTGACGCCGGGCAAGAGCAACTCGGTCGCCGCATACACTATTCTCAGAATGACTTGGTTGAGTACTCACCAGTCACAGAAAAGCATCTTACGGATGGCATGACAGTAAGAGAATTATGCAGTGCTGCCATAACCATGAGTGATAACACTGCGGCCAACTTACTTCTGACAACGATCGGAGGACCGAAGGAGCTAACCGCTTTTTTGCACAACATGGGGGATCATGTAACCCGCCTTGATCGTTGGGAACCGGAGCTGAATGAAGCCATACCAAACGACGAGCGTGACACCACGATGCCTGCAGCAATGGCAACAACGTTGCGCAAACTATTAACTGGCGAACTACTTACTCTAGCTTCCCGGCAACAATTAATAGACTGGATGGAGGCGGATAAAGTTGCAGGACCACTTCTGCGCTCGGCCCTTCCGGCTGGCTGGTTTATTGCTGATAAATCTGGAGCCGGTGAGCGTGGATCTCGCGGTATCATTGCAGCACTGGGGCCAGATGGTAAGCCCTCCCGTATCGTAGTTATCTACACGACGGGGAGTCAGGCAACTATGGA
515	gb|KP881239.1|+|0-1152|ARO:3003885|ADC-79	ATGCAATTTAAAAAAATTTCTTGTCTACTTTTATCCCCGCTTTTTATTTTTAGT...TAA	1152.0	68	1160	1092	1152	ATTTAAAAAAATTTCTTGTCTACTTTTATCCCCGCTTTTTATTTTTAGTACCTCAATTTATGCGGGCAATACACCAAAAGACCAAGAAATTAAAAAACTGGTAGATCAAAACTTTAAACCGTTATTAGAAAAATATGATGTGCCAGGTATGGCTGTGGGTGTTATTCAAAATAATAAAAAGTATGAAATGTATTATGGTCTTCAATCTGTTCAAGATAAAAAAGCCGTAAATAGCAGTACTATTTTTGAGCTAGGTTCTGTCAGTAAATTATTTACCGCGACAGCAGGTGGATATGCAAAAAATAAAGGAAAAATCTCTTTTGACGATACGCCTGGTAAGTATTGGAAAGAACTAAAAAATACACCGATTGACCAAGTTAACTTACTTCAACTCGCGACGTATACAAGTGGTAACCTTGCCTTGCAATTTCCAGATGAAGTAAAAACAGATCAGCAAGTTTTAACATTTTTTAAAGACTGGAAACCTAAAAACTCAATCGGTGAATATCGACAATATTCAAACCCAAGCATTGGTTTATTTGGAAAAGTTGTAGCTTTGTCTATGAATAAACCTTTCGACCAAGTCTTAGAAAAAACAATTTTTCCGGCCCTTGGCTTAAAACATAGCTATGTAAATGTACCTAAGACCCAGATGCAAAACTATGCTTTTGGCTATAACCAAGAAAATCAGCCGATTCGAGTTAACCCCGGCCCACTCGATGCCCCAGCATATGGCGTCAAATCGACACTACCCGACATGTTGAGTTTTATTCATGCCAACCTAAATCCACAAAAATATCCAGCAGATATTCAACGGGCAATTAATGAAACACATCAGGGTCGCTATCAAGTAAATACCATGTATCAGGCACTCGGTTGGGAAGAGTTTTCTTATCCGGCAACGTTACAAACTTTATTAGACAGTAATTCAGAACAGATTGTGATGAAACCTAATAAAGTGACTGCTATTTCAAAGGAACCTTCAGTTAAGATGTACCATAAAACTGGCTCAACTACCGGTTTCGGAACATATGTGGTGTTTATTCCTAAAGAAAATATTGGTTTAGTCATGTTAACCAATAAACGTATTCC
516	gb|KJ780076.1|+|0-825|ARO:3001587|OXA-401	ATGAACATTAAAGCCCTCTTACTTATAACAAGCGCTATTTTTATTTCAGCCTGC...TAG	825.0	54149	54919	770	825	ATGAACATTAAAGCACTCTTACTTATAACAAGCGCTATTTTTATTTCAGCCTGCTCACCTTATATAGTGACTGCTAATCCAAATCACAGCGCTTCAAAATCTGATGTAAAAGCAGAGAAAATTAAAAATTTATTTAACGAAGCACACACTACGGGTGTTTTAGTTATCCAACAAGGCCAAACTCAACAAAGCTATGGTAATGATCTTGCTCGTGCTTCGACCGAGTATGTACCTGCTTCGACCTTCAAAATGCTTAATGCTTTGATCGGCCTTGAGCACCATAAGGCAACCACCACAGAAGTATTTAAGTGGGATGGTAAAAAAAGGTTATTCCCAGAATGGGAAAAGGACATGACCCTAGGCGATGCCATGAAAGCTTCCGCTATTCCAGTTTATCAAGATTTAGCTCGTCGTATTGGACTTGAGCTCATGTCTAAGGAAGTGAAGCGTGTTGGTTATGGCAATGCAGATATCGGTACCCAAGTCGATAATTTTTGGCTGGTGGGTCCTTTAAAAATTACTCCTCAGCAAGAGGCACAGTTTGCTTACAAGCTAGCTAATAAAACGCTTCCATTTAGCCAAAAAGTCCAAGATGAAGTGCAATCCATGCTATTCATAGAAGAAAAGAATGGAAACAAAATATACGCAAAAAGTGGTTGGGGATGGGATGTAAACCCACAAGTAGGCTGGTTAACTGGATGGGTTGTTCAGCCTCAAGGGAATATTGTAGCGTTCTCCCTTAACTTAGAAATGAAAAAAGGAATACCTAG
517	gb|AJ222769.3|+|3686-5606|ARO:3000194|tetW	ATGAAAATAATCAATATTGGAATTCTTGCCCATGTAGACGCTGGAAAGACGACC...TAA	1920.0	745	2610	1865	1920	ATGAAAATAATCAATATTGGAATTCTTGCCCATGTAGACGCTGGAAAGACGACCTTGACGGAGAGCCTGCTATATGCCAGCGGAGCCATTTCAGAACCGGGGAGCGTCGAAAAAGGGACAACGAGGACGGACACCATGTTTTTGGAGCGGCAGCGTGGGATTACCATTCAAGCGGCAGTCACTTCCTTCCAGTGGCACAGATGTAAAGTCAACATTGTGGATACGCCCGGCCACATGGATTTTTTGGCGGAGGTGTACCGCTCTTTGGCTGTTTTAGATGGGGCCATCTTGGTGATCTCCGCTAAAGATGGCGTGCAGGCCCAGACCCGTATTCTGTTCCATGCCCTGCGGAAAATGAACATTCCCACCGTTATCTTTATCAACAAGATCGACCAGGCTGGCGTTGATTTGCAGAGCGTGGTTCAGTCTGTTCGGGATAAGCTCTCCGCCGATATTATCATCAAGCAGACGGTGTCGCTGTCCCCGGAAATAGTCCTGGAGGAAAATACCGACATAGAAGCATGGGATGCGGTCATCGAAAATAACGATAAATTATTGGAAAAGTATATCGCAGGAGAACCAATCAGCCGGGAAAAACTTGTGCGGGAGGAACAGCGGCGGGTTCAAGACGCCTCCCTGTTCCCGGTCTATTATGGCAGCGCCAAAAAGGGCCTTGGCATTCAACCGTTGATGGATGCGGTGACAGGGCTGTTCCAACCGATTGGGGAACAGGGGAGCGCCGCCCTATGCGGCAGCGTTTTCAAGGTGGAGTATACAGATTGCGGCCAGCGGCGTGTCTATCTACGGCTATACAGCGGAACGCTGCGCCTGCGGGATACGGTGGCCCTGGCCGGGAGAGAAAAGCTGAAAATCACAGAGATGCGTATTCCATCCAAAGGGGAAATTGTTCGGACAGACACCGCTTATCCGGGTGAAATTGTTATCCTTCCCAGCGACAGCGTGAGGTTAAACGATGTATTAGGGGACCCAACCCGGCTCCCTCGTAAAAGGTGGCGTGAGGACCCCCTCCCCATGCTGCGGACGTCGATTGCGCCGAAAACGGCAGCGCAAAGAGAACGGCTGCTGGACGCTCTTACGCAACTTGCGGATACTGACCCGCTTTTGCGCTGCGAGGTGGATTCCATCACCCATGAGATCATTCTTTCTTTTTTGGGCCGGGTGCAGTTGGAGGTTGTTTCCGCTTTGCTGTCGGAAAAATACAAGCTTGAAACAGTGGTAAAGGAACCCACCGTCATTTATATGGAGCGGCCGCTCAAAGCAGCCAGCCACACCATCCATATCGAGGTGCCGCCCAACCCGTTTTGGGCATCCATCGGACTGTCTGTTACACCACTCCCGCTTGGCTCCGGTGTACAATACGAGAGCCGGGTTTCGCTGGGATACTTGAACCAGAGTTTTCAAAACGCTGTCAGGGATGGTATCCGTTACGGGCTGGAGCAGGGCTTGTTCGGCTGGAACGTAACGGACTGTAAGATTTGCTTTGAATACGGGCTTTATTACAGTCCGGTCAGCACGCCGGCGGACTTCCGCTCATTGGCCCCGATTGTATTGGAACAGGCATTGAAGGAATCAGGGACGCAACTGCTGGAACCTTATCTCTCCTTCACCCTCTATGCGCCCCGGGAATATCTTTCCAGGGCTTATCATGATGCACCGAAATACTGTGCCACCATCGAAACGGTCCAGGTAAAAAAGGATGAAGTTGTCTTTACTGGCGAGATTCCCGCCCGCTGTATACAGGCATACCGTACTGATCTGGCCTTTTACACCAACGGGCAGAGCGTATGCCTTACAGAACTGAAAGGGTATCAGGCCGCTGTCGGCAAGCCAGTCATCCAGCCCCG
518	gb|AM049399|+|0-861|ARO:3001007|TEM-144	ATGAGTATTCAACATTTTCGTGTCGCCCTTATTCCCTTTTTTGCGGCATTTTGC...TAA	861.0	46	852	806	861	ATGAGTATTCAACATTTCCGTGTCGCCCTTATTCCCTTTTTTGCGGCATTTTGCCTTCCTGTTTTTGCTCACCCAGAAACGCTGGTGAAAGTAAAAGATGCTGAAGATCAGTTGGGTGCACGAGTGGGTTACATCGAGCTGGATCTCAACAGCGGTAAGATCCTTGAGAGTTTTCGCCCCGAAGAACGTTTTCCAATGATGAGCACTTTTAAAGTTCTGCTATGTGGTGCGGTATTATCCCGTGTTGACGCCGGGCAAGAGCAACTCGGTCGCCGCATACACTATTCTCAGAATGACTTGGTTGAGTACTCACCAGTCACAGAAAAGCATCTTACGGATGGCATGACAGTAAGAGAATTATGCAGTGCTGCCATAACCATGAGTGATAACACTGCGGCCAACTTACTTCTGACAACGATCGGAGGACCGAAGGAGCTAACCGCTTTTTTGCACAACATGGGGGATCATGTAACCCGCCTTGATCGTTGGGAACCGGAGCTGAATGAAGCCATACCAAACGACGAGCGTGACACCACGATGCCTGCAGCAATGGCAACAACGTTGCGCAAACTATTAACTGGCGAACTACTTACTCTAGCTTCCCGGCAACAATTAATAGACTGGATGGAGGCGGATAAAGTTGCAGGACCACTTCTGCGCTCGGCCCTTCCGGCTGGCTGGTTTATTGCTGATAAATCTGGAGCCGGTGAGCGTGGATCTCGCGGTATCATTGCAGCACTGGGGCCAGATGGTAAGCCCTCCCGTATCGTAGTTATCTACACGACGGGGAGTCAGGCAACTATGGA
519	gb|AY139603|+|106-898|ARO:3002608|aadA8	ATGAGGGTAGCGGTGACCATCGAAATTTCGAACCAACTATCAGAGGTGCTAAGC...TAA	792.0	0,10	267,747	267;737	792	GTGACCATCGAAATTTCGAACCAACTATCAGAGGTGCTAAGCGTCATTGAGCGCCATCTGGAATCAACGTTGCTGGCCGTGCATTTGTACGGCTCCGCAGTGGATGGCGGCCTGAAGCCATACAGCGATATTGATTTGTTGGTTACTGTGGCCGTAAAGCTTGATGAAACGACGCGGCGAGCATTGCTCAATGACCTTATGGAGGCTTCGGCTTTCCCTGGCGAGAGCGAGACGCTCCGCGCTATAGAAGTCACCCTTGTCGTGCAT;ATGAGGGAAGCGGTGATCGCCGAAGTATCGACTCAACTATCAGAGGTAGTTGGCGTCATCGAGCGCCATCTCGAACCGACGTTGCTGGCCGTACATTTGTACGGCTCCGCAGTGGATGGCGGCCTGAAGCCACACAGTGATATTGATTTGCTGGTTACGGTGACCGTAAGGCTTGATGAAACAACGCGGCGAGCTTTGATCAACGACCTTTTGGAAACTTCGGCTTCCCCTGGAGAGAGCGAGATTCTCCGCGCTGTAGAAGTCACCATTGTTGTGCACGACGACATCATTCCGTGGCGTTATCCAGCTAAGCGCGAACTGCAATTTGGAGAATGGCAGCGCAATGACATTCTTGCAGGTATCTTCGAGCCAGCCACGATCGACATTGATCTGGCTATCTTGCTGACAAAAGCAAGAGAACATAGCGTTGCCTTGGTAGGTCCAGCGGCGGAGGAACTCTTTGATCCGGTTCCTGAACAGGATCTATTTGAGGCGCTAAATGAAACCTTAACGCTATGGAACTCGCCGCCCGACTGGGCTGGCGATGAGCGAAATGTAGTGCTTACGTTGTCCCGCATTTGGTACAGCGCAGTAACCGGCAAAATCGCGCCGAAGGATGTCGCTGCCGACTGGGCAATGGAGCGCCTGCCGGCCCAGTATCAGCCCGTCATACTTGAAGCTAGACAGGCTTATCTTGGACAAGAAGAAGATCGCTTGGCCTCGCGCGCAGATCAGTT
520	gb|KR057760.1|+|0-1104|ARO:3004354|PDC-91	GATGAGGCCCCGGCGGATCGCCTGAAGGCACTGGTCGACGCCGCCGTACAACCG...TGA	1104.0	35591	36652	1061	1104	GATGAGGCCCCGGCGGATCGCCTGAAGGCACTGGTCGACGCCGCCGTACAACCGGTGATGAAGGCCAATGACATTCCGGGCCTGGCCGTAGCCATCAGCCTGAAAGGAGAACCGCATTACTTCAGCTATGGGCTGGCCTCGAAAGAGGACGGCCGCCGGGTGACGCCGGAGACCCTGTTCGAGATCGGCTCGGTGAGCAAGACCTTCACCGTCACCCTCGCCGGCTATGCCCTGGCCCAGGACAAGATGCGCCTCGACGACCGCGCCAGCCAGCACTGGCCGGCACTGCAGGGCAGCCGCTTCGACGGCATCAGCCTGCTCGACCTCGCGACCTATACCGCCGGCGGCTTGCCGCTGCAGTTCCCCGACTCGGTGCAGAAGGACCAGGCACAGATCCGCGACTACTACCGCCAGTGGCAGCCGACCTACGCGCCGGGCAGCCAGCGCCTCTATTCCAACCCGAGCATCGGCCTGTTCGGCTATCTCGCCGCGCGCAGCCTGGGCCAGCCGTTCGAACGGCTCATGGAGCAGCAATTGTTCCCGGCACTGGGCCTCGAACAGACCCACCTCGACGTGCCCGAGGCGGCGCTGGCGCAGTACGCCCAGGGCTACGGCAAGGACGACCGCCCGCTACGGGTCGGTCCCGGCCCGCTGGATGCCGAAGGCTACGGGGTGAAGACCAGCGCGGCCGACCTGCTGCGCTTCGTCGATGCCAACCTGCATCCGGAGCGCCTGGACAGGCCCTGGGCGCAGGCGCTCGATGCCACCCATCGCGGTTACTACAAGGTCGGCGACATGACCCAGGGCCTGGGCTGGGAAGCCTACGACTGGCCGATCTCCCTGAAGCGCCTGCAGGCCGGCAACTCGACGCCGATGGCGCTGCAACCACACAGGATCGCCAGGCTGCCCGCGCCACAGGCGCTGGAGGGCCAGCGCCTGCTGAACAAGACCGGCTCCACCAACGGCTTCGGCGCCTACGTGGCGTTCGTCCCGGGCCGCGACCTGGGCCTGGTGATCCTGGCCAACCGCAACTATCCCAATGCCGAGCGGGTGAAGATCGC
521	gb|JN254627|+|0-861|ARO:3001049|TEM-189	ATGAGTATTCAACATTTCCGTGTCGCCCTTATTCCCTTTTTTGCGGCATTTTGC...TAA	861.0	46	852	806	861	ATGAGTATTCAACATTTCCGTGTCGCCCTTATTCCCTTTTTTGCGGCATTTTGCCTTCCTGTTTTTGCTCACCCAGAAACGCTGGTGAAAGTAAAAGATGCTGAAGATCAGTTGGGTGCACGAGTGGGTTACATCGAGCTGGATCTCAACAGCGGTAAGATCCTTGAGAGTTTTCGCCCCGAAGAACGTTTTCCAATGATGAGCACTTTTAAAGTTCTGCTATGTGGTGCGGTATTATCCCGTGTTGACGCCGGGCAAGAGCAACTCGGTCGCCGCATACACTATTCTCAGAATGACTTGGTTGAGTACTCACCAGTCACAGAAAAGCATCTTACGGATGGCATGACAGTAAGAGAATTATGCAGTGCTGCCATAACCATGAGTGATAACACTGCGGCCAACTTACTTCTGACAACGATCGGAGGACCGAAGGAGCTAACCGCTTTTTTGCACAACATGGGGGATCATGTAACCCGCCTTGATCGTTGGGAACCGGAGCTGAATGAAGCCATACCAAACGACGAGCGTGACACCACGATGCCTGCAGCAATGGCAACAACGTTGCGCAAACTATTAACTGGCGAACTACTTACTCTAGCTTCCCGGCAACAATTAATAGACTGGATGGAGGCGGATAAAGTTGCAGGACCACTTCTGCGCTCGGCCCTTCCGGCTGGCTGGTTTATTGCTGATAAATCTGGAGCCGGTGAGCGTGGATCTCGCGGTATCATTGCAGCACTGGGGCCAGATGGTAAGCCCTCCCGTATCGTAGTTATCTACACGACGGGGAGTCAGGCAACTATGGA
522	gb|X57972|+|339-1200|ARO:3000878|TEM-6	ATGAGTATTCAACATTTCCGTGTCGCCCTTATTCCCTTTTTTGCGGCATTTTGC...TAA	861.0	46	852	806	861	ATGAGTATTCAACATTTCCGTGTCGCCCTTATTCCCTTTTTTGCGGCATTTTGCCTTCCTGTTTTTGCTCACCCAGAAACGCTGGTGAAAGTAAAAGATGCTGAAGATCAGTTGGGTGCACGAGTGGGTTACATCGAGCTGGATCTCAACAGCGGTAAGATCCTTGAGAGTTTTCGCCCCGAAGAACGTTTTCCAATGATGAGCACTTTTAAAGTTCTGCTATGTGGTGCGGTATTATCCCGTGTTGACGCCGGGCAAGAGCAACTCGGTCGCCGCATACACTATTCTCAGAATGACTTGGTTGAGTACTCACCAGTCACAGAAAAGCATCTTACGGATGGCATGACAGTAAGAGAATTATGCAGTGCTGCCATAACCATGAGTGATAACACTGCGGCCAACTTACTTCTGACAACGATCGGAGGACCGAAGGAGCTAACCGCTTTTTTGCACAACATGGGGGATCATGTAACCCGCCTTGATCGTTGGGAACCGGAGCTGAATGAAGCCATACCAAACGACGAGCGTGACACCACGATGCCTGCAGCAATGGCAACAACGTTGCGCAAACTATTAACTGGCGAACTACTTACTCTAGCTTCCCGGCAACAATTAATAGACTGGATGGAGGCGGATAAAGTTGCAGGACCACTTCTGCGCTCGGCCCTTCCGGCTGGCTGGTTTATTGCTGATAAATCTGGAGCCGGTGAGCGTGGATCTCGCGGTATCATTGCAGCACTGGGGCCAGATGGTAAGCCCTCCCGTATCGTAGTTATCTACACGACGGGGAGTCAGGCAACTATGGA
523	gb|JX042489|+|141-1002|ARO:3000890|TEM-19	ATGAGTATTCAACATTTCCGTGTCGCCCTTATTCCCTTTTTTGCGGCATTTTGC...TAA	861.0	46	852	806	861	ATGAGTATTCAACATTTCCGTGTCGCCCTTATTCCCTTTTTTGCGGCATTTTGCCTTCCTGTTTTTGCTCACCCAGAAACGCTGGTGAAAGTAAAAGATGCTGAAGATCAGTTGGGTGCACGAGTGGGTTACATCGAGCTGGATCTCAACAGCGGTAAGATCCTTGAGAGTTTTCGCCCCGAAGAACGTTTTCCAATGATGAGCACTTTTAAAGTTCTGCTATGTGGTGCGGTATTATCCCGTGTTGACGCCGGGCAAGAGCAACTCGGTCGCCGCATACACTATTCTCAGAATGACTTGGTTGAGTACTCACCAGTCACAGAAAAGCATCTTACGGATGGCATGACAGTAAGAGAATTATGCAGTGCTGCCATAACCATGAGTGATAACACTGCGGCCAACTTACTTCTGACAACGATCGGAGGACCGAAGGAGCTAACCGCTTTTTTGCACAACATGGGGGATCATGTAACCCGCCTTGATCGTTGGGAACCGGAGCTGAATGAAGCCATACCAAACGACGAGCGTGACACCACGATGCCTGCAGCAATGGCAACAACGTTGCGCAAACTATTAACTGGCGAACTACTTACTCTAGCTTCCCGGCAACAATTAATAGACTGGATGGAGGCGGATAAAGTTGCAGGACCACTTCTGCGCTCGGCCCTTCCGGCTGGCTGGTTTATTGCTGATAAATCTGGAGCCGGTGAGCGTGGATCTCGCGGTATCATTGCAGCACTGGGGCCAGATGGTAAGCCCTCCCGTATCGTAGTTATCTACACGACGGGGAGTCAGGCAACTATGGA
524	gb|AF047171|+|135-996|ARO:3000929|TEM-60	ATGAGTATTCAACATTTCCGTGTCGCCCTTATTCCCTTTTTTGCGGCATTTTGC...TAA	861.0	46	852	806	861	ATGAGTATTCAACATTTCCGTGTCGCCCTTATTCCCTTTTTTGCGGCATTTTGCCTTCCTGTTTTTGCTCACCCAGAAACGCTGGTGAAAGTAAAAGATGCTGAAGATCAGTTGGGTGCACGAGTGGGTTACATCGAGCTGGATCTCAACAGCGGTAAGATCCTTGAGAGTTTTCGCCCCGAAGAACGTTTTCCAATGATGAGCACTTTTAAAGTTCTGCTATGTGGTGCGGTATTATCCCGTGTTGACGCCGGGCAAGAGCAACTCGGTCGCCGCATACACTATTCTCAGAATGACTTGGTTGAGTACTCACCAGTCACAGAAAAGCATCTTACGGATGGCATGACAGTAAGAGAATTATGCAGTGCTGCCATAACCATGAGTGATAACACTGCGGCCAACTTACTTCTGACAACGATCGGAGGACCGAAGGAGCTAACCGCTTTTTTGCACAACATGGGGGATCATGTAACCCGCCTTGATCGTTGGGAACCGGAGCTGAATGAAGCCATACCAAACGACGAGCGTGACACCACGATGCCTGCAGCAATGGCAACAACGTTGCGCAAACTATTAACTGGCGAACTACTTACTCTAGCTTCCCGGCAACAATTAATAGACTGGATGGAGGCGGATAAAGTTGCAGGACCACTTCTGCGCTCGGCCCTTCCGGCTGGCTGGTTTATTGCTGATAAATCTGGAGCCGGTGAGCGTGGATCTCGCGGTATCATTGCAGCACTGGGGCCAGATGGTAAGCCCTCCCGTATCGTAGTTATCTACACGACGGGGAGTCAGGCAACTATGGA
525	gb|AM040708.1|+|1173-1965|ARO:3004704|aadA8b	ATGAGGGAAGCGGTGACCATCGAAATTTCGAACCAACTATCAGAGGTGCTAAGC...TAA	792.0	0,10	267,747	267;737	792	GTGACCATCGAAATTTCGAACCAACTATCAGAGGTGCTAAGCGTCATTGAGCGCCATCTGGAATCAACGTTGCTGGCCGTGCATTTGTACGGCTCCGCAGTGGATGGCGGCCTGAAGCCATACAGCGATATTGATTTGTTGGTTACTGTGGCCGTAAAGCTTGATGAAACGACGCGGCGAGCATTGCTCAATGACCTTATGGAGGCTTCGGCTTTCCCTGGCGAGAGCGAGACGCTCCGCGCTATAGAAGTCACCCTTGTCGTGCAT;ATGAGGGAAGCGGTGATCGCCGAAGTATCGACTCAACTATCAGAGGTAGTTGGCGTCATCGAGCGCCATCTCGAACCGACGTTGCTGGCCGTACATTTGTACGGCTCCGCAGTGGATGGCGGCCTGAAGCCACACAGTGATATTGATTTGCTGGTTACGGTGACCGTAAGGCTTGATGAAACAACGCGGCGAGCTTTGATCAACGACCTTTTGGAAACTTCGGCTTCCCCTGGAGAGAGCGAGATTCTCCGCGCTGTAGAAGTCACCATTGTTGTGCACGACGACATCATTCCGTGGCGTTATCCAGCTAAGCGCGAACTGCAATTTGGAGAATGGCAGCGCAATGACATTCTTGCAGGTATCTTCGAGCCAGCCACGATCGACATTGATCTGGCTATCTTGCTGACAAAAGCAAGAGAACATAGCGTTGCCTTGGTAGGTCCAGCGGCGGAGGAACTCTTTGATCCGGTTCCTGAACAGGATCTATTTGAGGCGCTAAATGAAACCTTAACGCTATGGAACTCGCCGCCCGACTGGGCTGGCGATGAGCGAAATGTAGTGCTTACGTTGTCCCGCATTTGGTACAGCGCAGTAACCGGCAAAATCGCGCCGAAGGATGTCGCTGCCGACTGGGCAATGGAGCGCCTGCCGGCCCAGTATCAGCCCGTCATACTTGAAGCTAGACAGGCTTATCTTGGACAAGAAGAAGATCGCTTGGCCTCGCGCGCAGATCAGTT
526	gb|DQ105528|+|0-861|ARO:3001012|TEM-145	ATGAGTATTCAACATTTCCGTGTCGCCCTTATTCCCTTTTTTGCGGCATTTTGC...TAA	861.0	46	852	806	861	ATGAGTATTCAACATTTCCGTGTCGCCCTTATTCCCTTTTTTGCGGCATTTTGCCTTCCTGTTTTTGCTCACCCAGAAACGCTGGTGAAAGTAAAAGATGCTGAAGATCAGTTGGGTGCACGAGTGGGTTACATCGAGCTGGATCTCAACAGCGGTAAGATCCTTGAGAGTTTTCGCCCCGAAGAACGTTTTCCAATGATGAGCACTTTTAAAGTTCTGCTATGTGGTGCGGTATTATCCCGTGTTGACGCCGGGCAAGAGCAACTCGGTCGCCGCATACACTATTCTCAGAATGACTTGGTTGAGTACTCACCAGTCACAGAAAAGCATCTTACGGATGGCATGACAGTAAGAGAATTATGCAGTGCTGCCATAACCATGAGTGATAACACTGCGGCCAACTTACTTCTGACAACGATCGGAGGACCGAAGGAGCTAACCGCTTTTTTGCACAACATGGGGGATCATGTAACCCGCCTTGATCGTTGGGAACCGGAGCTGAATGAAGCCATACCAAACGACGAGCGTGACACCACGATGCCTGCAGCAATGGCAACAACGTTGCGCAAACTATTAACTGGCGAACTACTTACTCTAGCTTCCCGGCAACAATTAATAGACTGGATGGAGGCGGATAAAGTTGCAGGACCACTTCTGCGCTCGGCCCTTCCGGCTGGCTGGTTTATTGCTGATAAATCTGGAGCCGGTGAGCGTGGATCTCGCGGTATCATTGCAGCACTGGGGCCAGATGGTAAGCCCTCCCGTATCGTAGTTATCTACACGACGGGGAGTCAGGCAACTATGGA
527	gb|AF332513|+|103-964|ARO:3000931|TEM-63	ATGAGTATTCAACATTTCCGTGTCGCCCTTATTCCCTTTTTTGCGGCATTTTGC...TAA	861.0	46	852	806	861	ATGAGTATTCAACATTTCCGTGTCGCCCTTATTCCCTTTTTTGCGGCATTTTGCCTTCCTGTTTTTGCTCACCCAGAAACGCTGGTGAAAGTAAAAGATGCTGAAGATCAGTTGGGTGCACGAGTGGGTTACATCGAGCTGGATCTCAACAGCGGTAAGATCCTTGAGAGTTTTCGCCCCGAAGAACGTTTTCCAATGATGAGCACTTTTAAAGTTCTGCTATGTGGTGCGGTATTATCCCGTGTTGACGCCGGGCAAGAGCAACTCGGTCGCCGCATACACTATTCTCAGAATGACTTGGTTGAGTACTCACCAGTCACAGAAAAGCATCTTACGGATGGCATGACAGTAAGAGAATTATGCAGTGCTGCCATAACCATGAGTGATAACACTGCGGCCAACTTACTTCTGACAACGATCGGAGGACCGAAGGAGCTAACCGCTTTTTTGCACAACATGGGGGATCATGTAACCCGCCTTGATCGTTGGGAACCGGAGCTGAATGAAGCCATACCAAACGACGAGCGTGACACCACGATGCCTGCAGCAATGGCAACAACGTTGCGCAAACTATTAACTGGCGAACTACTTACTCTAGCTTCCCGGCAACAATTAATAGACTGGATGGAGGCGGATAAAGTTGCAGGACCACTTCTGCGCTCGGCCCTTCCGGCTGGCTGGTTTATTGCTGATAAATCTGGAGCCGGTGAGCGTGGATCTCGCGGTATCATTGCAGCACTGGGGCCAGATGGTAAGCCCTCCCGTATCGTAGTTATCTACACGACGGGGAGTCAGGCAACTATGGA
528	gb|KR057761.1|+|0-1110|ARO:3004355|PDC-92	GATGAGGCCCCGGCGGATCGCCTGAAGGCACTGGTCGACGCCGCCGTACAACCG...TGA	1110.0	35591	36652	1061	1110	GATGAGGCCCCGGCGGATCGCCTGAAGGCACTGGTCGACGCCGCCGTACAACCGGTGATGAAGGCCAATGACATTCCGGGCCTGGCCGTAGCCATCAGCCTGAAAGGAGAACCGCATTACTTCAGCTATGGGCTGGCCTCGAAAGAGGACGGCCGCCGGGTGACGCCGGAGACCCTGTTCGAGATCGGCTCGGTGAGCAAGACCTTCACCGTCACCCTCGCCGGCTATGCCCTGGCCCAGGACAAGATGCGCCTCGACGACCGCGCCAGCCAGCACTGGCCGGCACTGCAGGGCAGCCGCTTCGACGGCATCAGCCTGCTCGACCTCGCGACCTATACCGCCGGCGGCTTGCCGCTGCAGTTCCCCGACTCGGTGCAGAAGGACCAGGCACAGATCCGCGACTACTACCGCCAGTGGCAGCCGACCTACGCGCCGGGCAGCCAGCGCCTCTATTCCAACCCGAGCATCGGCCTGTTCGGCTATCTCGCCGCGCGCAGCCTGGGCCAGCCGTTCGAACGGCTCATGGAGCAGCAATTGTTCCCGGCACTGGGCCTCGAACAGACCCACCTCGACGTGCCCGAGGCGGCGCTGGCGCAGTACGCCCAGGGCTACGGCAAGGACGACCGCCCGCTACGGGTCGGTCCCGGCCCGCTGGATGCCGAAGGCTACGGGGTGAAGACCAGCGCGGCCGACCTGCTGCGCTTCGTCGATGCCAACCTGCATCCGGAGCGCCTGGACAGGCCCTGGGCGCAGGCGCTCGATGCCACCCATCGCGGTTACTACAAGGTCGGCGACATGACCCAGGGCCTGGGCTGGGAAGCCTACGACTGGCCGATCTCCCTGAAGCGCCTGCAGGCCGGCAACTCGACGCCGATGGCGCTGCAACCACACAGGATCGCCAGGCTGCCCGCGCCACAGGCGCTGGAGGGCCAGCGCCTGCTGAACAAGACCGGCTCCACCAACGGCTTCGGCGCCTACGTGGCGTTCGTCCCGGGCCGCGACCTGGGCCTGGTGATCCTGGCCAACCGCAACTATCCCAATGCCGAGCGGGTGAAGATCGC
529	gb|KJ780077.1|+|0-825|ARO:3001588|OXA-402	ATGAACATTAAAGCACTCTTACTTATAACAAGCGCTATTTTTATTTCAGCCTGC...TAG	825.0	54149	54919	770	825	ATGAACATTAAAGCACTCTTACTTATAACAAGCGCTATTTTTATTTCAGCCTGCTCACCTTATATAGTGACTGCTAATCCAAATCACAGCGCTTCAAAATCTGATGTAAAAGCAGAGAAAATTAAAAATTTATTTAACGAAGCACACACTACGGGTGTTTTAGTTATCCAACAAGGCCAAACTCAACAAAGCTATGGTAATGATCTTGCTCGTGCTTCGACCGAGTATGTACCTGCTTCGACCTTCAAAATGCTTAATGCTTTGATCGGCCTTGAGCACCATAAGGCAACCACCACAGAAGTATTTAAGTGGGATGGTAAAAAAAGGTTATTCCCAGAATGGGAAAAGGACATGACCCTAGGCGATGCCATGAAAGCTTCCGCTATTCCAGTTTATCAAGATTTAGCTCGTCGTATTGGACTTGAGCTCATGTCTAAGGAAGTGAAGCGTGTTGGTTATGGCAATGCAGATATCGGTACCCAAGTCGATAATTTTTGGCTGGTGGGTCCTTTAAAAATTACTCCTCAGCAAGAGGCACAGTTTGCTTACAAGCTAGCTAATAAAACGCTTCCATTTAGCCAAAAAGTCCAAGATGAAGTGCAATCCATGCTATTCATAGAAGAAAAGAATGGAAACAAAATATACGCAAAAAGTGGTTGGGGATGGGATGTAAACCCACAAGTAGGCTGGTTAACTGGATGGGTTGTTCAGCCTCAAGGGAATATTGTAGCGTTCTCCCTTAACTTAGAAATGAAAAAAGGAATACCTAG
530	gb|JN416112|+|0-861|ARO:3001050|TEM-190	ATGAGTATTCAACATTTCCGTGTCGCCCTTATTCCCTTTTTTGCGGCATTTTGC...TAA	861.0	46	852	806	861	ATGAGTATTCAACATTTCCGTGTCGCCCTTATTCCCTTTTTTGCGGCATTTTGCCTTCCTGTTTTTGCTCACCCAGAAACGCTGGTGAAAGTAAAAGATGCTGAAGATCAGTTGGGTGCACGAGTGGGTTACATCGAGCTGGATCTCAACAGCGGTAAGATCCTTGAGAGTTTTCGCCCCGAAGAACGTTTTCCAATGATGAGCACTTTTAAAGTTCTGCTATGTGGTGCGGTATTATCCCGTGTTGACGCCGGGCAAGAGCAACTCGGTCGCCGCATACACTATTCTCAGAATGACTTGGTTGAGTACTCACCAGTCACAGAAAAGCATCTTACGGATGGCATGACAGTAAGAGAATTATGCAGTGCTGCCATAACCATGAGTGATAACACTGCGGCCAACTTACTTCTGACAACGATCGGAGGACCGAAGGAGCTAACCGCTTTTTTGCACAACATGGGGGATCATGTAACCCGCCTTGATCGTTGGGAACCGGAGCTGAATGAAGCCATACCAAACGACGAGCGTGACACCACGATGCCTGCAGCAATGGCAACAACGTTGCGCAAACTATTAACTGGCGAACTACTTACTCTAGCTTCCCGGCAACAATTAATAGACTGGATGGAGGCGGATAAAGTTGCAGGACCACTTCTGCGCTCGGCCCTTCCGGCTGGCTGGTTTATTGCTGATAAATCTGGAGCCGGTGAGCGTGGATCTCGCGGTATCATTGCAGCACTGGGGCCAGATGGTAAGCCCTCCCGTATCGTAGTTATCTACACGACGGGGAGTCAGGCAACTATGGA
531	gb|AF091113|+|450-1311|ARO:3000934|TEM-67	ATGAGTATTCAACATTTCCGTGTCGCCCTTATTCCCTTTTTTGCGGCATTTTGC...TAA	861.0	46	852	806	861	ATGAGTATTCAACATTTCCGTGTCGCCCTTATTCCCTTTTTTGCGGCATTTTGCCTTCCTGTTTTTGCTCACCCAGAAACGCTGGTGAAAGTAAAAGATGCTGAAGATCAGTTGGGTGCACGAGTGGGTTACATCGAGCTGGATCTCAACAGCGGTAAGATCCTTGAGAGTTTTCGCCCCGAAGAACGTTTTCCAATGATGAGCACTTTTAAAGTTCTGCTATGTGGTGCGGTATTATCCCGTGTTGACGCCGGGCAAGAGCAACTCGGTCGCCGCATACACTATTCTCAGAATGACTTGGTTGAGTACTCACCAGTCACAGAAAAGCATCTTACGGATGGCATGACAGTAAGAGAATTATGCAGTGCTGCCATAACCATGAGTGATAACACTGCGGCCAACTTACTTCTGACAACGATCGGAGGACCGAAGGAGCTAACCGCTTTTTTGCACAACATGGGGGATCATGTAACCCGCCTTGATCGTTGGGAACCGGAGCTGAATGAAGCCATACCAAACGACGAGCGTGACACCACGATGCCTGCAGCAATGGCAACAACGTTGCGCAAACTATTAACTGGCGAACTACTTACTCTAGCTTCCCGGCAACAATTAATAGACTGGATGGAGGCGGATAAAGTTGCAGGACCACTTCTGCGCTCGGCCCTTCCGGCTGGCTGGTTTATTGCTGATAAATCTGGAGCCGGTGAGCGTGGATCTCGCGGTATCATTGCAGCACTGGGGCCAGATGGTAAGCCCTCCCGTATCGTAGTTATCTACACGACGGGGAGTCAGGCAACTATGGA
532	gb|AL009126|-|2735681-2736536|ARO:3002627|aadK	ATGCGAAGTGAGCAGGAAATGATGGACATTTTTTTGGACTTTGCTTTGAACGAT...TGA	855.0	2991	3789	798	855	ATGCGAAGTGAGCAGGAAATGATGGACATTTTTTTGGACTTTGCTTTGAACGATGAGAGAATCCGATTGGTCACTTTGGAAGGGTCGCGTACAAACAGAAATATCCCTCCTGACAACTTCCAAGATTATGACATCTCGTATTTTGTAACTGATGTAGATTCTTTTAAAGAAAATGATCAGTGGCTCGAAATCTTTGGGAAGCGCATTATGATGCAAAAACCAGAAGATATGGAGCTTTTTCCTCCCGAATTAGGTAATTGGTTTTCATACATTATTCTTTTTGAGTATGGCAACAAATTAGATCTAACCCTTATTCCAATTCGTGAAGCAGAAGACTATTTTGCTAATAACGATGGTTTGGTTAAGGTATTGCTTGATAAGGATTCGTTCATCAACTATAAAGTGACCCCAAATGATCACCAATACTGGATGAAAAAGCCGACTGCAAGGGAATTTGATGATTGCTGTAATGAGTTCTGGATGGTTTCGACTTACGTAGTAAAAGGATTAGCAAGAAATGAAATCCTTTTTGCCATTGACCATTTAAATGAAATTGTACGTCCTAATTTATTGAGAATGATGGCCTGGCATATCGCATCTCAGAAAGGGTATTCATTTAGTATGGGGAAGAACTATAAATTTATGAAGCGGTACCTTTCAAATAAAGAATGGGAGGAACTCATGTCTACATATTCTGTGAATGGGTATCAGGAAATGTGGAAGTCTTTATTTACTTGCTATGCATTATTTAGAAAGTATTCAAAAGCTGTATCAGAAAGTCTTGCATATCAGTATCCT
533	gb|KY432484.1|+|0-861|ARO:3001051|TEM-191	ATGAGTATTCAACATTTCCGTGTCGCCCTTATTCCCTTTTTTGCGGCATTTTGC...TAA	861.0	46	852	806	861	ATGAGTATTCAACATTTCCGTGTCGCCCTTATTCCCTTTTTTGCGGCATTTTGCCTTCCTGTTTTTGCTCACCCAGAAACGCTGGTGAAAGTAAAAGATGCTGAAGATCAGTTGGGTGCACGAGTGGGTTACATCGAGCTGGATCTCAACAGCGGTAAGATCCTTGAGAGTTTTCGCCCCGAAGAACGTTTTCCAATGATGAGCACTTTTAAAGTTCTGCTATGTGGTGCGGTATTATCCCGTGTTGACGCCGGGCAAGAGCAACTCGGTCGCCGCATACACTATTCTCAGAATGACTTGGTTGAGTACTCACCAGTCACAGAAAAGCATCTTACGGATGGCATGACAGTAAGAGAATTATGCAGTGCTGCCATAACCATGAGTGATAACACTGCGGCCAACTTACTTCTGACAACGATCGGAGGACCGAAGGAGCTAACCGCTTTTTTGCACAACATGGGGGATCATGTAACCCGCCTTGATCGTTGGGAACCGGAGCTGAATGAAGCCATACCAAACGACGAGCGTGACACCACGATGCCTGCAGCAATGGCAACAACGTTGCGCAAACTATTAACTGGCGAACTACTTACTCTAGCTTCCCGGCAACAATTAATAGACTGGATGGAGGCGGATAAAGTTGCAGGACCACTTCTGCGCTCGGCCCTTCCGGCTGGCTGGTTTATTGCTGATAAATCTGGAGCCGGTGAGCGTGGATCTCGCGGTATCATTGCAGCACTGGGGCCAGATGGTAAGCCCTCCCGTATCGTAGTTATCTACACGACGGGGAGTCAGGCAACTATGGA
534	gb|AJ239002|+|0-861|ARO:3000935|TEM-68	ATGAGTATTCAACATTTTCGTGTCGCCCTTATTCCCTTTTTTGCGGCATTTTGC...TAA	861.0	46	852	806	861	ATGAGTATTCAACATTTCCGTGTCGCCCTTATTCCCTTTTTTGCGGCATTTTGCCTTCCTGTTTTTGCTCACCCAGAAACGCTGGTGAAAGTAAAAGATGCTGAAGATCAGTTGGGTGCACGAGTGGGTTACATCGAGCTGGATCTCAACAGCGGTAAGATCCTTGAGAGTTTTCGCCCCGAAGAACGTTTTCCAATGATGAGCACTTTTAAAGTTCTGCTATGTGGTGCGGTATTATCCCGTGTTGACGCCGGGCAAGAGCAACTCGGTCGCCGCATACACTATTCTCAGAATGACTTGGTTGAGTACTCACCAGTCACAGAAAAGCATCTTACGGATGGCATGACAGTAAGAGAATTATGCAGTGCTGCCATAACCATGAGTGATAACACTGCGGCCAACTTACTTCTGACAACGATCGGAGGACCGAAGGAGCTAACCGCTTTTTTGCACAACATGGGGGATCATGTAACCCGCCTTGATCGTTGGGAACCGGAGCTGAATGAAGCCATACCAAACGACGAGCGTGACACCACGATGCCTGCAGCAATGGCAACAACGTTGCGCAAACTATTAACTGGCGAACTACTTACTCTAGCTTCCCGGCAACAATTAATAGACTGGATGGAGGCGGATAAAGTTGCAGGACCACTTCTGCGCTCGGCCCTTCCGGCTGGCTGGTTTATTGCTGATAAATCTGGAGCCGGTGAGCGTGGATCTCGCGGTATCATTGCAGCACTGGGGCCAGATGGTAAGCCCTCCCGTATCGTAGTTATCTACACGACGGGGAGTCAGGCAACTATGGA
535	gb|DQ105529|+|0-861|ARO:3001013|TEM-146	ATGAGTATTCAACATTTCCGTGTCGCCCTTATTCCCTTTTTTGCGGCATTTTGC...TAA	861.0	46	852	806	861	ATGAGTATTCAACATTTCCGTGTCGCCCTTATTCCCTTTTTTGCGGCATTTTGCCTTCCTGTTTTTGCTCACCCAGAAACGCTGGTGAAAGTAAAAGATGCTGAAGATCAGTTGGGTGCACGAGTGGGTTACATCGAGCTGGATCTCAACAGCGGTAAGATCCTTGAGAGTTTTCGCCCCGAAGAACGTTTTCCAATGATGAGCACTTTTAAAGTTCTGCTATGTGGTGCGGTATTATCCCGTGTTGACGCCGGGCAAGAGCAACTCGGTCGCCGCATACACTATTCTCAGAATGACTTGGTTGAGTACTCACCAGTCACAGAAAAGCATCTTACGGATGGCATGACAGTAAGAGAATTATGCAGTGCTGCCATAACCATGAGTGATAACACTGCGGCCAACTTACTTCTGACAACGATCGGAGGACCGAAGGAGCTAACCGCTTTTTTGCACAACATGGGGGATCATGTAACCCGCCTTGATCGTTGGGAACCGGAGCTGAATGAAGCCATACCAAACGACGAGCGTGACACCACGATGCCTGCAGCAATGGCAACAACGTTGCGCAAACTATTAACTGGCGAACTACTTACTCTAGCTTCCCGGCAACAATTAATAGACTGGATGGAGGCGGATAAAGTTGCAGGACCACTTCTGCGCTCGGCCCTTCCGGCTGGCTGGTTTATTGCTGATAAATCTGGAGCCGGTGAGCGTGGATCTCGCGGTATCATTGCAGCACTGGGGCCAGATGGTAAGCCCTCCCGTATCGTAGTTATCTACACGACGGGGAGTCAGGCAACTATGGA
536	gb|KP881241.1|+|0-1167|ARO:3003887|ADC-81	ATGCGATTTAAAAAAATTTCTTGTCTACTTTTATCCCCGCTTTTTATTTTTAGT...TAA	1167.0	63	1160	1097	1167	ATGCGATTTAAAAAAATTTCTTGTCTACTTTTATCCCCGCTTTTTATTTTTAGTACCTCAATTTATGCGGGCAATACACCAAAAGACCAAGAAATTAAAAAACTGGTAGATCAAAACTTTAAACCGTTATTAGAAAAATATGATGTGCCAGGTATGGCTGTGGGTGTTATTCAAAATAATAAAAAGTATGAAATGTATTATGGTCTTCAATCTGTTCAAGATAAAAAAGCCGTAAATAGCAGTACTATTTTTGAGCTAGGTTCTGTCAGTAAATTATTTACCGCGACAGCAGGTGGATATGCAAAAAATAAAGGAAAAATCTCTTTTGACGATACGCCTGGTAAGTATTGGAAAGAACTAAAAAATACACCGATTGACCAAGTTAACTTACTTCAACTCGCGACGTATACAAGTGGTAACCTTGCCTTGCAATTTCCAGATGAAGTAAAAACAGATCAGCAAGTTTTAACATTTTTTAAAGACTGGAAACCTAAAAACTCAATCGGTGAATATCGACAATATTCAAACCCAAGCATTGGTTTATTTGGAAAAGTTGTAGCTTTGTCTATGAATAAACCTTTCGACCAAGTCTTAGAAAAAACAATTTTTCCGGCCCTTGGCTTAAAACATAGCTATGTAAATGTACCTAAGACCCAGATGCAAAACTATGCTTTTGGCTATAACCAAGAAAATCAGCCGATTCGAGTTAACCCCGGCCCACTCGATGCCCCAGCATATGGCGTCAAATCGACACTACCCGACATGTTGAGTTTTATTCATGCCAACCTAAATCCACAAAAATATCCAGCAGATATTCAACGGGCAATTAATGAAACACATCAGGGTCGCTATCAAGTAAATACCATGTATCAGGCACTCGGTTGGGAAGAGTTTTCTTATCCGGCAACGTTACAAACTTTATTAGACAGTAATTCAGAACAGATTGTGATGAAACCTAATAAAGTGACTGCTATTTCAAAGGAACCTTCAGTTAAGATGTACCATAAAACTGGCTCAACTACCGGTTTCGGAACATATGTGGTGTTTATTCCTAAAGAAAATATTGGTTTAGTCATGTTAACCAATAAACGTATTCC
537	gb|GU437214.1|+|0-774|ARO:3000858|armA	ATGGATAAGAATGATGTTGTTAAGAAGATACTTGAATCAAAAAAGTACGAAAAC...TAA	774.0	137	856	719	774	ATGGATAAGAATGATGTTGTTAAGAAGATACTTGAATCAAAAAAGTACGAAAACCTTGATTCAGATATTGTTGAAAAGGTTGTTTCCATTTCTGAGAAGAAATATAAATTAAAGGAAGTTGAGAATTATTCTAAAAAGAAATTGCATCAAATATGGGGGTCTTACTATTCTGCCTATCCTAATTGGGATAAATTATTAAAAAAGTACAATCAGGGGCAGTTATCAATAGAAGATTTACTAAAGATTCATTCTTCGACGAATGAAAGAGTCGCAACATTAAATGACTTTTACACTTATGTATTTGGAAATATCAAACATGTCTCATCTATTTTAGATTTTGGTTGTGGCTTCAATCCATTAGCTTTATACCAATGGAATGAAAATGAAAAAATAATATATCATGCATACGATATTGATAGAGCTGAGATAGCTTTTTTGAGTAGCATTATTGGGAAGTTAAAGACGACGATAAAGTATAGGTTTTTGAATAAAGAGAGTGATGTCTACAAAGGTACTTATGATGTAGTATTCCTTTTAAAGATGCTTCCTGTGCTAAAACAGCAAGATGTAAATATCTTGGATTTCCTACAGCTTTTTCATACTCAAAACTTTGTAATATCTTTTCCAATAAAGTCTTTATCTGGAAAGGAGAAGGGAATGGAAGAGAATTACCAGCTATGGTTTGAATCTTTTACAAAAGGTTGGATAAAAATCCTTGA
538	gb|AF527798.1|+|0-785|ARO:3000879|TEM-7  Partial			82	812	730	785	TTTTTTGCGGCATTTTGCCTTCCTGTTTTTGCTCACCCAGAAACGCTGGTGAAAGTAAAAGATGCTGAAGATCAGTTGGGTGCACGAGTGGGTTACATCGAGCTGGATCTCAACAGCGGTAAGATCCTTGAGAGTTTTCGCCCCGAAGAACGTTTTCCAATGATGAGCACTTTTAAAGTTCTGCTATGTGGTGCGGTATTATCCCGTGTTGACGCCGGGCAAGAGCAACTCGGTCGCCGCATACACTATTCTCAGAATGACTTGGTTGAGTACTCACCAGTCACAGAAAAGCATCTTACGGATGGCATGACAGTAAGAGAATTATGCAGTGCTGCCATAACCATGAGTGATAACACTGCGGCCAACTTACTTCTGACAACGATCGGAGGACCGAAGGAGCTAACCGCTTTTTTGCACAACATGGGGGATCATGTAACCCGCCTTGATCGTTGGGAACCGGAGCTGAATGAAGCCATACCAAACGACGAGCGTGACACCACGATGCCTGCAGCAATGGCAACAACGTTGCGCAAACTATTAACTGGCGAACTACTTACTCTAGCTTCCCGGCAACAATTAATAGACTGGATGGAGGCGGATAAAGTTGCAGGACCACTTCTGCGCTCGGCCCTTCCGGCTGGCTGGTTTATTGCTGATAAATCTGGAGCCGGTGAGCGTGGATCTCGCGGTATCATTGCAGCACTGGGGCCAGATGGTAAGCCCTCCCGTA
539	gb|JF949915|+|0-754|ARO:3001052|TEM-192	ATTCCCTTTTTTGCGGCATTTTGCCTTCCTGTTTTTGCTCACCCAGAAACGCTG...ACG	753.0	76	774	698	753	ATTCCCTTTTTTGCGGCATTTTGCCTTCCTGTTTTTGCTCACCCAGAAACGCTGGTGAAAGTAAAAGATGCTGAAGATCAGTTGGGTGCACGAGTGGGTTACATCGAGCTGGATCTCAACAGCGGTAAGATCCTTGAGAGTTTTCGCCCCGAAGAACGTTTTCCAATGATGAGCACTTTTAAAGTTCTGCTATGTGGTGCGGTATTATCCCGTGTTGACGCCGGGCAAGAGCAACTCGGTCGCCGCATACACTATTCTCAGAATGACTTGGTTGAGTACTCACCAGTCACAGAAAAGCATCTTACGGATGGCATGACAGTAAGAGAATTATGCAGTGCTGCCATAACCATGAGTGATAACACTGCGGCCAACTTACTTCTGACAACGATCGGAGGACCGAAGGAGCTAACCGCTTTTTTGCACAACATGGGGGATCATGTAACCCGCCTTGATCGTTGGGAACCGGAGCTGAATGAAGCCATACCAAACGACGAGCGTGACACCACGATGCCTGCAGCAATGGCAACAACGTTGCGCAAACTATTAACTGGCGAACTACTTACTCTAGCTTCCCGGCAACAATTAATAGACTGGATGGAGGCGGATAAAGTTGCAGGACCACTTCTGCGCTCGGCCCTTCCGGCTGGCTGGTTTATTGCTGATAAATCTGGAGCCGGTGAGCGTGGATCTCGCGGTAT
540	gb|KR057762.1|+|0-1116|ARO:3004356|PDC-93	GATGAGGCCCCGGCGGATCGCCTGAAGGCACTGGTCGACGCCGCCGTACAACCG...TGA	1116.0	35591	36652	1061	1116	GATGAGGCCCCGGCGGATCGCCTGAAGGCACTGGTCGACGCCGCCGTACAACCGGTGATGAAGGCCAATGACATTCCGGGCCTGGCCGTAGCCATCAGCCTGAAAGGAGAACCGCATTACTTCAGCTATGGGCTGGCCTCGAAAGAGGACGGCCGCCGGGTGACGCCGGAGACCCTGTTCGAGATCGGCTCGGTGAGCAAGACCTTCACCGTCACCCTCGCCGGCTATGCCCTGGCCCAGGACAAGATGCGCCTCGACGACCGCGCCAGCCAGCACTGGCCGGCACTGCAGGGCAGCCGCTTCGACGGCATCAGCCTGCTCGACCTCGCGACCTATACCGCCGGCGGCTTGCCGCTGCAGTTCCCCGACTCGGTGCAGAAGGACCAGGCACAGATCCGCGACTACTACCGCCAGTGGCAGCCGACCTACGCGCCGGGCAGCCAGCGCCTCTATTCCAACCCGAGCATCGGCCTGTTCGGCTATCTCGCCGCGCGCAGCCTGGGCCAGCCGTTCGAACGGCTCATGGAGCAGCAATTGTTCCCGGCACTGGGCCTCGAACAGACCCACCTCGACGTGCCCGAGGCGGCGCTGGCGCAGTACGCCCAGGGCTACGGCAAGGACGACCGCCCGCTACGGGTCGGTCCCGGCCCGCTGGATGCCGAAGGCTACGGGGTGAAGACCAGCGCGGCCGACCTGCTGCGCTTCGTCGATGCCAACCTGCATCCGGAGCGCCTGGACAGGCCCTGGGCGCAGGCGCTCGATGCCACCCATCGCGGTTACTACAAGGTCGGCGACATGACCCAGGGCCTGGGCTGGGAAGCCTACGACTGGCCGATCTCCCTGAAGCGCCTGCAGGCCGGCAACTCGACGCCGATGGCGCTGCAACCACACAGGATCGCCAGGCTGCCCGCGCCACAGGCGCTGGAGGGCCAGCGCCTGCTGAACAAGACCGGCTCCACCAACGGCTTCGGCGCCTACGTGGCGTTCGTCCCGGGCCGCGACCTGGGCCTGGTGATCCTGGCCAACCGCAACTATCCCAATGCCGAGCGGGTGAAGATCGC
541	gb|AF188199|+|214-1075|ARO:3000936|TEM-70	ATGAGTATTCAACATTTTCGTGTCGCCCTTATTCCCTTTTTTGCGGCATTTTGC...TAA	861.0	46	852	806	861	ATGAGTATTCAACATTTCCGTGTCGCCCTTATTCCCTTTTTTGCGGCATTTTGCCTTCCTGTTTTTGCTCACCCAGAAACGCTGGTGAAAGTAAAAGATGCTGAAGATCAGTTGGGTGCACGAGTGGGTTACATCGAGCTGGATCTCAACAGCGGTAAGATCCTTGAGAGTTTTCGCCCCGAAGAACGTTTTCCAATGATGAGCACTTTTAAAGTTCTGCTATGTGGTGCGGTATTATCCCGTGTTGACGCCGGGCAAGAGCAACTCGGTCGCCGCATACACTATTCTCAGAATGACTTGGTTGAGTACTCACCAGTCACAGAAAAGCATCTTACGGATGGCATGACAGTAAGAGAATTATGCAGTGCTGCCATAACCATGAGTGATAACACTGCGGCCAACTTACTTCTGACAACGATCGGAGGACCGAAGGAGCTAACCGCTTTTTTGCACAACATGGGGGATCATGTAACCCGCCTTGATCGTTGGGAACCGGAGCTGAATGAAGCCATACCAAACGACGAGCGTGACACCACGATGCCTGCAGCAATGGCAACAACGTTGCGCAAACTATTAACTGGCGAACTACTTACTCTAGCTTCCCGGCAACAATTAATAGACTGGATGGAGGCGGATAAAGTTGCAGGACCACTTCTGCGCTCGGCCCTTCCGGCTGGCTGGTTTATTGCTGATAAATCTGGAGCCGGTGAGCGTGGATCTCGCGGTATCATTGCAGCACTGGGGCCAGATGGTAAGCCCTCCCGTATCGTAGTTATCTACACGACGGGGAGTCAGGCAACTATGGA
542	gb|DQ279850|+|0-861|ARO:3001014|TEM-147	ATGAGTATTCAACATTTCCGTGTCGCCCTTATTCCCTTTTTTGCGGCATTTTGC...TAA	861.0	46	852	806	861	ATGAGTATTCAACATTTCCGTGTCGCCCTTATTCCCTTTTTTGCGGCATTTTGCCTTCCTGTTTTTGCTCACCCAGAAACGCTGGTGAAAGTAAAAGATGCTGAAGATCAGTTGGGTGCACGAGTGGGTTACATCGAGCTGGATCTCAACAGCGGTAAGATCCTTGAGAGTTTTCGCCCCGAAGAACGTTTTCCAATGATGAGCACTTTTAAAGTTCTGCTATGTGGTGCGGTATTATCCCGTGTTGACGCCGGGCAAGAGCAACTCGGTCGCCGCATACACTATTCTCAGAATGACTTGGTTGAGTACTCACCAGTCACAGAAAAGCATCTTACGGATGGCATGACAGTAAGAGAATTATGCAGTGCTGCCATAACCATGAGTGATAACACTGCGGCCAACTTACTTCTGACAACGATCGGAGGACCGAAGGAGCTAACCGCTTTTTTGCACAACATGGGGGATCATGTAACCCGCCTTGATCGTTGGGAACCGGAGCTGAATGAAGCCATACCAAACGACGAGCGTGACACCACGATGCCTGCAGCAATGGCAACAACGTTGCGCAAACTATTAACTGGCGAACTACTTACTCTAGCTTCCCGGCAACAATTAATAGACTGGATGGAGGCGGATAAAGTTGCAGGACCACTTCTGCGCTCGGCCCTTCCGGCTGGCTGGTTTATTGCTGATAAATCTGGAGCCGGTGAGCGTGGATCTCGCGGTATCATTGCAGCACTGGGGCCAGATGGTAAGCCCTCCCGTATCGTAGTTATCTACACGACGGGGAGTCAGGCAACTATGGA
543	gb|KJ920337.1|+|0-825|ARO:3001589|OXA-403	ATGAACATTAAAGCACTCTTACTTATAACAAGCGCTATTTTTATTTCAGCCTGC...TAG	825.0	54149	54919	770	825	ATGAACATTAAAGCACTCTTACTTATAACAAGCGCTATTTTTATTTCAGCCTGCTCACCTTATATAGTGACTGCTAATCCAAATCACAGCGCTTCAAAATCTGATGTAAAAGCAGAGAAAATTAAAAATTTATTTAACGAAGCACACACTACGGGTGTTTTAGTTATCCAACAAGGCCAAACTCAACAAAGCTATGGTAATGATCTTGCTCGTGCTTCGACCGAGTATGTACCTGCTTCGACCTTCAAAATGCTTAATGCTTTGATCGGCCTTGAGCACCATAAGGCAACCACCACAGAAGTATTTAAGTGGGATGGTAAAAAAAGGTTATTCCCAGAATGGGAAAAGGACATGACCCTAGGCGATGCCATGAAAGCTTCCGCTATTCCAGTTTATCAAGATTTAGCTCGTCGTATTGGACTTGAGCTCATGTCTAAGGAAGTGAAGCGTGTTGGTTATGGCAATGCAGATATCGGTACCCAAGTCGATAATTTTTGGCTGGTGGGTCCTTTAAAAATTACTCCTCAGCAAGAGGCACAGTTTGCTTACAAGCTAGCTAATAAAACGCTTCCATTTAGCCAAAAAGTCCAAGATGAAGTGCAATCCATGCTATTCATAGAAGAAAAGAATGGAAACAAAATATACGCAAAAAGTGGTTGGGGATGGGATGTAAACCCACAAGTAGGCTGGTTAACTGGATGGGTTGTTCAGCCTCAAGGGAATATTGTAGCGTTCTCCCTTAACTTAGAAATGAAAAAAGGAATACCTAG
544	gb|AF203816|+|210-1071|ARO:3000937|TEM-71	ATGAGTATTCAACATTTCCGTGTCGCCCTTATTCCCTTTTTTGCGGCATTTTGC...TAA	861.0	46	852	806	861	ATGAGTATTCAACATTTCCGTGTCGCCCTTATTCCCTTTTTTGCGGCATTTTGCCTTCCTGTTTTTGCTCACCCAGAAACGCTGGTGAAAGTAAAAGATGCTGAAGATCAGTTGGGTGCACGAGTGGGTTACATCGAGCTGGATCTCAACAGCGGTAAGATCCTTGAGAGTTTTCGCCCCGAAGAACGTTTTCCAATGATGAGCACTTTTAAAGTTCTGCTATGTGGTGCGGTATTATCCCGTGTTGACGCCGGGCAAGAGCAACTCGGTCGCCGCATACACTATTCTCAGAATGACTTGGTTGAGTACTCACCAGTCACAGAAAAGCATCTTACGGATGGCATGACAGTAAGAGAATTATGCAGTGCTGCCATAACCATGAGTGATAACACTGCGGCCAACTTACTTCTGACAACGATCGGAGGACCGAAGGAGCTAACCGCTTTTTTGCACAACATGGGGGATCATGTAACCCGCCTTGATCGTTGGGAACCGGAGCTGAATGAAGCCATACCAAACGACGAGCGTGACACCACGATGCCTGCAGCAATGGCAACAACGTTGCGCAAACTATTAACTGGCGAACTACTTACTCTAGCTTCCCGGCAACAATTAATAGACTGGATGGAGGCGGATAAAGTTGCAGGACCACTTCTGCGCTCGGCCCTTCCGGCTGGCTGGTTTATTGCTGATAAATCTGGAGCCGGTGAGCGTGGATCTCGCGGTATCATTGCAGCACTGGGGCCAGATGGTAAGCCCTCCCGTATCGTAGTTATCTACACGACGGGGAGTCAGGCAACTATGGA
545	gb|JEXY01000001.1|+|379-1531|ARO:3003888|ADC-82	ATGCGATTTAAAAAAATTTCTTGTCTACTTTTATCCCCGCTTTTTATTTTTAGT...TAA	1152.0	63	1160	1097	1152	ATGCGATTTAAAAAAATTTCTTGTCTACTTTTATCCCCGCTTTTTATTTTTAGTACCTCAATTTATGCGGGCAATACACCAAAAGACCAAGAAATTAAAAAACTGGTAGATCAAAACTTTAAACCGTTATTAGAAAAATATGATGTGCCAGGTATGGCTGTGGGTGTTATTCAAAATAATAAAAAGTATGAAATGTATTATGGTCTTCAATCTGTTCAAGATAAAAAAGCCGTAAATAGCAGTACTATTTTTGAGCTAGGTTCTGTCAGTAAATTATTTACCGCGACAGCAGGTGGATATGCAAAAAATAAAGGAAAAATCTCTTTTGACGATACGCCTGGTAAGTATTGGAAAGAACTAAAAAATACACCGATTGACCAAGTTAACTTACTTCAACTCGCGACGTATACAAGTGGTAACCTTGCCTTGCAATTTCCAGATGAAGTAAAAACAGATCAGCAAGTTTTAACATTTTTTAAAGACTGGAAACCTAAAAACTCAATCGGTGAATATCGACAATATTCAAACCCAAGCATTGGTTTATTTGGAAAAGTTGTAGCTTTGTCTATGAATAAACCTTTCGACCAAGTCTTAGAAAAAACAATTTTTCCGGCCCTTGGCTTAAAACATAGCTATGTAAATGTACCTAAGACCCAGATGCAAAACTATGCTTTTGGCTATAACCAAGAAAATCAGCCGATTCGAGTTAACCCCGGCCCACTCGATGCCCCAGCATATGGCGTCAAATCGACACTACCCGACATGTTGAGTTTTATTCATGCCAACCTAAATCCACAAAAATATCCAGCAGATATTCAACGGGCAATTAATGAAACACATCAGGGTCGCTATCAAGTAAATACCATGTATCAGGCACTCGGTTGGGAAGAGTTTTCTTATCCGGCAACGTTACAAACTTTATTAGACAGTAATTCAGAACAGATTGTGATGAAACCTAATAAAGTGACTGCTATTTCAAAGGAACCTTCAGTTAAGATGTACCATAAAACTGGCTCAACTACCGGTTTCGGAACATATGTGGTGTTTATTCCTAAAGAAAATATTGGTTTAGTCATGTTAACCAATAAACGTATTCC
546	gb|KU736867.1|+|19653-21573|ARO:3004442|tet(W/N/W)	ATGAAAATAATCAATATTGGAATTCTTGCCCATGTAGACGCTGGAAAGACGACC...TGA	1920.0	745	2603	1858	1920	ATGAAAATAATCAATATTGGAATTCTTGCCCATGTAGACGCTGGAAAGACGACCTTGACGGAGAGCCTGCTATATGCCAGCGGAGCCATTTCAGAACCGGGGAGCGTCGAAAAAGGGACAACGAGGACGGACACCATGTTTTTGGAGCGGCAGCGTGGGATTACCATTCAAGCGGCAGTCACTTCCTTCCAGTGGCACAGATGTAAAGTCAACATTGTGGATACGCCCGGCCACATGGATTTTTTGGCGGAGGTGTACCGCTCTTTGGCTGTTTTAGATGGGGCCATCTTGGTGATCTCCGCTAAAGATGGCGTGCAGGCCCAGACCCGTATTCTGTTCCATGCCCTGCGGAAAATGAACATTCCCACCGTTATCTTTATCAACAAGATCGACCAGGCTGGCGTTGATTTGCAGAGCGTGGTTCAGTCTGTTCGGGATAAGCTCTCCGCCGATATTATCATCAAGCAGACGGTGTCGCTGTCCCCGGAAATAGTCCTGGAGGAAAATACCGACATAGAAGCATGGGATGCGGTCATCGAAAATAACGATAAATTATTGGAAAAGTATATCGCAGGAGAACCAATCAGCCGGGAAAAACTTGTGCGGGAGGAACAGCGGCGGGTTCAAGACGCCTCCCTGTTCCCGGTCTATTATGGCAGCGCCAAAAAGGGCCTTGGCATTCAACCGTTGATGGATGCGGTGACAGGGCTGTTCCAACCGATTGGGGAACAGGGGAGCGCCGCCCTATGCGGCAGCGTTTTCAAGGTGGAGTATACAGATTGCGGCCAGCGGCGTGTCTATCTACGGCTATACAGCGGAACGCTGCGCCTGCGGGATACGGTGGCCCTGGCCGGGAGAGAAAAGCTGAAAATCACAGAGATGCGTATTCCATCCAAAGGGGAAATTGTTCGGACAGACACCGCTTATCCGGGTGAAATTGTTATCCTTCCCAGCGACAGCGTGAGGTTAAACGATGTATTAGGGGACCCAACCCGGCTCCCTCGTAAAAGGTGGCGTGAGGACCCCCTCCCCATGCTGCGGACGTCGATTGCGCCGAAAACGGCAGCGCAAAGAGAACGGCTGCTGGACGCTCTTACGCAACTTGCGGATACTGACCCGCTTTTGCGCTGCGAGGTGGATTCCATCACCCATGAGATCATTCTTTCTTTTTTGGGCCGGGTGCAGTTGGAGGTTGTTTCCGCTTTGCTGTCGGAAAAATACAAGCTTGAAACAGTGGTAAAGGAACCCACCGTCATTTATATGGAGCGGCCGCTCAAAGCAGCCAGCCACACCATCCATATCGAGGTGCCGCCCAACCCGTTTTGGGCATCCATCGGACTGTCTGTTACACCACTCCCGCTTGGCTCCGGTGTACAATACGAGAGCCGGGTTTCGCTGGGATACTTGAACCAGAGTTTTCAAAACGCTGTCAGGGATGGTATCCGTTACGGGCTGGAGCAGGGCTTGTTCGGCTGGAACGTAACGGACTGTAAGATTTGCTTTGAATACGGGCTTTATTACAGTCCGGTCAGCACGCCGGCGGACTTCCGCTCATTGGCCCCGATTGTATTGGAACAGGCATTGAAGGAATCAGGGACGCAACTGCTGGAACCTTATCTCTCCTTCACCCTCTATGCGCCCCGGGAATATCTTTCCAGGGCTTATCATGATGCACCGAAATACTGTGCCACCATCGAAACGGTCCAGGTAAAAAAGGATGAAGTTGTCTTTACTGGCGAGATTCCCGCCCGCTGTATACAGGCATACCGTACTGATCTGGCCTTTTACACCAACGGGCAGAGCGTATGCCTTACAGAACTGAAAGGGTATCAGGCCGCTGTCGGCAAGCCAGTCATCC
547	gb|AF157553|+|147-1008|ARO:3000938|TEM-72	ATGAGTATTCAACATTTCCGTGTCGCCCTTATTCCCTTTTTTGCGGCATTTTGC...TAA	861.0	46	852	806	861	ATGAGTATTCAACATTTCCGTGTCGCCCTTATTCCCTTTTTTGCGGCATTTTGCCTTCCTGTTTTTGCTCACCCAGAAACGCTGGTGAAAGTAAAAGATGCTGAAGATCAGTTGGGTGCACGAGTGGGTTACATCGAGCTGGATCTCAACAGCGGTAAGATCCTTGAGAGTTTTCGCCCCGAAGAACGTTTTCCAATGATGAGCACTTTTAAAGTTCTGCTATGTGGTGCGGTATTATCCCGTGTTGACGCCGGGCAAGAGCAACTCGGTCGCCGCATACACTATTCTCAGAATGACTTGGTTGAGTACTCACCAGTCACAGAAAAGCATCTTACGGATGGCATGACAGTAAGAGAATTATGCAGTGCTGCCATAACCATGAGTGATAACACTGCGGCCAACTTACTTCTGACAACGATCGGAGGACCGAAGGAGCTAACCGCTTTTTTGCACAACATGGGGGATCATGTAACCCGCCTTGATCGTTGGGAACCGGAGCTGAATGAAGCCATACCAAACGACGAGCGTGACACCACGATGCCTGCAGCAATGGCAACAACGTTGCGCAAACTATTAACTGGCGAACTACTTACTCTAGCTTCCCGGCAACAATTAATAGACTGGATGGAGGCGGATAAAGTTGCAGGACCACTTCTGCGCTCGGCCCTTCCGGCTGGCTGGTTTATTGCTGATAAATCTGGAGCCGGTGAGCGTGGATCTCGCGGTATCATTGCAGCACTGGGGCCAGATGGTAAGCCCTCCCGTATCGTAGTTATCTACACGACGGGGAGTCAGGCAACTATGGA
548	gb|AF078527|+|3769-4303|ARO:3000230|ANT(2'')-Ia	ATGGACACAACGCAGGTCACATTGATACACAAAATTCTAGCTGCGGCAGATGAG...TAA	534.0	57	536	479	534	ATGGACACAACGCAGGTCACATTGATACACAAAATTCTAGCTGCGGCAGATGAGCGAAATCTGCCGCTCTGGATCGGTGGGGGCTGGGCGATCGATGCACGGCTAGGGCGTGTAACACGCAAGCACGATGATATTGATCTGACGTTTCCCGGCGAGAGGCGCGGCGAGCTCGAGGCAATAGTTGAAATGCTCGGCGGGCGCGTCATGGAGGAGTTGGACTATGGATTCTTAGCGGAGATCGGGGATGAGTTACTTGACTGCGAACCTGCTTGGTGGGCAGACGAAGCGTATGAAATCGCGGAGGCTCCGCAGGGCTCGTGCCCAGAGGCGGCTGAGGGCGTCATCGCCGGGCGGCCAGTCCGTTGTAACAGCTGGGAGGCGATCATCTGGGATTACTTTTACTATGCCGATGAAGTACCACCAGTGGACTGGCCTACAAAGCACATAGAGTCCTACAGGCTCGCATGCACCTCACTCGG
549	gb|NC_002516.2|-|779462-780101|ARO:3002679|Pseudomonas_aeruginosa_catB7	ATGGGCAACTATTTCGAGAGCCCCTTCAGGGGCAAGCTGCTCTCGGAACAGGTC...TGA	639.0	78566	79150	584	639	ATGGGCAACTATTTCGAGAGCCCCTTCAGGGGCAAGCTGCTCTCGGAACAGGTCAGCAACCCAAACATTCGGGTGGGGCGCTACAGCTACTACTCCGGCTACTATCACGGGCATTCCTTCGACGACTGCGCCCGCTACCTGATGCCGGACCGCGACGACGTGGACAAGCTGGTCATCGGCAGTTTCTGTTCGATCGGCAGTGGCGCCGCCTTCATCATGGCCGGCAACCAGGGACACCGCGCCGAATGGGCATCGACCTTCCCCTTCCACTTCATGCACGAAGAGCCTGCCTTCGCCGGCGCCGTGAACGGCTATCAGCCAGCGGGCGACACGCTGATCGGCCATGACGTCTGGATCGGTACCGAGGCGATGTTCATGCCCGGCGTACGGGTCGGCCACGGAGCCATCATCGGCAGCCGCGCGCTGGTGACCGGCGATGTCGAGCCCTATGCCATCGTCGGCGGTAACCCGGCCCGGACCATTCGTAAGCGCTTTTCCGATGGCGATATCCAGAACCTGCTGGAAATGGCCTGGTGGGACTGGCCACTGGCCGATATCGAGGCAGCCATGCCACTGCTGTGTAC
550	gb|JN935135|+|0-861|ARO:3001053|TEM-193	ATGAGTATTCAACATTTCCGTGTCGCCCTTATTCCCTTTTTTGCGGCATTTTGC...TAA	861.0	46	852	806	861	ATGAGTATTCAACATTTCCGTGTCGCCCTTATTCCCTTTTTTGCGGCATTTTGCCTTCCTGTTTTTGCTCACCCAGAAACGCTGGTGAAAGTAAAAGATGCTGAAGATCAGTTGGGTGCACGAGTGGGTTACATCGAGCTGGATCTCAACAGCGGTAAGATCCTTGAGAGTTTTCGCCCCGAAGAACGTTTTCCAATGATGAGCACTTTTAAAGTTCTGCTATGTGGTGCGGTATTATCCCGTGTTGACGCCGGGCAAGAGCAACTCGGTCGCCGCATACACTATTCTCAGAATGACTTGGTTGAGTACTCACCAGTCACAGAAAAGCATCTTACGGATGGCATGACAGTAAGAGAATTATGCAGTGCTGCCATAACCATGAGTGATAACACTGCGGCCAACTTACTTCTGACAACGATCGGAGGACCGAAGGAGCTAACCGCTTTTTTGCACAACATGGGGGATCATGTAACCCGCCTTGATCGTTGGGAACCGGAGCTGAATGAAGCCATACCAAACGACGAGCGTGACACCACGATGCCTGCAGCAATGGCAACAACGTTGCGCAAACTATTAACTGGCGAACTACTTACTCTAGCTTCCCGGCAACAATTAATAGACTGGATGGAGGCGGATAAAGTTGCAGGACCACTTCTGCGCTCGGCCCTTCCGGCTGGCTGGTTTATTGCTGATAAATCTGGAGCCGGTGAGCGTGGATCTCGCGGTATCATTGCAGCACTGGGGCCAGATGGTAAGCCCTCCCGTATCGTAGTTATCTACACGACGGGGAGTCAGGCAACTATGGA
551	gb|AM087454|+|208-1069|ARO:3001015|TEM-148	ATGAGTATTCAACATTTTCGTGTCGCCCTTATTCCCTTTTTTGCGGCATTTTGC...TAA	861.0	46	852	806	861	ATGAGTATTCAACATTTCCGTGTCGCCCTTATTCCCTTTTTTGCGGCATTTTGCCTTCCTGTTTTTGCTCACCCAGAAACGCTGGTGAAAGTAAAAGATGCTGAAGATCAGTTGGGTGCACGAGTGGGTTACATCGAGCTGGATCTCAACAGCGGTAAGATCCTTGAGAGTTTTCGCCCCGAAGAACGTTTTCCAATGATGAGCACTTTTAAAGTTCTGCTATGTGGTGCGGTATTATCCCGTGTTGACGCCGGGCAAGAGCAACTCGGTCGCCGCATACACTATTCTCAGAATGACTTGGTTGAGTACTCACCAGTCACAGAAAAGCATCTTACGGATGGCATGACAGTAAGAGAATTATGCAGTGCTGCCATAACCATGAGTGATAACACTGCGGCCAACTTACTTCTGACAACGATCGGAGGACCGAAGGAGCTAACCGCTTTTTTGCACAACATGGGGGATCATGTAACCCGCCTTGATCGTTGGGAACCGGAGCTGAATGAAGCCATACCAAACGACGAGCGTGACACCACGATGCCTGCAGCAATGGCAACAACGTTGCGCAAACTATTAACTGGCGAACTACTTACTCTAGCTTCCCGGCAACAATTAATAGACTGGATGGAGGCGGATAAAGTTGCAGGACCACTTCTGCGCTCGGCCCTTCCGGCTGGCTGGTTTATTGCTGATAAATCTGGAGCCGGTGAGCGTGGATCTCGCGGTATCATTGCAGCACTGGGGCCAGATGGTAAGCCCTCCCGTATCGTAGTTATCTACACGACGGGGAGTCAGGCAACTATGGA
552	gb|AJ012256|+|208-1069|ARO:3000939|TEM-73	ATGAGTATTCAACATTTCCGTGTCGCCCTTATTCCCTTTTTTGCGGCATTTTGC...TAA	861.0	46	852	806	861	ATGAGTATTCAACATTTCCGTGTCGCCCTTATTCCCTTTTTTGCGGCATTTTGCCTTCCTGTTTTTGCTCACCCAGAAACGCTGGTGAAAGTAAAAGATGCTGAAGATCAGTTGGGTGCACGAGTGGGTTACATCGAGCTGGATCTCAACAGCGGTAAGATCCTTGAGAGTTTTCGCCCCGAAGAACGTTTTCCAATGATGAGCACTTTTAAAGTTCTGCTATGTGGTGCGGTATTATCCCGTGTTGACGCCGGGCAAGAGCAACTCGGTCGCCGCATACACTATTCTCAGAATGACTTGGTTGAGTACTCACCAGTCACAGAAAAGCATCTTACGGATGGCATGACAGTAAGAGAATTATGCAGTGCTGCCATAACCATGAGTGATAACACTGCGGCCAACTTACTTCTGACAACGATCGGAGGACCGAAGGAGCTAACCGCTTTTTTGCACAACATGGGGGATCATGTAACCCGCCTTGATCGTTGGGAACCGGAGCTGAATGAAGCCATACCAAACGACGAGCGTGACACCACGATGCCTGCAGCAATGGCAACAACGTTGCGCAAACTATTAACTGGCGAACTACTTACTCTAGCTTCCCGGCAACAATTAATAGACTGGATGGAGGCGGATAAAGTTGCAGGACCACTTCTGCGCTCGGCCCTTCCGGCTGGCTGGTTTATTGCTGATAAATCTGGAGCCGGTGAGCGTGGATCTCGCGGTATCATTGCAGCACTGGGGCCAGATGGTAAGCCCTCCCGTATCGTAGTTATCTACACGACGGGGAGTCAGGCAACTATGGA
553	gb|KJ920338.1|+|0-825|ARO:3001595|OXA-404	ATGAACATTAAAACACTCTTACTTATAACAAGCGCTATTCTTATTTCAGCCTGC...TAG	825.0	54149	54919	770	825	ATGAACATTAAAGCACTCTTACTTATAACAAGCGCTATTTTTATTTCAGCCTGCTCACCTTATATAGTGACTGCTAATCCAAATCACAGCGCTTCAAAATCTGATGTAAAAGCAGAGAAAATTAAAAATTTATTTAACGAAGCACACACTACGGGTGTTTTAGTTATCCAACAAGGCCAAACTCAACAAAGCTATGGTAATGATCTTGCTCGTGCTTCGACCGAGTATGTACCTGCTTCGACCTTCAAAATGCTTAATGCTTTGATCGGCCTTGAGCACCATAAGGCAACCACCACAGAAGTATTTAAGTGGGATGGTAAAAAAAGGTTATTCCCAGAATGGGAAAAGGACATGACCCTAGGCGATGCCATGAAAGCTTCCGCTATTCCAGTTTATCAAGATTTAGCTCGTCGTATTGGACTTGAGCTCATGTCTAAGGAAGTGAAGCGTGTTGGTTATGGCAATGCAGATATCGGTACCCAAGTCGATAATTTTTGGCTGGTGGGTCCTTTAAAAATTACTCCTCAGCAAGAGGCACAGTTTGCTTACAAGCTAGCTAATAAAACGCTTCCATTTAGCCAAAAAGTCCAAGATGAAGTGCAATCCATGCTATTCATAGAAGAAAAGAATGGAAACAAAATATACGCAAAAAGTGGTTGGGGATGGGATGTAAACCCACAAGTAGGCTGGTTAACTGGATGGGTTGTTCAGCCTCAAGGGAATATTGTAGCGTTCTCCCTTAACTTAGAAATGAAAAAAGGAATACCTAG
554	gb|GQ891757|+|2004-2661|ARO:3002801|QnrVC4	ATGGATAAAACAGACCAGTTATATGTACAAGCAGACTTTTCACATCAAGACATG...TAA	657.0	292	894	602	657	ATGGATAAAACAGACCAGTTATATGTACAAGCAGACTTTTCACATCAAGACATGAGTGGTCAGTATTTTAAAAATTGCAAATTTTTCTGCTGTTCCTTTAAACGAGCAAACCTCCGCGATACACAATTTGTAGACTGTTCTTTCATTGAACGAGGTGAATTAGAGGGGTGTGATTTTTCTTACTCGGATCTTAGAGATGCATCTTTTAAAAACTGCAGTCTTTCAATGTCGTATTTCAAAGGTGCAAATTGTTTTGGTATCGAGTTCAGAGAATGCGATTTAAAGGGTGCCAATTTTGCTCAAGCTAGCTTCATGAATCAGGTATCGAACAGAATGTATTTTTGTTCAGCTTATATAACAGGTTGTAATCTTTCATACGCCAACTTTGAAAGGCAGTGTATCGAAAAGTGTGATTTGTTTGAGAACAGATGGATTGGTGCAAATCTAAGTGGGGCATCATTTAAAGAGTCTGATTTAAGTCGGGGAGTATTTTCTGAAGGGTGTTGGAGCCAGTGTAGGTTGCAAGGTTGTGATTTGAGCCACTCGGACTTGTATGGTTTAGACCCTCGGAAAGTTGACCTTACAGGTGTAAAAATCTGTTC
555	gb|AL009126.3|-|339155-339749|ARO:3003059|tmrB	ATGATCATTTGGATAAACGGGGCATTCGGTTCGGGAAAAACACAAACAGCCTTC...TAA	594.0	33	571	538	594	ATGATCATTTGGATAAACGGGGCATTCGGTTCCGGAAAAACACAAACAGCCTTCGAACTGCACAGAAGGCTGAAATCATCTTACGTGTATGATCCCGAGAAAATGGGTTTTGCGCTGCGCTCCATGGTGCCGCAGGAGATCGCAAAGGACGATTTTCAAAGCTATCCTTTATGGCGGGCGTTCAATTACAGTTTGCTAGCTTCTCTGACAGATACATACCGCGGCATCATTATTGTGCCTATGACGATTGTACATCCTGAATACTTCAATGAGATCATCGGCAGGCTCAGACATGAAGGCAGGATCGTTCACCACTTTACACTAATGGCTTCAAAGGAAACCTTGTTAAAAAGGCTTCGCACCAGAGCAGAAGGAAAAAACTCATGGGCCGCCAAACAAATTGACCGCTGCGTTGAAGGTTTATCATTACCCATTTTTGAGGACCACATTCAAACAGACAACCTGTCGATTCAGGATGTGGCAGAGACATTGCCGCGAGAGCCGAACTCCCATTAGATCCTGATACAAGAGGCAGCCT
556	gb|DQ369751|+|0-861|ARO:3001016|TEM-149	ATGAGTATTCAACATTTCCGTGTCGCCCTTATTCCCTTTTTTGCGGCATTTTGC...TAA	861.0	46	852	806	861	ATGAGTATTCAACATTTCCGTGTCGCCCTTATTCCCTTTTTTGCGGCATTTTGCCTTCCTGTTTTTGCTCACCCAGAAACGCTGGTGAAAGTAAAAGATGCTGAAGATCAGTTGGGTGCACGAGTGGGTTACATCGAGCTGGATCTCAACAGCGGTAAGATCCTTGAGAGTTTTCGCCCCGAAGAACGTTTTCCAATGATGAGCACTTTTAAAGTTCTGCTATGTGGTGCGGTATTATCCCGTGTTGACGCCGGGCAAGAGCAACTCGGTCGCCGCATACACTATTCTCAGAATGACTTGGTTGAGTACTCACCAGTCACAGAAAAGCATCTTACGGATGGCATGACAGTAAGAGAATTATGCAGTGCTGCCATAACCATGAGTGATAACACTGCGGCCAACTTACTTCTGACAACGATCGGAGGACCGAAGGAGCTAACCGCTTTTTTGCACAACATGGGGGATCATGTAACCCGCCTTGATCGTTGGGAACCGGAGCTGAATGAAGCCATACCAAACGACGAGCGTGACACCACGATGCCTGCAGCAATGGCAACAACGTTGCGCAAACTATTAACTGGCGAACTACTTACTCTAGCTTCCCGGCAACAATTAATAGACTGGATGGAGGCGGATAAAGTTGCAGGACCACTTCTGCGCTCGGCCCTTCCGGCTGGCTGGTTTATTGCTGATAAATCTGGAGCCGGTGAGCGTGGATCTCGCGGTATCATTGCAGCACTGGGGCCAGATGGTAAGCCCTCCCGTATCGTAGTTATCTACACGACGGGGAGTCAGGCAACTATGGA
557	gb|X02340.1|+|222-1194|ARO:3004089|ANT(3'')-IIa	GTGGTAACGGCGCAGTGGCGGTTTTCATGGCTTCTTGTTATGACATGTTTTTTT...TAA	972.0	0	747	747	972	GTTAAACATCATGAGGGAAGCGGTGATCGCCGAAGTATCGACTCAACTATCAGAGGTAGTTGGCGTCATCGAGCGCCATCTCGAACCGACGTTGCTGGCCGTACATTTGTACGGCTCCGCAGTGGATGGCGGCCTGAAGCCACACAGTGATATTGATTTGCTGGTTACGGTGACCGTAAGGCTTGATGAAACAACGCGGCGAGCTTTGATCAACGACCTTTTGGAAACTTCGGCTTCCCCTGGAGAGAGCGAGATTCTCCGCGCTGTAGAAGTCACCATTGTTGTGCACGACGACATCATTCCGTGGCGTTATCCAGCTAAGCGCGAACTGCAATTTGGAGAATGGCAGCGCAATGACATTCTTGCAGGTATCTTCGAGCCAGCCACGATCGACATTGATCTGGCTATCTTGCTGACAAAAGCAAGAGAACATAGCGTTGCCTTGGTAGGTCCAGCGGCGGAGGAACTCTTTGATCCGGTTCCTGAACAGGATCTATTTGAGGCGCTAAATGAAACCTTAACGCTATGGAACTCGCCGCCCGACTGGGCTGGCGATGAGCGAAATGTAGTGCTTACGTTGTCCCGCATTTGGTACAGCGCAGTAACCGGCAAAATCGCGCCGAAGGATGTCGCTGCCGACTGGGCAATGGAGCGCCTGCCGGCCCAGTATCAGCCCGTCATACTTGAAGCTAGACAGGCTTATCTTGGACAAGAAGAAGATCGCTTGGCCTCGCGCGCAGATCAGTT
558	gb|AY130284|+|0-785|ARO:3000941|TEM-75  Partial			82	812	730	785	TTTTTTGCGGCATTTTGCCTTCCTGTTTTTGCTCACCCAGAAACGCTGGTGAAAGTAAAAGATGCTGAAGATCAGTTGGGTGCACGAGTGGGTTACATCGAGCTGGATCTCAACAGCGGTAAGATCCTTGAGAGTTTTCGCCCCGAAGAACGTTTTCCAATGATGAGCACTTTTAAAGTTCTGCTATGTGGTGCGGTATTATCCCGTGTTGACGCCGGGCAAGAGCAACTCGGTCGCCGCATACACTATTCTCAGAATGACTTGGTTGAGTACTCACCAGTCACAGAAAAGCATCTTACGGATGGCATGACAGTAAGAGAATTATGCAGTGCTGCCATAACCATGAGTGATAACACTGCGGCCAACTTACTTCTGACAACGATCGGAGGACCGAAGGAGCTAACCGCTTTTTTGCACAACATGGGGGATCATGTAACCCGCCTTGATCGTTGGGAACCGGAGCTGAATGAAGCCATACCAAACGACGAGCGTGACACCACGATGCCTGCAGCAATGGCAACAACGTTGCGCAAACTATTAACTGGCGAACTACTTACTCTAGCTTCCCGGCAACAATTAATAGACTGGATGGAGGCGGATAAAGTTGCAGGACCACTTCTGCGCTCGGCCCTTCCGGCTGGCTGGTTTATTGCTGATAAATCTGGAGCCGGTGAGCGTGGATCTCGCGGTATCATTGCAGCACTGGGGCCAGATGGTAAGCCCTCCCGTA
559	gb|JN408080|+|0-657|ARO:3002802|QnrVC5	ATGGATAAAACAGACCAGTTATATGTACAAGCAGACTTTTCACATCAAGACATG...TAA	657.0	292	894	602	657	ATGGATAAAACAGACCAGTTATATGTACAAGCAGACTTTTCACATCAAGACATGAGTGGTCAGTATTTTAAAAATTGCAAATTTTTCTGCTGTTCCTTTAAACGAGCAAACCTCCGCGATACACAATTTGTAGACTGTTCTTTCATTGAACGAGGTGAATTAGAGGGGTGTGATTTTTCTTACTCGGATCTTAGAGATGCATCTTTTAAAAACTGCAGTCTTTCAATGTCGTATTTCAAAGGTGCAAATTGTTTTGGTATCGAGTTCAGAGAATGCGATTTAAAGGGTGCCAATTTTGCTCAAGCTAGCTTCATGAATCAGGTATCGAACAGAATGTATTTTTGTTCAGCTTATATAACAGGTTGTAATCTTTCATACGCCAACTTTGAAAGGCAGTGTATCGAAAAGTGTGATTTGTTTGAGAACAGATGGATTGGTGCAAATCTAAGTGGGGCATCATTTAAAGAGTCTGATTTAAGTCGGGGAGTATTTTCTGAAGGGTGTTGGAGCCAGTGTAGGTTGCAAGGTTGTGATTTGAGCCACTCGGACTTGTATGGTTTAGACCCTCGGAAAGTTGACCTTACAGGTGTAAAAATCTGTTC
560	gb|JN935136|+|0-861|ARO:3001054|TEM-194	ATGAGTATTCAACATTTCCGTGTCGCCCTTATTCCCTTTTTTGCGGCATTTTGC...TAA	861.0	46	852	806	861	ATGAGTATTCAACATTTCCGTGTCGCCCTTATTCCCTTTTTTGCGGCATTTTGCCTTCCTGTTTTTGCTCACCCAGAAACGCTGGTGAAAGTAAAAGATGCTGAAGATCAGTTGGGTGCACGAGTGGGTTACATCGAGCTGGATCTCAACAGCGGTAAGATCCTTGAGAGTTTTCGCCCCGAAGAACGTTTTCCAATGATGAGCACTTTTAAAGTTCTGCTATGTGGTGCGGTATTATCCCGTGTTGACGCCGGGCAAGAGCAACTCGGTCGCCGCATACACTATTCTCAGAATGACTTGGTTGAGTACTCACCAGTCACAGAAAAGCATCTTACGGATGGCATGACAGTAAGAGAATTATGCAGTGCTGCCATAACCATGAGTGATAACACTGCGGCCAACTTACTTCTGACAACGATCGGAGGACCGAAGGAGCTAACCGCTTTTTTGCACAACATGGGGGATCATGTAACCCGCCTTGATCGTTGGGAACCGGAGCTGAATGAAGCCATACCAAACGACGAGCGTGACACCACGATGCCTGCAGCAATGGCAACAACGTTGCGCAAACTATTAACTGGCGAACTACTTACTCTAGCTTCCCGGCAACAATTAATAGACTGGATGGAGGCGGATAAAGTTGCAGGACCACTTCTGCGCTCGGCCCTTCCGGCTGGCTGGTTTATTGCTGATAAATCTGGAGCCGGTGAGCGTGGATCTCGCGGTATCATTGCAGCACTGGGGCCAGATGGTAAGCCCTCCCGTATCGTAGTTATCTACACGACGGGGAGTCAGGCAACTATGGA
561	gb|AM849805|+|262-1123|ARO:3000886|TEM-15	ATGAGTATTCAACATTTTCGTGTCGCCCTTATTCCCTTTTTTGCGGCATTTTGC...TAA	861.0	46	852	806	861	ATGAGTATTCAACATTTCCGTGTCGCCCTTATTCCCTTTTTTGCGGCATTTTGCCTTCCTGTTTTTGCTCACCCAGAAACGCTGGTGAAAGTAAAAGATGCTGAAGATCAGTTGGGTGCACGAGTGGGTTACATCGAGCTGGATCTCAACAGCGGTAAGATCCTTGAGAGTTTTCGCCCCGAAGAACGTTTTCCAATGATGAGCACTTTTAAAGTTCTGCTATGTGGTGCGGTATTATCCCGTGTTGACGCCGGGCAAGAGCAACTCGGTCGCCGCATACACTATTCTCAGAATGACTTGGTTGAGTACTCACCAGTCACAGAAAAGCATCTTACGGATGGCATGACAGTAAGAGAATTATGCAGTGCTGCCATAACCATGAGTGATAACACTGCGGCCAACTTACTTCTGACAACGATCGGAGGACCGAAGGAGCTAACCGCTTTTTTGCACAACATGGGGGATCATGTAACCCGCCTTGATCGTTGGGAACCGGAGCTGAATGAAGCCATACCAAACGACGAGCGTGACACCACGATGCCTGCAGCAATGGCAACAACGTTGCGCAAACTATTAACTGGCGAACTACTTACTCTAGCTTCCCGGCAACAATTAATAGACTGGATGGAGGCGGATAAAGTTGCAGGACCACTTCTGCGCTCGGCCCTTCCGGCTGGCTGGTTTATTGCTGATAAATCTGGAGCCGGTGAGCGTGGATCTCGCGGTATCATTGCAGCACTGGGGCCAGATGGTAAGCCCTCCCGTATCGTAGTTATCTACACGACGGGGAGTCAGGCAACTATGGA
562	gb|AF190694|+|208-1069|ARO:3000942|TEM-76	ATGAGTATTCAACATTTTCGTGTCGCCCTTATTCCCTTTTTTGCGGCATTTTGC...TAA	861.0	46	852	806	861	ATGAGTATTCAACATTTCCGTGTCGCCCTTATTCCCTTTTTTGCGGCATTTTGCCTTCCTGTTTTTGCTCACCCAGAAACGCTGGTGAAAGTAAAAGATGCTGAAGATCAGTTGGGTGCACGAGTGGGTTACATCGAGCTGGATCTCAACAGCGGTAAGATCCTTGAGAGTTTTCGCCCCGAAGAACGTTTTCCAATGATGAGCACTTTTAAAGTTCTGCTATGTGGTGCGGTATTATCCCGTGTTGACGCCGGGCAAGAGCAACTCGGTCGCCGCATACACTATTCTCAGAATGACTTGGTTGAGTACTCACCAGTCACAGAAAAGCATCTTACGGATGGCATGACAGTAAGAGAATTATGCAGTGCTGCCATAACCATGAGTGATAACACTGCGGCCAACTTACTTCTGACAACGATCGGAGGACCGAAGGAGCTAACCGCTTTTTTGCACAACATGGGGGATCATGTAACCCGCCTTGATCGTTGGGAACCGGAGCTGAATGAAGCCATACCAAACGACGAGCGTGACACCACGATGCCTGCAGCAATGGCAACAACGTTGCGCAAACTATTAACTGGCGAACTACTTACTCTAGCTTCCCGGCAACAATTAATAGACTGGATGGAGGCGGATAAAGTTGCAGGACCACTTCTGCGCTCGGCCCTTCCGGCTGGCTGGTTTATTGCTGATAAATCTGGAGCCGGTGAGCGTGGATCTCGCGGTATCATTGCAGCACTGGGGCCAGATGGTAAGCCCTCCCGTATCGTAGTTATCTACACGACGGGGAGTCAGGCAACTATGGA
563	gb|KJ584915.1|+|0-825|ARO:3001597|OXA-406	ATGAACATTAAAGCACTCTTACTTATAACAAGCGCTATTTTTATTTCAGCCTGC...TAG	825.0	54149	54919	770	825	ATGAACATTAAAGCACTCTTACTTATAACAAGCGCTATTTTTATTTCAGCCTGCTCACCTTATATAGTGACTGCTAATCCAAATCACAGCGCTTCAAAATCTGATGTAAAAGCAGAGAAAATTAAAAATTTATTTAACGAAGCACACACTACGGGTGTTTTAGTTATCCAACAAGGCCAAACTCAACAAAGCTATGGTAATGATCTTGCTCGTGCTTCGACCGAGTATGTACCTGCTTCGACCTTCAAAATGCTTAATGCTTTGATCGGCCTTGAGCACCATAAGGCAACCACCACAGAAGTATTTAAGTGGGATGGTAAAAAAAGGTTATTCCCAGAATGGGAAAAGGACATGACCCTAGGCGATGCCATGAAAGCTTCCGCTATTCCAGTTTATCAAGATTTAGCTCGTCGTATTGGACTTGAGCTCATGTCTAAGGAAGTGAAGCGTGTTGGTTATGGCAATGCAGATATCGGTACCCAAGTCGATAATTTTTGGCTGGTGGGTCCTTTAAAAATTACTCCTCAGCAAGAGGCACAGTTTGCTTACAAGCTAGCTAATAAAACGCTTCCATTTAGCCAAAAAGTCCAAGATGAAGTGCAATCCATGCTATTCATAGAAGAAAAGAATGGAAACAAAATATACGCAAAAAGTGGTTGGGGATGGGATGTAAACCCACAAGTAGGCTGGTTAACTGGATGGGTTGTTCAGCCTCAAGGGAATATTGTAGCGTTCTCCCTTAACTTAGAAATGAAAAAAGGAATACCTAG
564	gb|KM555152|+|0-657|ARO:3003193|QnrVC7	ATGGATAAAACAGACCAGTTATATGTACAAGCTGACTTTTCACATCAAGACTTG...TAA	657.0	292	894	602	657	ATGGATAAAACAGACCAGTTATATGTACAAGCAGACTTTTCACATCAAGACATGAGTGGTCAGTATTTTAAAAATTGCAAATTTTTCTGCTGTTCCTTTAAACGAGCAAACCTCCGCGATACACAATTTGTAGACTGTTCTTTCATTGAACGAGGTGAATTAGAGGGGTGTGATTTTTCTTACTCGGATCTTAGAGATGCATCTTTTAAAAACTGCAGTCTTTCAATGTCGTATTTCAAAGGTGCAAATTGTTTTGGTATCGAGTTCAGAGAATGCGATTTAAAGGGTGCCAATTTTGCTCAAGCTAGCTTCATGAATCAGGTATCGAACAGAATGTATTTTTGTTCAGCTTATATAACAGGTTGTAATCTTTCATACGCCAACTTTGAAAGGCAGTGTATCGAAAAGTGTGATTTGTTTGAGAACAGATGGATTGGTGCAAATCTAAGTGGGGCATCATTTAAAGAGTCTGATTTAAGTCGGGGAGTATTTTCTGAAGGGTGTTGGAGCCAGTGTAGGTTGCAAGGTTGTGATTTGAGCCACTCGGACTTGTATGGTTTAGACCCTCGGAAAGTTGACCTTACAGGTGTAAAAATCTGTTC
565	gb|AE004091.2|+|3982020-3984009|ARO:3002985|arnA	ATGACCTCGAAAGCCGTCGTCTTCGCCTACCACGACATCGGTTGCACCGGTATC...TGA	1989.0	295	2229	1934	1989	ATGACCTCGAAAGCCGTCGTCTTCGCCTACCACGACATCGGTTGCACCGGTATCGAAGCCCTGCTCAATGCCGGCTACGAGATCGCCGCCGTCTTCACCCATGCCGACGACCCACGGGAAAACACCTTCTACGCCTCGGTCGCACGCCTCTGTGCCGAGCGCGGCATTCCGCTGCACGCGCCCGAGGACGTGAACCATCCGCTGTGGCTGGAGCGCATCCGCCAACTGCGCCCGGACTTCCTGTTCTCCTTCTACTACCGCCGCCTGCTCGGCGCCGAGCTGCTCGCCTGCGCCGCACGCGGCGCCTACAACCTGCACGGTTCGCTGCTGCCGCGCTACCGCGGACGCGCCCCGGCGAACTGGGTGCTGGTCAACGGCGAAACGCAGACCGGGGTGACCCTGCATCGCATGATCGAGCGCGCCGACGCCGGGCCGATCCTCGCCCAGCAGGCCGTCGCCATCGACCCCGAGGACACCGCCCTGAGCCTGCACGGCAAGCTGCGCAAGGCCGCCGGCGCCCTGCTGCGCGACAGCCTGCCGCTGCTCGCCCTCGGCGTGCTGCCGGAAGTCGAGCAGGACGAGAGCCAGGCCAGCCACTTCGGCCGGCGCACCCCGGCGGACGGCCTGCTCGACTGGCACAGGCCGGCACGGCAGTTGTACGACCTGGTGCGCGCGGTGACCCAGCCCTACCCTGGCGCCTTCTGCCAGGTCGGCGAACAGAAGCTGATCGTCTGGAGCGCCGAGGTGGTCGCCGGCAACCACGGTCGCGAGCCGGGCAGCGTACTGTCCTGCGACCCGCTGCGGATCGCCTGCGGCGAGGACTCGCTGGTGCTGCGCTTCGGCCAGCGCGGCGAGCGCGGCCTGTACCTGGCCGGCACGCAACTGGCCACCGAGCTGGGCCTGGTCGAGGGCGCGCGCCTGCGTGGCGCGGCGTCCGGCCCGCAGCGCCGCACGCGGGTGCTGATCCTCGGGGTCAACGGCTTCATCGGCAACCACCTGTCCGAACGCCTGCTGCGCGACGGGCGCTACGAGGTCCACGGCATGGACATCGGCTCCGACGCCATCGAACGGCTCAAGGCCGACCCGCATTTCCACTTCGTCGAAGGCGACATCGGCATCCATTCGGAGTGGCTCGAATACCATGTGAAGAAATGCGACGTGGTCCTGCCGCTGGTGGCCATCGCCACGCCCATCGAGTACACGCGCAACCCGCTGCGGGTGTTCGAACTGGACTTCGAGGAAAACCTGCGGATCGTCCGCTACTGCGTGAAATACGGCAAACGCGTGGTGTTCCCTTCCACCTCCGAGGTCTACGGCATGTGCCAGGACCCGGACTTCGACGAAGACCGCTCGAATCTGGTGGTCGGGCCGATCAACAAGCAGCGCTGGATCTACTCGGTGTCCAAGCAGTTGCTCGACCGGGTGATCTGGGCCTACGGCCAGCAGGGCCTGCGCTTCACCCTGTTCCGTCCGTTCAACTGGATGGGCCCGCGCCTGGACCGCCTGGATTCGGCGCGGATCGGCAGCTCGCGGGCGATCACCCAGCTCATCCTGCACCTGGTCGAAGGCACGCCGATCCGCCTGGTCGACGGCGGCGCGCAGAAGCGCTGCTTCACCGACGTCGACGACGGCATCGAGGCCCTCGCGCGGATCATCGACAACCGCGACGGCCGCTGCGACGGGCAGATCGTCAACATCGGCAACCCGGACAACGAGGCGAGCATCCGCCAGCTCGGCGAGGAACTGCTGCGCCAGTTCGAGGCCCACCCGCTGCGCGCGCAGTTCCCGCCCTTCGCCGGCTTCCGCGAGGTGGAGAGCCGCAGCTTCTACGGCGACGGCTACCAGGACGTGGCCCACCGCAAGCCGAGCATCGACAACGCCCGGCGCCTGCTCGACTGGCAGCCCACCATCGAACTGCGCGAGACCATCGGCAA
566	gb|AM183304|+|208-1069|ARO:3001017|TEM-150	ATGAGTATTCAACATTTCCGTGTCGCCCTTATTCCCTTTTTTGCGGCATTTTGC...TAA	861.0	46	852	806	861	ATGAGTATTCAACATTTCCGTGTCGCCCTTATTCCCTTTTTTGCGGCATTTTGCCTTCCTGTTTTTGCTCACCCAGAAACGCTGGTGAAAGTAAAAGATGCTGAAGATCAGTTGGGTGCACGAGTGGGTTACATCGAGCTGGATCTCAACAGCGGTAAGATCCTTGAGAGTTTTCGCCCCGAAGAACGTTTTCCAATGATGAGCACTTTTAAAGTTCTGCTATGTGGTGCGGTATTATCCCGTGTTGACGCCGGGCAAGAGCAACTCGGTCGCCGCATACACTATTCTCAGAATGACTTGGTTGAGTACTCACCAGTCACAGAAAAGCATCTTACGGATGGCATGACAGTAAGAGAATTATGCAGTGCTGCCATAACCATGAGTGATAACACTGCGGCCAACTTACTTCTGACAACGATCGGAGGACCGAAGGAGCTAACCGCTTTTTTGCACAACATGGGGGATCATGTAACCCGCCTTGATCGTTGGGAACCGGAGCTGAATGAAGCCATACCAAACGACGAGCGTGACACCACGATGCCTGCAGCAATGGCAACAACGTTGCGCAAACTATTAACTGGCGAACTACTTACTCTAGCTTCCCGGCAACAATTAATAGACTGGATGGAGGCGGATAAAGTTGCAGGACCACTTCTGCGCTCGGCCCTTCCGGCTGGCTGGTTTATTGCTGATAAATCTGGAGCCGGTGAGCGTGGATCTCGCGGTATCATTGCAGCACTGGGGCCAGATGGTAAGCCCTCCCGTATCGTAGTTATCTACACGACGGGGAGTCAGGCAACTATGGA
567	gb|AF190693|+|208-1069|ARO:3000944|TEM-78	ATGAGTATTCAACATTTCCGTGTCGCCCTTATTCCCTTTTTTGCGGCATTTTGC...TAA	861.0	46	852	806	861	ATGAGTATTCAACATTTCCGTGTCGCCCTTATTCCCTTTTTTGCGGCATTTTGCCTTCCTGTTTTTGCTCACCCAGAAACGCTGGTGAAAGTAAAAGATGCTGAAGATCAGTTGGGTGCACGAGTGGGTTACATCGAGCTGGATCTCAACAGCGGTAAGATCCTTGAGAGTTTTCGCCCCGAAGAACGTTTTCCAATGATGAGCACTTTTAAAGTTCTGCTATGTGGTGCGGTATTATCCCGTGTTGACGCCGGGCAAGAGCAACTCGGTCGCCGCATACACTATTCTCAGAATGACTTGGTTGAGTACTCACCAGTCACAGAAAAGCATCTTACGGATGGCATGACAGTAAGAGAATTATGCAGTGCTGCCATAACCATGAGTGATAACACTGCGGCCAACTTACTTCTGACAACGATCGGAGGACCGAAGGAGCTAACCGCTTTTTTGCACAACATGGGGGATCATGTAACCCGCCTTGATCGTTGGGAACCGGAGCTGAATGAAGCCATACCAAACGACGAGCGTGACACCACGATGCCTGCAGCAATGGCAACAACGTTGCGCAAACTATTAACTGGCGAACTACTTACTCTAGCTTCCCGGCAACAATTAATAGACTGGATGGAGGCGGATAAAGTTGCAGGACCACTTCTGCGCTCGGCCCTTCCGGCTGGCTGGTTTATTGCTGATAAATCTGGAGCCGGTGAGCGTGGATCTCGCGGTATCATTGCAGCACTGGGGCCAGATGGTAAGCCCTCCCGTATCGTAGTTATCTACACGACGGGGAGTCAGGCAACTATGGA
568	gb|JN935137|+|0-861|ARO:3001055|TEM-195	ATGAGTATTCAACATTTCCGTGTCGCCCTTATTCCCTTTTTTGCGGCATTTTGC...TAA	861.0	46	852	806	861	ATGAGTATTCAACATTTCCGTGTCGCCCTTATTCCCTTTTTTGCGGCATTTTGCCTTCCTGTTTTTGCTCACCCAGAAACGCTGGTGAAAGTAAAAGATGCTGAAGATCAGTTGGGTGCACGAGTGGGTTACATCGAGCTGGATCTCAACAGCGGTAAGATCCTTGAGAGTTTTCGCCCCGAAGAACGTTTTCCAATGATGAGCACTTTTAAAGTTCTGCTATGTGGTGCGGTATTATCCCGTGTTGACGCCGGGCAAGAGCAACTCGGTCGCCGCATACACTATTCTCAGAATGACTTGGTTGAGTACTCACCAGTCACAGAAAAGCATCTTACGGATGGCATGACAGTAAGAGAATTATGCAGTGCTGCCATAACCATGAGTGATAACACTGCGGCCAACTTACTTCTGACAACGATCGGAGGACCGAAGGAGCTAACCGCTTTTTTGCACAACATGGGGGATCATGTAACCCGCCTTGATCGTTGGGAACCGGAGCTGAATGAAGCCATACCAAACGACGAGCGTGACACCACGATGCCTGCAGCAATGGCAACAACGTTGCGCAAACTATTAACTGGCGAACTACTTACTCTAGCTTCCCGGCAACAATTAATAGACTGGATGGAGGCGGATAAAGTTGCAGGACCACTTCTGCGCTCGGCCCTTCCGGCTGGCTGGTTTATTGCTGATAAATCTGGAGCCGGTGAGCGTGGATCTCGCGGTATCATTGCAGCACTGGGGCCAGATGGTAAGCCCTCCCGTATCGTAGTTATCTACACGACGGGGAGTCAGGCAACTATGGA
569	gb|V00618.1|+|150-945|ARO:3002644|APH(3')-IIa	ATGATTGAACAAGATGGATTGCACGCAGGTTCTCCGGCCGCTTGGGTGGAGAGG...TGA	795.0	15	536	521	795	ATGATTGAACAAGATGGATTGCACGCAGGTTCTCCGGCCGCTTGGGTGGAGAGGCTATTCGGCTATGACTGGGCACAACAGACAATCGGCTGCTCTGATGCCGCCGTGTTCCGGCTGTCAGCGCAGGGGCGCCCGGTTCTTTTTGTCAAGACCGACCTGTCCGGTGCCCTGAATGAACTGCAAGACGAGGCAGCGCGGCTATCGTGGCTGGCCACGACGGGCGTTCCTTGCGCAGCTGTGCTCGACGTTGTCACTGAAGCGGGAAGGGACTGGCTGCTATTGGGCGAAGTGCCGGGGCAGGATCTCCTGTCATCTCACCTTGCTCCTGCCGAGAAAGTATCCATCATGGCTGATGCAATGCGGCGGCTGCATACGCTTGATCCGGCTACCTGCCCATTCGACCACCAAGCGAAACATCGCATCGAGCGAGCACGTACTCGGATGGAAGCCGGTCTTGTCGATCAGGATGATCTGGACGAAGAGCATCAGGGGCTCGCGCCAGCCGAACTGTTCGCCAGGCT
570	gb|FJ668814|+|76-937|ARO:3001059|SHV-1	ATGCGTTATATTCGCCTGTGTATTATCTCCCTGTTAGCCACCCTGCCGCTGGCG...TAA	861.0	16	822	806	861	ATGCGTTATATTCGCCTGTGTATTATCACCCTGTGAGCCACCCTGCCGCTGGCGGTACACGCCAGCCCGCAGCCGCTTGAGCAAATTAAACAAAGCGAAAGCCAGCTGTCGGGCCGCGTAGGCATGATAGAAATGGATCTGGCCAGCGGCCGCACGCTGACCGCCTGGCGCGCCGATGAACGCTTTCCCATGATGAGCACCTTTAAAGTAGTGCTCTGCGGCGCAGTGCTGGCGCGGGTGGATGCCGGTGACGAACAGCTGGAGCGAAAGATCCACTATCGCCAGCAGGATCTGGTGGACTACTCGCCGGTCAGCGAAAAACACCTTGCCGACGGCATGACGGTCGGCGAACTCTGCGCCGCCGCCATTACCATGAGCGATAACAGCGCCGCCAATCTGCTGCTGGCCACCGTCGGCGGCCCCGCAGGATTGACTGCCTTTTTGCGCCAGATCGGCGACAACGTCACCCGCCTTGACCGCTGGGAAACGGAACTGAATGAGGCGCTTCCCGGCGACGCCCGCGACACCACTACCCCGGCCAGCATGGCCGCGACCCTGCGCAAGCTGCTGACCAGCCAGCGTCTGAGCGCCCGTTCGCAACGGCAGCTGCTGCAGTGGATGGTGGACGATCGGGTCGCCGGACCGTTGATCCGCTCCGTGCTGCCGGCGGGCTGGTTTATCGCCGATAAGACCGGAGCTAGCAAGCGGGGTGCGCGCGGGATTGTCGCCCTGCTTGGCCCGAATAACAAAGCAGAGCGCATTGTGGTGATTTATCTGCGGGATACGCCGGCGAGCATGGCCGAGCG
571	gb|DQ834729|+|205-1066|ARO:3001018|TEM-151	ATGAGTATTCAACATTTCCGTGTCGCCCTTATTCCCTTTTTTGCGGCATTTTGC...TAA	861.0	46	852	806	861	ATGAGTATTCAACATTTCCGTGTCGCCCTTATTCCCTTTTTTGCGGCATTTTGCCTTCCTGTTTTTGCTCACCCAGAAACGCTGGTGAAAGTAAAAGATGCTGAAGATCAGTTGGGTGCACGAGTGGGTTACATCGAGCTGGATCTCAACAGCGGTAAGATCCTTGAGAGTTTTCGCCCCGAAGAACGTTTTCCAATGATGAGCACTTTTAAAGTTCTGCTATGTGGTGCGGTATTATCCCGTGTTGACGCCGGGCAAGAGCAACTCGGTCGCCGCATACACTATTCTCAGAATGACTTGGTTGAGTACTCACCAGTCACAGAAAAGCATCTTACGGATGGCATGACAGTAAGAGAATTATGCAGTGCTGCCATAACCATGAGTGATAACACTGCGGCCAACTTACTTCTGACAACGATCGGAGGACCGAAGGAGCTAACCGCTTTTTTGCACAACATGGGGGATCATGTAACCCGCCTTGATCGTTGGGAACCGGAGCTGAATGAAGCCATACCAAACGACGAGCGTGACACCACGATGCCTGCAGCAATGGCAACAACGTTGCGCAAACTATTAACTGGCGAACTACTTACTCTAGCTTCCCGGCAACAATTAATAGACTGGATGGAGGCGGATAAAGTTGCAGGACCACTTCTGCGCTCGGCCCTTCCGGCTGGCTGGTTTATTGCTGATAAATCTGGAGCCGGTGAGCGTGGATCTCGCGGTATCATTGCAGCACTGGGGCCAGATGGTAAGCCCTCCCGTATCGTAGTTATCTACACGACGGGGAGTCAGGCAACTATGGA
572	gb|DQ834728|+|205-1066|ARO:3001019|TEM-152	ATGAGTATTCAACATTTCCGTGTCGCCCTTATTCCCTTTTTTGCGGCATTTTGC...TAA	861.0	46	852	806	861	ATGAGTATTCAACATTTCCGTGTCGCCCTTATTCCCTTTTTTGCGGCATTTTGCCTTCCTGTTTTTGCTCACCCAGAAACGCTGGTGAAAGTAAAAGATGCTGAAGATCAGTTGGGTGCACGAGTGGGTTACATCGAGCTGGATCTCAACAGCGGTAAGATCCTTGAGAGTTTTCGCCCCGAAGAACGTTTTCCAATGATGAGCACTTTTAAAGTTCTGCTATGTGGTGCGGTATTATCCCGTGTTGACGCCGGGCAAGAGCAACTCGGTCGCCGCATACACTATTCTCAGAATGACTTGGTTGAGTACTCACCAGTCACAGAAAAGCATCTTACGGATGGCATGACAGTAAGAGAATTATGCAGTGCTGCCATAACCATGAGTGATAACACTGCGGCCAACTTACTTCTGACAACGATCGGAGGACCGAAGGAGCTAACCGCTTTTTTGCACAACATGGGGGATCATGTAACCCGCCTTGATCGTTGGGAACCGGAGCTGAATGAAGCCATACCAAACGACGAGCGTGACACCACGATGCCTGCAGCAATGGCAACAACGTTGCGCAAACTATTAACTGGCGAACTACTTACTCTAGCTTCCCGGCAACAATTAATAGACTGGATGGAGGCGGATAAAGTTGCAGGACCACTTCTGCGCTCGGCCCTTCCGGCTGGCTGGTTTATTGCTGATAAATCTGGAGCCGGTGAGCGTGGATCTCGCGGTATCATTGCAGCACTGGGGCCAGATGGTAAGCCCTCCCGTATCGTAGTTATCTACACGACGGGGAGTCAGGCAACTATGGA
573	gb|U00096.3|-|3203309-3204131|ARO:3002986|bacA	ATGAGCGATATGCACTCGCTGCTGATAGCGGCAATATTGGGTGTGGTCGAAGGA...TAA	822.0	2132	2897	765	822	ATGAGCGATATGCACTCGCTGCTGATAGCGGCAATATTGGGTGTGGTCGAAGGATTGACAGAATTTCTGCCGGTATCCAGCACGGGCCATATGATTATTGTCGGTCACTTGTTGGGGTTCGAGGGCGACACGGCGAAAACCTTTGAAGTTGTGATCCAGTTAGGATCAATTCTGGCGGTAGTAGTGATGTTCTGGCGGCGTCTGTTTGGCCTGATTGGCATCCACTTTGGCCGCCCGTTGCAGCACGAAGGAGAAAGCAAAGGTCGTTTAACGCTGATCCACATTTTGCTGGGGATGATTCCGGCGGTGGTACTGGGGCTGTTGTTCCACGACACGATTAAGTCATTGTTTAACCCGATAAATGTGATGTATGCACTGGTCGTTGGCGGTTTGTTGCTGATTGCCGCCGAATGCCTGAAGCCGAAAGAGCCGCGTGCGCCGGGTCTTGATGATATGACCTATCGTCAGGCGTTTATGATTGGCTGTTTCCAGTGTCTGGCGCTGTGGCCGGGTTTCTCCCGTTCCGGGGCCACCATTTCAGGTGGGATGCTGATGGGCGTGAGCCGTTACGCTGCTTCCGAGTTCTCGTTCCTGCTGGCGGTACCGATGATGATGGGCGCAACGGCGCTCGATCTCTACAAAAGCTGGGGCTTCCTGACAACCGGCGATATCCCGATGTTTGCCGTTGGGTTTATCACCGCTTTTGTGGTGGCGCTGATAGCGATTAAAACCTTCCTGCAATTGATTAAGCGCATTTCGTTTATC
574	gb|AF190692|+|208-1069|ARO:3000946|TEM-79	ATGAGTATTCAACATTTTCGTGTCGCCCTTATTCCCTTTTTTGCGGCATTTTGC...TAA	861.0	46	852	806	861	ATGAGTATTCAACATTTCCGTGTCGCCCTTATTCCCTTTTTTGCGGCATTTTGCCTTCCTGTTTTTGCTCACCCAGAAACGCTGGTGAAAGTAAAAGATGCTGAAGATCAGTTGGGTGCACGAGTGGGTTACATCGAGCTGGATCTCAACAGCGGTAAGATCCTTGAGAGTTTTCGCCCCGAAGAACGTTTTCCAATGATGAGCACTTTTAAAGTTCTGCTATGTGGTGCGGTATTATCCCGTGTTGACGCCGGGCAAGAGCAACTCGGTCGCCGCATACACTATTCTCAGAATGACTTGGTTGAGTACTCACCAGTCACAGAAAAGCATCTTACGGATGGCATGACAGTAAGAGAATTATGCAGTGCTGCCATAACCATGAGTGATAACACTGCGGCCAACTTACTTCTGACAACGATCGGAGGACCGAAGGAGCTAACCGCTTTTTTGCACAACATGGGGGATCATGTAACCCGCCTTGATCGTTGGGAACCGGAGCTGAATGAAGCCATACCAAACGACGAGCGTGACACCACGATGCCTGCAGCAATGGCAACAACGTTGCGCAAACTATTAACTGGCGAACTACTTACTCTAGCTTCCCGGCAACAATTAATAGACTGGATGGAGGCGGATAAAGTTGCAGGACCACTTCTGCGCTCGGCCCTTCCGGCTGGCTGGTTTATTGCTGATAAATCTGGAGCCGGTGAGCGTGGATCTCGCGGTATCATTGCAGCACTGGGGCCAGATGGTAAGCCCTCCCGTATCGTAGTTATCTACACGACGGGGAGTCAGGCAACTATGGA
575	gb|JQ034306|+|0-861|ARO:3001376|TEM-196	ATGAGTATTCAACATTTTCGTGTCGCCCTTATTCCCTTTTTTGCGGCATTTTGC...TAA	861.0	46	852	806	861	ATGAGTATTCAACATTTCCGTGTCGCCCTTATTCCCTTTTTTGCGGCATTTTGCCTTCCTGTTTTTGCTCACCCAGAAACGCTGGTGAAAGTAAAAGATGCTGAAGATCAGTTGGGTGCACGAGTGGGTTACATCGAGCTGGATCTCAACAGCGGTAAGATCCTTGAGAGTTTTCGCCCCGAAGAACGTTTTCCAATGATGAGCACTTTTAAAGTTCTGCTATGTGGTGCGGTATTATCCCGTGTTGACGCCGGGCAAGAGCAACTCGGTCGCCGCATACACTATTCTCAGAATGACTTGGTTGAGTACTCACCAGTCACAGAAAAGCATCTTACGGATGGCATGACAGTAAGAGAATTATGCAGTGCTGCCATAACCATGAGTGATAACACTGCGGCCAACTTACTTCTGACAACGATCGGAGGACCGAAGGAGCTAACCGCTTTTTTGCACAACATGGGGGATCATGTAACCCGCCTTGATCGTTGGGAACCGGAGCTGAATGAAGCCATACCAAACGACGAGCGTGACACCACGATGCCTGCAGCAATGGCAACAACGTTGCGCAAACTATTAACTGGCGAACTACTTACTCTAGCTTCCCGGCAACAATTAATAGACTGGATGGAGGCGGATAAAGTTGCAGGACCACTTCTGCGCTCGGCCCTTCCGGCTGGCTGGTTTATTGCTGATAAATCTGGAGCCGGTGAGCGTGGATCTCGCGGTATCATTGCAGCACTGGGGCCAGATGGTAAGCCCTCCCGTATCGTAGTTATCTACACGACGGGGAGTCAGGCAACTATGGA
576	gb|U00096|-|2098446-2099613|ARO:3003577|ugd	ATGAAAATCACCATTTCCGGTACTGGCTATGTAGGCTTGTCAAACGGGCTTCTA...TAA	1167.0	71,0	584,364	513;364	1167	ATGAAAATCACCATTTCCGGTACTGGCTATGTCGGCTTGTCAAACGGGCTTCTAATCGCACAAAATCATGAGGTTGTGGCATTAGATATTTTACCGTCACGCGTTGCTATGCTGAATGATCGGATATCTCCTATTGTTGATAAGGAAATTCAGCAGTTTTTGCAATCAGATAAAATACACTTTAATGCCACATTAGATAAAAATGAAGCCTATCGGGATGCTGATTACGTCATCATCGCCACTCCAACCGACTATGATCCTAAAACTAATTATTTCAATACATCGAGTGTAGAATCAGTAATTAAAGACGTAGTTGAGATAAATCCTTATGCGGTTATGGTGATCAAATCAACGGTTCCCGTTGGTTTTACCGCAGCGATGCATAAGAAATATCGCACTGAAAATATTATATTCTCCCCGGAATTTCTCCGTGAGGGTAAAGCCCTTTACGATAATCTCCATCCTTCACGTATTGTCATCGGTGAGCGTTCAGAACGCGCAGAACGTTTTGCT;GACCCACGTATTGGCAACCATTACAACAATCCGTCGTTTGGTTATGGTGGTTATTGTCTGCCGAAAGATACTAAGCAGTTACTGGCGAACTACCAGTCTGTGCCGAATAACCTGATCTCGGCAATTGTCGATGCAAACCGCAAGTGGTGGGTATTTATCGTCTGATTATGAAGAGCGGTTCAGACAACTTCCGCGCGTCTTCCATTCAGGGGATTATGAAACGTATCAAGGCGAAAGGCGTTGAAGTGATCATTTACGAGCCGGTGATGAAAGAAGACTCATTCTTCAACTCTCGCCTGGAACGTGATCTCGCCACTTTCAAACAACAAGCCGATGTCATTATTTCCAACCGTATGGCAGAAGA
577	gb|KJ584916.1|+|0-825|ARO:3001598|OXA-407	ATGAACATTAAAACACTCTTACTTATAACAAGCGCTATTTTTATTTCAGCCTGC...TAG	825.0	54149	54919	770	825	ATGAACATTAAAGCACTCTTACTTATAACAAGCGCTATTTTTATTTCAGCCTGCTCACCTTATATAGTGACTGCTAATCCAAATCACAGCGCTTCAAAATCTGATGTAAAAGCAGAGAAAATTAAAAATTTATTTAACGAAGCACACACTACGGGTGTTTTAGTTATCCAACAAGGCCAAACTCAACAAAGCTATGGTAATGATCTTGCTCGTGCTTCGACCGAGTATGTACCTGCTTCGACCTTCAAAATGCTTAATGCTTTGATCGGCCTTGAGCACCATAAGGCAACCACCACAGAAGTATTTAAGTGGGATGGTAAAAAAAGGTTATTCCCAGAATGGGAAAAGGACATGACCCTAGGCGATGCCATGAAAGCTTCCGCTATTCCAGTTTATCAAGATTTAGCTCGTCGTATTGGACTTGAGCTCATGTCTAAGGAAGTGAAGCGTGTTGGTTATGGCAATGCAGATATCGGTACCCAAGTCGATAATTTTTGGCTGGTGGGTCCTTTAAAAATTACTCCTCAGCAAGAGGCACAGTTTGCTTACAAGCTAGCTAATAAAACGCTTCCATTTAGCCAAAAAGTCCAAGATGAAGTGCAATCCATGCTATTCATAGAAGAAAAGAATGGAAACAAAATATACGCAAAAAGTGGTTGGGGATGGGATGTAAACCCACAAGTAGGCTGGTTAACTGGATGGGTTGTTCAGCCTCAAGGGAATATTGTAGCGTTCTCCCTTAACTTAGAAATGAAAAAAGGAATACCTAG
578	gb|KC149518|+|0-861|ARO:3001369|TEM-153	ATGAGTATTCAACATTTCCGTGTCGCCCTTATTCCCTTTTTTGCGGCATTTTGC...TAA	861.0	46	852	806	861	ATGAGTATTCAACATTTCCGTGTCGCCCTTATTCCCTTTTTTGCGGCATTTTGCCTTCCTGTTTTTGCTCACCCAGAAACGCTGGTGAAAGTAAAAGATGCTGAAGATCAGTTGGGTGCACGAGTGGGTTACATCGAGCTGGATCTCAACAGCGGTAAGATCCTTGAGAGTTTTCGCCCCGAAGAACGTTTTCCAATGATGAGCACTTTTAAAGTTCTGCTATGTGGTGCGGTATTATCCCGTGTTGACGCCGGGCAAGAGCAACTCGGTCGCCGCATACACTATTCTCAGAATGACTTGGTTGAGTACTCACCAGTCACAGAAAAGCATCTTACGGATGGCATGACAGTAAGAGAATTATGCAGTGCTGCCATAACCATGAGTGATAACACTGCGGCCAACTTACTTCTGACAACGATCGGAGGACCGAAGGAGCTAACCGCTTTTTTGCACAACATGGGGGATCATGTAACCCGCCTTGATCGTTGGGAACCGGAGCTGAATGAAGCCATACCAAACGACGAGCGTGACACCACGATGCCTGCAGCAATGGCAACAACGTTGCGCAAACTATTAACTGGCGAACTACTTACTCTAGCTTCCCGGCAACAATTAATAGACTGGATGGAGGCGGATAAAGTTGCAGGACCACTTCTGCGCTCGGCCCTTCCGGCTGGCTGGTTTATTGCTGATAAATCTGGAGCCGGTGAGCGTGGATCTCGCGGTATCATTGCAGCACTGGGGCCAGATGGTAAGCCCTCCCGTATCGTAGTTATCTACACGACGGGGAGTCAGGCAACTATGGA
579	gb|HQ877606|+|0-861|ARO:3001056|TEM-197	ATGAGTATTCAACATTTCCGTGTCGCCCTTATTCCCTTTTTTGCGGCATTTTGC...TAA	861.0	46	852	806	861	ATGAGTATTCAACATTTCCGTGTCGCCCTTATTCCCTTTTTTGCGGCATTTTGCCTTCCTGTTTTTGCTCACCCAGAAACGCTGGTGAAAGTAAAAGATGCTGAAGATCAGTTGGGTGCACGAGTGGGTTACATCGAGCTGGATCTCAACAGCGGTAAGATCCTTGAGAGTTTTCGCCCCGAAGAACGTTTTCCAATGATGAGCACTTTTAAAGTTCTGCTATGTGGTGCGGTATTATCCCGTGTTGACGCCGGGCAAGAGCAACTCGGTCGCCGCATACACTATTCTCAGAATGACTTGGTTGAGTACTCACCAGTCACAGAAAAGCATCTTACGGATGGCATGACAGTAAGAGAATTATGCAGTGCTGCCATAACCATGAGTGATAACACTGCGGCCAACTTACTTCTGACAACGATCGGAGGACCGAAGGAGCTAACCGCTTTTTTGCACAACATGGGGGATCATGTAACCCGCCTTGATCGTTGGGAACCGGAGCTGAATGAAGCCATACCAAACGACGAGCGTGACACCACGATGCCTGCAGCAATGGCAACAACGTTGCGCAAACTATTAACTGGCGAACTACTTACTCTAGCTTCCCGGCAACAATTAATAGACTGGATGGAGGCGGATAAAGTTGCAGGACCACTTCTGCGCTCGGCCCTTCCGGCTGGCTGGTTTATTGCTGATAAATCTGGAGCCGGTGAGCGTGGATCTCGCGGTATCATTGCAGCACTGGGGCCAGATGGTAAGCCCTCCCGTATCGTAGTTATCTACACGACGGGGAGTCAGGCAACTATGGA
580	gb|EU155018|+|0-861|ARO:3001150|SHV-101	ATGCGTTATATTCGCCTGTGTATTATCTCCCTGTTAGCCACCCTGCCGCTGGCG...TAA	861.0	16	822	806	861	ATGCGTTATATTCGCCTGTGTATTATCACCCTGTGAGCCACCCTGCCGCTGGCGGTACACGCCAGCCCGCAGCCGCTTGAGCAAATTAAACAAAGCGAAAGCCAGCTGTCGGGCCGCGTAGGCATGATAGAAATGGATCTGGCCAGCGGCCGCACGCTGACCGCCTGGCGCGCCGATGAACGCTTTCCCATGATGAGCACCTTTAAAGTAGTGCTCTGCGGCGCAGTGCTGGCGCGGGTGGATGCCGGTGACGAACAGCTGGAGCGAAAGATCCACTATCGCCAGCAGGATCTGGTGGACTACTCGCCGGTCAGCGAAAAACACCTTGCCGACGGCATGACGGTCGGCGAACTCTGCGCCGCCGCCATTACCATGAGCGATAACAGCGCCGCCAATCTGCTGCTGGCCACCGTCGGCGGCCCCGCAGGATTGACTGCCTTTTTGCGCCAGATCGGCGACAACGTCACCCGCCTTGACCGCTGGGAAACGGAACTGAATGAGGCGCTTCCCGGCGACGCCCGCGACACCACTACCCCGGCCAGCATGGCCGCGACCCTGCGCAAGCTGCTGACCAGCCAGCGTCTGAGCGCCCGTTCGCAACGGCAGCTGCTGCAGTGGATGGTGGACGATCGGGTCGCCGGACCGTTGATCCGCTCCGTGCTGCCGGCGGGCTGGTTTATCGCCGATAAGACCGGAGCTAGCAAGCGGGGTGCGCGCGGGATTGTCGCCCTGCTTGGCCCGAATAACAAAGCAGAGCGCATTGTGGTGATTTATCTGCGGGATACGCCGGCGAGCATGGCCGAGCG
581	gb|FJ807656|+|0-861|ARO:3001020|TEM-154	ATGAGTATTCAACATTTCCGTGTCGCCCTTATTCCCTTTTTTGCGGCATTTTGC...TAA	861.0	46	852	806	861	ATGAGTATTCAACATTTCCGTGTCGCCCTTATTCCCTTTTTTGCGGCATTTTGCCTTCCTGTTTTTGCTCACCCAGAAACGCTGGTGAAAGTAAAAGATGCTGAAGATCAGTTGGGTGCACGAGTGGGTTACATCGAGCTGGATCTCAACAGCGGTAAGATCCTTGAGAGTTTTCGCCCCGAAGAACGTTTTCCAATGATGAGCACTTTTAAAGTTCTGCTATGTGGTGCGGTATTATCCCGTGTTGACGCCGGGCAAGAGCAACTCGGTCGCCGCATACACTATTCTCAGAATGACTTGGTTGAGTACTCACCAGTCACAGAAAAGCATCTTACGGATGGCATGACAGTAAGAGAATTATGCAGTGCTGCCATAACCATGAGTGATAACACTGCGGCCAACTTACTTCTGACAACGATCGGAGGACCGAAGGAGCTAACCGCTTTTTTGCACAACATGGGGGATCATGTAACCCGCCTTGATCGTTGGGAACCGGAGCTGAATGAAGCCATACCAAACGACGAGCGTGACACCACGATGCCTGCAGCAATGGCAACAACGTTGCGCAAACTATTAACTGGCGAACTACTTACTCTAGCTTCCCGGCAACAATTAATAGACTGGATGGAGGCGGATAAAGTTGCAGGACCACTTCTGCGCTCGGCCCTTCCGGCTGGCTGGTTTATTGCTGATAAATCTGGAGCCGGTGAGCGTGGATCTCGCGGTATCATTGCAGCACTGGGGCCAGATGGTAAGCCCTCCCGTATCGTAGTTATCTACACGACGGGGAGTCAGGCAACTATGGA
582	gb|X65252|+|175-1036|ARO:3000880|TEM-8	ATGAGTATTCAACATTTCCGTGTCGCCCTTATTCCCTTTTTTGCGGCATTTTGC...TAA	861.0	46	852	806	861	ATGAGTATTCAACATTTCCGTGTCGCCCTTATTCCCTTTTTTGCGGCATTTTGCCTTCCTGTTTTTGCTCACCCAGAAACGCTGGTGAAAGTAAAAGATGCTGAAGATCAGTTGGGTGCACGAGTGGGTTACATCGAGCTGGATCTCAACAGCGGTAAGATCCTTGAGAGTTTTCGCCCCGAAGAACGTTTTCCAATGATGAGCACTTTTAAAGTTCTGCTATGTGGTGCGGTATTATCCCGTGTTGACGCCGGGCAAGAGCAACTCGGTCGCCGCATACACTATTCTCAGAATGACTTGGTTGAGTACTCACCAGTCACAGAAAAGCATCTTACGGATGGCATGACAGTAAGAGAATTATGCAGTGCTGCCATAACCATGAGTGATAACACTGCGGCCAACTTACTTCTGACAACGATCGGAGGACCGAAGGAGCTAACCGCTTTTTTGCACAACATGGGGGATCATGTAACCCGCCTTGATCGTTGGGAACCGGAGCTGAATGAAGCCATACCAAACGACGAGCGTGACACCACGATGCCTGCAGCAATGGCAACAACGTTGCGCAAACTATTAACTGGCGAACTACTTACTCTAGCTTCCCGGCAACAATTAATAGACTGGATGGAGGCGGATAAAGTTGCAGGACCACTTCTGCGCTCGGCCCTTCCGGCTGGCTGGTTTATTGCTGATAAATCTGGAGCCGGTGAGCGTGGATCTCGCGGTATCATTGCAGCACTGGGGCCAGATGGTAAGCCCTCCCGTATCGTAGTTATCTACACGACGGGGAGTCAGGCAACTATGGA
583	gb|X90856|+|387-1194|ARO:3002645|APH(3')-IIb	ATGCATGATGCAGCCACCTCCATGCCGCCGCAGGCTCCCTCAACCTGGGCCGAC...TAG	807.0	6925	7677	752	807	ATGCATGATGCAGCCACCTCCATGCCGCCGCAGGCTCCCTCAACCTGGGCCGACTACCTTGCCGGCTACCGCTGGCGAGGGCAGGGCGAAGGATGTTCCGCGGCCACGGTCCACCGCCTGGAGGCTGAGCGGCGGCCGACCCTGTTCGTCAAGCAGGAAGTGCTGTCCGCACATGCCGAGCTGCCCGCCGAAATCGCCCGCCTGCGCTGGCTGCACGGTGCCGGCATCGATTGCCCGCAGGTGCTGAACGAAACCCAGAGCGACGGCCGGCAATGGCTGCTGATGAGCGCCGTGCCGGGGGACACGCTGTCCGCGCTGGCGCAGCGCGGCGAGCTGGAGCCCGAGCGCCTGGTGCGCCTGGTGGCCGCCGCCCTGCGCCGGCTGCACGATCTCGATCCGGCTGCCTGTCCCTTCGACCATCGCCTGGAACGGCGTCTGGACACCGTGCGCCAGCGGGTCGAGGCCGGGCTGGTGGACGAGGCGGACTTCGATGACGACCATCGCGGTCGCAGCGCCACGGAGCTGTACCGCCTGCTCCTCGACCGGCGTCCGGCGGTCGAAGACCTGGTGGTCGCCCACGGCGACGCCTGCCTGCCCAACCTCTTGGCGGAGGGGCGGCGCTTCAGCGGCTTCATCGATTGCGGGCGGCTCGGCGTCGCCGACCGGCACCAGGACCTGGCCCTGGCCGCGCGGGACATCGAGGCCGAACTCGGCGCGGCCTGGGCCGAGGCCTTCCTCGTCGAATACGGCGG
584	gb|DQ679961|+|114-975|ARO:3001021|TEM-155	ATGAGTATTCAACATTTCCGTGTCGCCCTTATTCCCTTTTTTGCGGCATTTTGC...TAA	861.0	46	852	806	861	ATGAGTATTCAACATTTCCGTGTCGCCCTTATTCCCTTTTTTGCGGCATTTTGCCTTCCTGTTTTTGCTCACCCAGAAACGCTGGTGAAAGTAAAAGATGCTGAAGATCAGTTGGGTGCACGAGTGGGTTACATCGAGCTGGATCTCAACAGCGGTAAGATCCTTGAGAGTTTTCGCCCCGAAGAACGTTTTCCAATGATGAGCACTTTTAAAGTTCTGCTATGTGGTGCGGTATTATCCCGTGTTGACGCCGGGCAAGAGCAACTCGGTCGCCGCATACACTATTCTCAGAATGACTTGGTTGAGTACTCACCAGTCACAGAAAAGCATCTTACGGATGGCATGACAGTAAGAGAATTATGCAGTGCTGCCATAACCATGAGTGATAACACTGCGGCCAACTTACTTCTGACAACGATCGGAGGACCGAAGGAGCTAACCGCTTTTTTGCACAACATGGGGGATCATGTAACCCGCCTTGATCGTTGGGAACCGGAGCTGAATGAAGCCATACCAAACGACGAGCGTGACACCACGATGCCTGCAGCAATGGCAACAACGTTGCGCAAACTATTAACTGGCGAACTACTTACTCTAGCTTCCCGGCAACAATTAATAGACTGGATGGAGGCGGATAAAGTTGCAGGACCACTTCTGCGCTCGGCCCTTCCGGCTGGCTGGTTTATTGCTGATAAATCTGGAGCCGGTGAGCGTGGATCTCGCGGTATCATTGCAGCACTGGGGCCAGATGGTAAGCCCTCCCGTATCGTAGTTATCTACACGACGGGGAGTCAGGCAACTATGGA
585	gb|AF347054|+|208-1069|ARO:3000947|TEM-80	ATGAGTATTCAACATTTCCGTGTCGCCCTTATTCCCTTTTTTGCGGCATTTTGC...TAA	861.0	46	852	806	861	ATGAGTATTCAACATTTCCGTGTCGCCCTTATTCCCTTTTTTGCGGCATTTTGCCTTCCTGTTTTTGCTCACCCAGAAACGCTGGTGAAAGTAAAAGATGCTGAAGATCAGTTGGGTGCACGAGTGGGTTACATCGAGCTGGATCTCAACAGCGGTAAGATCCTTGAGAGTTTTCGCCCCGAAGAACGTTTTCCAATGATGAGCACTTTTAAAGTTCTGCTATGTGGTGCGGTATTATCCCGTGTTGACGCCGGGCAAGAGCAACTCGGTCGCCGCATACACTATTCTCAGAATGACTTGGTTGAGTACTCACCAGTCACAGAAAAGCATCTTACGGATGGCATGACAGTAAGAGAATTATGCAGTGCTGCCATAACCATGAGTGATAACACTGCGGCCAACTTACTTCTGACAACGATCGGAGGACCGAAGGAGCTAACCGCTTTTTTGCACAACATGGGGGATCATGTAACCCGCCTTGATCGTTGGGAACCGGAGCTGAATGAAGCCATACCAAACGACGAGCGTGACACCACGATGCCTGCAGCAATGGCAACAACGTTGCGCAAACTATTAACTGGCGAACTACTTACTCTAGCTTCCCGGCAACAATTAATAGACTGGATGGAGGCGGATAAAGTTGCAGGACCACTTCTGCGCTCGGCCCTTCCGGCTGGCTGGTTTATTGCTGATAAATCTGGAGCCGGTGAGCGTGGATCTCGCGGTATCATTGCAGCACTGGGGCCAGATGGTAAGCCCTCCCGTATCGTAGTTATCTACACGACGGGGAGTCAGGCAACTATGGA
586	gb|KJ584917.1|+|0-825|ARO:3001599|OXA-408	ATGAACATTCAAGCCCTCTTACTTATAACAAGCGCTATTTTTATTTCAGCCTGC...TAG	825.0	54149	54919	770	825	ATGAACATTAAAGCACTCTTACTTATAACAAGCGCTATTTTTATTTCAGCCTGCTCACCTTATATAGTGACTGCTAATCCAAATCACAGCGCTTCAAAATCTGATGTAAAAGCAGAGAAAATTAAAAATTTATTTAACGAAGCACACACTACGGGTGTTTTAGTTATCCAACAAGGCCAAACTCAACAAAGCTATGGTAATGATCTTGCTCGTGCTTCGACCGAGTATGTACCTGCTTCGACCTTCAAAATGCTTAATGCTTTGATCGGCCTTGAGCACCATAAGGCAACCACCACAGAAGTATTTAAGTGGGATGGTAAAAAAAGGTTATTCCCAGAATGGGAAAAGGACATGACCCTAGGCGATGCCATGAAAGCTTCCGCTATTCCAGTTTATCAAGATTTAGCTCGTCGTATTGGACTTGAGCTCATGTCTAAGGAAGTGAAGCGTGTTGGTTATGGCAATGCAGATATCGGTACCCAAGTCGATAATTTTTGGCTGGTGGGTCCTTTAAAAATTACTCCTCAGCAAGAGGCACAGTTTGCTTACAAGCTAGCTAATAAAACGCTTCCATTTAGCCAAAAAGTCCAAGATGAAGTGCAATCCATGCTATTCATAGAAGAAAAGAATGGAAACAAAATATACGCAAAAAGTGGTTGGGGATGGGATGTAAACCCACAAGTAGGCTGGTTAACTGGATGGGTTGTTCAGCCTCAAGGGAATATTGTAGCGTTCTCCCTTAACTTAGAAATGAAAAAAGGAATACCTAG
587	gb|AM941159|+|208-1069|ARO:3001022|TEM-156	ATGAGTATTCAACATTTCCGTGTCGCCCTTATTCCCTTTTTTGCGGCATTTTGC...TAA	861.0	46	852	806	861	ATGAGTATTCAACATTTCCGTGTCGCCCTTATTCCCTTTTTTGCGGCATTTTGCCTTCCTGTTTTTGCTCACCCAGAAACGCTGGTGAAAGTAAAAGATGCTGAAGATCAGTTGGGTGCACGAGTGGGTTACATCGAGCTGGATCTCAACAGCGGTAAGATCCTTGAGAGTTTTCGCCCCGAAGAACGTTTTCCAATGATGAGCACTTTTAAAGTTCTGCTATGTGGTGCGGTATTATCCCGTGTTGACGCCGGGCAAGAGCAACTCGGTCGCCGCATACACTATTCTCAGAATGACTTGGTTGAGTACTCACCAGTCACAGAAAAGCATCTTACGGATGGCATGACAGTAAGAGAATTATGCAGTGCTGCCATAACCATGAGTGATAACACTGCGGCCAACTTACTTCTGACAACGATCGGAGGACCGAAGGAGCTAACCGCTTTTTTGCACAACATGGGGGATCATGTAACCCGCCTTGATCGTTGGGAACCGGAGCTGAATGAAGCCATACCAAACGACGAGCGTGACACCACGATGCCTGCAGCAATGGCAACAACGTTGCGCAAACTATTAACTGGCGAACTACTTACTCTAGCTTCCCGGCAACAATTAATAGACTGGATGGAGGCGGATAAAGTTGCAGGACCACTTCTGCGCTCGGCCCTTCCGGCTGGCTGGTTTATTGCTGATAAATCTGGAGCCGGTGAGCGTGGATCTCGCGGTATCATTGCAGCACTGGGGCCAGATGGTAAGCCCTCCCGTATCGTAGTTATCTACACGACGGGGAGTCAGGCAACTATGGA
588	gb|AB700703|+|161-1022|ARO:3001057|TEM-198	ATGAGTATTCAACATTTTCGTGTCGCCCTTATTCCCTTTTTTGCGGCATTTTGC...TAA	861.0	46	852	806	861	ATGAGTATTCAACATTTCCGTGTCGCCCTTATTCCCTTTTTTGCGGCATTTTGCCTTCCTGTTTTTGCTCACCCAGAAACGCTGGTGAAAGTAAAAGATGCTGAAGATCAGTTGGGTGCACGAGTGGGTTACATCGAGCTGGATCTCAACAGCGGTAAGATCCTTGAGAGTTTTCGCCCCGAAGAACGTTTTCCAATGATGAGCACTTTTAAAGTTCTGCTATGTGGTGCGGTATTATCCCGTGTTGACGCCGGGCAAGAGCAACTCGGTCGCCGCATACACTATTCTCAGAATGACTTGGTTGAGTACTCACCAGTCACAGAAAAGCATCTTACGGATGGCATGACAGTAAGAGAATTATGCAGTGCTGCCATAACCATGAGTGATAACACTGCGGCCAACTTACTTCTGACAACGATCGGAGGACCGAAGGAGCTAACCGCTTTTTTGCACAACATGGGGGATCATGTAACCCGCCTTGATCGTTGGGAACCGGAGCTGAATGAAGCCATACCAAACGACGAGCGTGACACCACGATGCCTGCAGCAATGGCAACAACGTTGCGCAAACTATTAACTGGCGAACTACTTACTCTAGCTTCCCGGCAACAATTAATAGACTGGATGGAGGCGGATAAAGTTGCAGGACCACTTCTGCGCTCGGCCCTTCCGGCTGGCTGGTTTATTGCTGATAAATCTGGAGCCGGTGAGCGTGGATCTCGCGGTATCATTGCAGCACTGGGGCCAGATGGTAAGCCCTCCCGTATCGTAGTTATCTACACGACGGGGAGTCAGGCAACTATGGA
589	gb|AF427127|+|208-1069|ARO:3000948|TEM-81	ATGAGTATTCAACATTTCCGTGTCGCCCTTATTCCCTTTTTTGCGGCATTTTGC...TAA	861.0	46	852	806	861	ATGAGTATTCAACATTTCCGTGTCGCCCTTATTCCCTTTTTTGCGGCATTTTGCCTTCCTGTTTTTGCTCACCCAGAAACGCTGGTGAAAGTAAAAGATGCTGAAGATCAGTTGGGTGCACGAGTGGGTTACATCGAGCTGGATCTCAACAGCGGTAAGATCCTTGAGAGTTTTCGCCCCGAAGAACGTTTTCCAATGATGAGCACTTTTAAAGTTCTGCTATGTGGTGCGGTATTATCCCGTGTTGACGCCGGGCAAGAGCAACTCGGTCGCCGCATACACTATTCTCAGAATGACTTGGTTGAGTACTCACCAGTCACAGAAAAGCATCTTACGGATGGCATGACAGTAAGAGAATTATGCAGTGCTGCCATAACCATGAGTGATAACACTGCGGCCAACTTACTTCTGACAACGATCGGAGGACCGAAGGAGCTAACCGCTTTTTTGCACAACATGGGGGATCATGTAACCCGCCTTGATCGTTGGGAACCGGAGCTGAATGAAGCCATACCAAACGACGAGCGTGACACCACGATGCCTGCAGCAATGGCAACAACGTTGCGCAAACTATTAACTGGCGAACTACTTACTCTAGCTTCCCGGCAACAATTAATAGACTGGATGGAGGCGGATAAAGTTGCAGGACCACTTCTGCGCTCGGCCCTTCCGGCTGGCTGGTTTATTGCTGATAAATCTGGAGCCGGTGAGCGTGGATCTCGCGGTATCATTGCAGCACTGGGGCCAGATGGTAAGCCCTCCCGTATCGTAGTTATCTACACGACGGGGAGTCAGGCAACTATGGA
590	gb|AF427128|+|208-1069|ARO:3000949|TEM-82	ATGAGTATTCAACATTTCCGTGTCGCCCTTATTCCCTTTTTTGCGGCATTTTGC...TAA	861.0	46	852	806	861	ATGAGTATTCAACATTTCCGTGTCGCCCTTATTCCCTTTTTTGCGGCATTTTGCCTTCCTGTTTTTGCTCACCCAGAAACGCTGGTGAAAGTAAAAGATGCTGAAGATCAGTTGGGTGCACGAGTGGGTTACATCGAGCTGGATCTCAACAGCGGTAAGATCCTTGAGAGTTTTCGCCCCGAAGAACGTTTTCCAATGATGAGCACTTTTAAAGTTCTGCTATGTGGTGCGGTATTATCCCGTGTTGACGCCGGGCAAGAGCAACTCGGTCGCCGCATACACTATTCTCAGAATGACTTGGTTGAGTACTCACCAGTCACAGAAAAGCATCTTACGGATGGCATGACAGTAAGAGAATTATGCAGTGCTGCCATAACCATGAGTGATAACACTGCGGCCAACTTACTTCTGACAACGATCGGAGGACCGAAGGAGCTAACCGCTTTTTTGCACAACATGGGGGATCATGTAACCCGCCTTGATCGTTGGGAACCGGAGCTGAATGAAGCCATACCAAACGACGAGCGTGACACCACGATGCCTGCAGCAATGGCAACAACGTTGCGCAAACTATTAACTGGCGAACTACTTACTCTAGCTTCCCGGCAACAATTAATAGACTGGATGGAGGCGGATAAAGTTGCAGGACCACTTCTGCGCTCGGCCCTTCCGGCTGGCTGGTTTATTGCTGATAAATCTGGAGCCGGTGAGCGTGGATCTCGCGGTATCATTGCAGCACTGGGGCCAGATGGTAAGCCCTCCCGTATCGTAGTTATCTACACGACGGGGAGTCAGGCAACTATGGA
591	gb|EU024485|+|0-861|ARO:3001151|SHV-102	ATGCGTTATATTCGCCTGTGTATTATCTCCCTGTTAGCCACCCTGCCGCTGGCG...TAA	861.0	16	822	806	861	ATGCGTTATATTCGCCTGTGTATTATCACCCTGTGAGCCACCCTGCCGCTGGCGGTACACGCCAGCCCGCAGCCGCTTGAGCAAATTAAACAAAGCGAAAGCCAGCTGTCGGGCCGCGTAGGCATGATAGAAATGGATCTGGCCAGCGGCCGCACGCTGACCGCCTGGCGCGCCGATGAACGCTTTCCCATGATGAGCACCTTTAAAGTAGTGCTCTGCGGCGCAGTGCTGGCGCGGGTGGATGCCGGTGACGAACAGCTGGAGCGAAAGATCCACTATCGCCAGCAGGATCTGGTGGACTACTCGCCGGTCAGCGAAAAACACCTTGCCGACGGCATGACGGTCGGCGAACTCTGCGCCGCCGCCATTACCATGAGCGATAACAGCGCCGCCAATCTGCTGCTGGCCACCGTCGGCGGCCCCGCAGGATTGACTGCCTTTTTGCGCCAGATCGGCGACAACGTCACCCGCCTTGACCGCTGGGAAACGGAACTGAATGAGGCGCTTCCCGGCGACGCCCGCGACACCACTACCCCGGCCAGCATGGCCGCGACCCTGCGCAAGCTGCTGACCAGCCAGCGTCTGAGCGCCCGTTCGCAACGGCAGCTGCTGCAGTGGATGGTGGACGATCGGGTCGCCGGACCGTTGATCCGCTCCGTGCTGCCGGCGGGCTGGTTTATCGCCGATAAGACCGGAGCTAGCAAGCGGGGTGCGCGCGGGATTGTCGCCCTGCTTGGCCCGAATAACAAAGCAGAGCGCATTGTGGTGATTTATCTGCGGGATACGCCGGCGAGCATGGCCGAGCG
592	gb|DQ909059|+|0-861|ARO:3001023|TEM-157	ATGAGTATTCAACATTTCCGAGTCGCCCTTATTCCCTTTTTTGCGGCATTTTGC...TAA	861.0	46	852	806	861	ATGAGTATTCAACATTTCCGTGTCGCCCTTATTCCCTTTTTTGCGGCATTTTGCCTTCCTGTTTTTGCTCACCCAGAAACGCTGGTGAAAGTAAAAGATGCTGAAGATCAGTTGGGTGCACGAGTGGGTTACATCGAGCTGGATCTCAACAGCGGTAAGATCCTTGAGAGTTTTCGCCCCGAAGAACGTTTTCCAATGATGAGCACTTTTAAAGTTCTGCTATGTGGTGCGGTATTATCCCGTGTTGACGCCGGGCAAGAGCAACTCGGTCGCCGCATACACTATTCTCAGAATGACTTGGTTGAGTACTCACCAGTCACAGAAAAGCATCTTACGGATGGCATGACAGTAAGAGAATTATGCAGTGCTGCCATAACCATGAGTGATAACACTGCGGCCAACTTACTTCTGACAACGATCGGAGGACCGAAGGAGCTAACCGCTTTTTTGCACAACATGGGGGATCATGTAACCCGCCTTGATCGTTGGGAACCGGAGCTGAATGAAGCCATACCAAACGACGAGCGTGACACCACGATGCCTGCAGCAATGGCAACAACGTTGCGCAAACTATTAACTGGCGAACTACTTACTCTAGCTTCCCGGCAACAATTAATAGACTGGATGGAGGCGGATAAAGTTGCAGGACCACTTCTGCGCTCGGCCCTTCCGGCTGGCTGGTTTATTGCTGATAAATCTGGAGCCGGTGAGCGTGGATCTCGCGGTATCATTGCAGCACTGGGGCCAGATGGTAAGCCCTCCCGTATCGTAGTTATCTACACGACGGGGAGTCAGGCAACTATGGA
593	gb|BX664015.1|-|103017-103833|ARO:3002641|APH(3')-Ia	ATGAGCCATATTCAACGGGAAACGTCTTGCTCGAGGCCGCGATTAAATTCCAAC...TGA	816.0	120	879	759	816	ATGAGCCATATTCAACGGGAAACGTCTTGCTCGAGGCCGCGATTAAATTCCAACCTGGATGCTGATTTATATGGGTATAGATGGGCTCGCGATAATGTCGGGCAATCAGGTGCGACAATCTATCGATTGTATGGGAAGCCCGATGCGCCAGAGTTGTTTCTGAAACATGGCAAAGGTAGCGTTGCCAATGATGTTACAGATGAGATGGTCAGACTAAACTGGCTGACGGCATTTATGCCTCTTCCGACCATCAAGCATTTTATCCGTACTCCTGATGATGCATGGTTACTCACCACTGCGATCCCCGGGAAAACAGCATTCCAGGTATTAGAAGAATATCCTGATTCAGGTGAAAATATTGTTGATGCGCTGGCAGTGTTCCTGCGCCGGTTGCATTCGATTCCTGTTTGTAATTGTCCTTTTAACAGCGATCGCGTATTTCGTCTCGCTCAGGCGCAATCACGAATGAATAACGGTTTGGTTGATGCTAGTGATTTTGATGACGAGCGTAATGGCTGGCCTGTTGAACAAGTCTGGAAAGAAATGCATAAGCTTTTGCCATTCTCACCGGATTCAGTCGTCACTCATGGTGATTTCTCACTTGATAACCTTATTTTTGACGAGGGGAAATTAATAGGTTGTATTGATGTTGGACGAGTCGGAATCGCAGACCGATACCAGGATCTTGCCATCCTATGGAACTGCCTCGGTGAGTTTTCTCCTTCATTACAGAAACGGCTTTTTCAAAAATATGGTATT
594	gb|KJ584918.1|+|0-828|ARO:3001600|OXA-409	ATGAACATTAAAGCACTCTTACTTATAACAAGCGCTATTTTTATTTCAGCCTGC...TAG	828.0	54149	54919	770	828	ATGAACATTAAAGCACTCTTACTTATAACAAGCGCTATTTTTATTTCAGCCTGCTCACCTTATATAGTGACTGCTAATCCAAATCACAGCGCTTCAAAATCTGATGTAAAAGCAGAGAAAATTAAAAATTTATTTAACGAAGCACACACTACGGGTGTTTTAGTTATCCAACAAGGCCAAACTCAACAAAGCTATGGTAATGATCTTGCTCGTGCTTCGACCGAGTATGTACCTGCTTCGACCTTCAAAATGCTTAATGCTTTGATCGGCCTTGAGCACCATAAGGCAACCACCACAGAAGTATTTAAGTGGGATGGTAAAAAAAGGTTATTCCCAGAATGGGAAAAGGACATGACCCTAGGCGATGCCATGAAAGCTTCCGCTATTCCAGTTTATCAAGATTTAGCTCGTCGTATTGGACTTGAGCTCATGTCTAAGGAAGTGAAGCGTGTTGGTTATGGCAATGCAGATATCGGTACCCAAGTCGATAATTTTTGGCTGGTGGGTCCTTTAAAAATTACTCCTCAGCAAGAGGCACAGTTTGCTTACAAGCTAGCTAATAAAACGCTTCCATTTAGCCAAAAAGTCCAAGATGAAGTGCAATCCATGCTATTCATAGAAGAAAAGAATGGAAACAAAATATACGCAAAAAGTGGTTGGGGATGGGATGTAAACCCACAAGTAGGCTGGTTAACTGGATGGGTTGTTCAGCCTCAAGGGAATATTGTAGCGTTCTCCCTTAACTTAGAAATGAAAAAAGGAATACCTAG
595	gb|AF427129|+|208-1069|ARO:3000950|TEM-83	ATGAGTATTCAACATTTCCGTGTCGCCCTTATTCCCTTTTTTGCGGCATTTTGC...TAA	861.0	46	852	806	861	ATGAGTATTCAACATTTCCGTGTCGCCCTTATTCCCTTTTTTGCGGCATTTTGCCTTCCTGTTTTTGCTCACCCAGAAACGCTGGTGAAAGTAAAAGATGCTGAAGATCAGTTGGGTGCACGAGTGGGTTACATCGAGCTGGATCTCAACAGCGGTAAGATCCTTGAGAGTTTTCGCCCCGAAGAACGTTTTCCAATGATGAGCACTTTTAAAGTTCTGCTATGTGGTGCGGTATTATCCCGTGTTGACGCCGGGCAAGAGCAACTCGGTCGCCGCATACACTATTCTCAGAATGACTTGGTTGAGTACTCACCAGTCACAGAAAAGCATCTTACGGATGGCATGACAGTAAGAGAATTATGCAGTGCTGCCATAACCATGAGTGATAACACTGCGGCCAACTTACTTCTGACAACGATCGGAGGACCGAAGGAGCTAACCGCTTTTTTGCACAACATGGGGGATCATGTAACCCGCCTTGATCGTTGGGAACCGGAGCTGAATGAAGCCATACCAAACGACGAGCGTGACACCACGATGCCTGCAGCAATGGCAACAACGTTGCGCAAACTATTAACTGGCGAACTACTTACTCTAGCTTCCCGGCAACAATTAATAGACTGGATGGAGGCGGATAAAGTTGCAGGACCACTTCTGCGCTCGGCCCTTCCGGCTGGCTGGTTTATTGCTGATAAATCTGGAGCCGGTGAGCGTGGATCTCGCGGTATCATTGCAGCACTGGGGCCAGATGGTAAGCCCTCCCGTATCGTAGTTATCTACACGACGGGGAGTCAGGCAACTATGGA
596	gb|AF427130|+|208-1069|ARO:3000951|TEM-84	ATGAGTATTCAACATTTCCGTGTCGCCCTTATTCCCTTTTTTGCGGCATTTTGC...TAA	861.0	46	852	806	861	ATGAGTATTCAACATTTCCGTGTCGCCCTTATTCCCTTTTTTGCGGCATTTTGCCTTCCTGTTTTTGCTCACCCAGAAACGCTGGTGAAAGTAAAAGATGCTGAAGATCAGTTGGGTGCACGAGTGGGTTACATCGAGCTGGATCTCAACAGCGGTAAGATCCTTGAGAGTTTTCGCCCCGAAGAACGTTTTCCAATGATGAGCACTTTTAAAGTTCTGCTATGTGGTGCGGTATTATCCCGTGTTGACGCCGGGCAAGAGCAACTCGGTCGCCGCATACACTATTCTCAGAATGACTTGGTTGAGTACTCACCAGTCACAGAAAAGCATCTTACGGATGGCATGACAGTAAGAGAATTATGCAGTGCTGCCATAACCATGAGTGATAACACTGCGGCCAACTTACTTCTGACAACGATCGGAGGACCGAAGGAGCTAACCGCTTTTTTGCACAACATGGGGGATCATGTAACCCGCCTTGATCGTTGGGAACCGGAGCTGAATGAAGCCATACCAAACGACGAGCGTGACACCACGATGCCTGCAGCAATGGCAACAACGTTGCGCAAACTATTAACTGGCGAACTACTTACTCTAGCTTCCCGGCAACAATTAATAGACTGGATGGAGGCGGATAAAGTTGCAGGACCACTTCTGCGCTCGGCCCTTCCGGCTGGCTGGTTTATTGCTGATAAATCTGGAGCCGGTGAGCGTGGATCTCGCGGTATCATTGCAGCACTGGGGCCAGATGGTAAGCCCTCCCGTATCGTAGTTATCTACACGACGGGGAGTCAGGCAACTATGGA
597	gb|M90056.1|+|908-2477|ARO:3002829|vgaA	ATGAAAATAATGTTAGAGGGACTTAATATAAAACATTATGTTCAAGATCGTTTA...TAA	1569.0	0	1045	1045	1569	ATAATAACTATATAGAAAAATTAGAACAGGATTTAAAAAATTGGCATGGAGCATTTATTATAGTTTCACATGATCGCGCTTTTTTAGATAACTTATGTACTACTATATGGGAAATTGACGAGGGGAGAATAACTGAATATAAGGGGAATTATAGTAACTATGTTGAACAAAAAGAATTAGAAAGACATCGAGAAGAATTAGAATATGAAAAATATGAAAAAGAAAAGAAACGATTGGAAAAAGCTATAAATATAAAAGAACAGAAAGCTCAACGAGCAACTAAAAAACCGAAAAACTTAAGTTCATCTGAAGGCAAAATAAAAGTAACAAAGCCATACTTTGCAAGTAAGCAAAAGAAGTTACGAAAAACTGTAAAATCTCTAGAAACCAGACTAGAAAAACTTGAAAGGGTCGAAAAGAGAAACGAACTTCCTCCAGTTAAAATGGATTTAGTGAACTTAAAAAGTGTAAAAAATAGAACTATAATACGTGGTGAAGATGTCTCGGGTACAATTGAAGGACGGGTATTGTGGAAAGCAAAAAGTTTTAGTATTCGCGGAGGAGACAAGATGGCAATTATCGGATCTAATGGTACAGGAAAGACAACGTTTATTAAAAAAATTGTGCATGGGAATCCTGGTATTTCGTTATCGCCATCTGTCAAAATCGGTTATTTTAGCCAAAAAATAGATACATTAGAATTAGATAAGAGTATTTTAGAAAATGTTCAATCTTCTTCACAACAAAATGAAACTCTTATTCGAACTATTCTAGCTAGAATGCATTTTTTTAGAGATGATGTTTATAAACCAATAAGTGTCTTAAGTGGTGGAGAGCGAGTTAAAGTAGCACTAACTAAAGTATTCTTAAGTGAAGTTAATACGTTGGTACTAGATGAACCAACAAACTTTCTTGATATGGAAGCTATAGAGGCGTTTGAATCTTTGTTAAAGGAATATAATGGCAGTATAATCTTTGTATCTCACGATCGTAAATTTATCGAAAAAGTAGCCACTCGAATAATGACAATTGATAATAAAGAAAT
598	gb|JX050178|+|0-853|ARO:3001058|TEM-199  Partial			54	852	798	853	TCAACATTTCCGTGTCGCCCTTATTCCCTTTTTTGCGGCATTTTGCCTTCCTGTTTTTGCTCACCCAGAAACGCTGGTGAAAGTAAAAGATGCTGAAGATCAGTTGGGTGCACGAGTGGGTTACATCGAGCTGGATCTCAACAGCGGTAAGATCCTTGAGAGTTTTCGCCCCGAAGAACGTTTTCCAATGATGAGCACTTTTAAAGTTCTGCTATGTGGTGCGGTATTATCCCGTGTTGACGCCGGGCAAGAGCAACTCGGTCGCCGCATACACTATTCTCAGAATGACTTGGTTGAGTACTCACCAGTCACAGAAAAGCATCTTACGGATGGCATGACAGTAAGAGAATTATGCAGTGCTGCCATAACCATGAGTGATAACACTGCGGCCAACTTACTTCTGACAACGATCGGAGGACCGAAGGAGCTAACCGCTTTTTTGCACAACATGGGGGATCATGTAACCCGCCTTGATCGTTGGGAACCGGAGCTGAATGAAGCCATACCAAACGACGAGCGTGACACCACGATGCCTGCAGCAATGGCAACAACGTTGCGCAAACTATTAACTGGCGAACTACTTACTCTAGCTTCCCGGCAACAATTAATAGACTGGATGGAGGCGGATAAAGTTGCAGGACCACTTCTGCGCTCGGCCCTTCCGGCTGGCTGGTTTATTGCTGATAAATCTGGAGCCGGTGAGCGTGGATCTCGCGGTATCATTGCAGCACTGGGGCCAGATGGTAAGCCCTCCCGTATCGTAGTTATCTACACGACGGGGAGTCAGGCAACTATGGA
599	gb|AJ277414|+|0-861|ARO:3000952|TEM-85	ATGAGTATTCAACATTTCCGTGTCGCCCTTATTCCCTTTTTTGCGGCATTTTGC...TAA	861.0	46	852	806	861	ATGAGTATTCAACATTTCCGTGTCGCCCTTATTCCCTTTTTTGCGGCATTTTGCCTTCCTGTTTTTGCTCACCCAGAAACGCTGGTGAAAGTAAAAGATGCTGAAGATCAGTTGGGTGCACGAGTGGGTTACATCGAGCTGGATCTCAACAGCGGTAAGATCCTTGAGAGTTTTCGCCCCGAAGAACGTTTTCCAATGATGAGCACTTTTAAAGTTCTGCTATGTGGTGCGGTATTATCCCGTGTTGACGCCGGGCAAGAGCAACTCGGTCGCCGCATACACTATTCTCAGAATGACTTGGTTGAGTACTCACCAGTCACAGAAAAGCATCTTACGGATGGCATGACAGTAAGAGAATTATGCAGTGCTGCCATAACCATGAGTGATAACACTGCGGCCAACTTACTTCTGACAACGATCGGAGGACCGAAGGAGCTAACCGCTTTTTTGCACAACATGGGGGATCATGTAACCCGCCTTGATCGTTGGGAACCGGAGCTGAATGAAGCCATACCAAACGACGAGCGTGACACCACGATGCCTGCAGCAATGGCAACAACGTTGCGCAAACTATTAACTGGCGAACTACTTACTCTAGCTTCCCGGCAACAATTAATAGACTGGATGGAGGCGGATAAAGTTGCAGGACCACTTCTGCGCTCGGCCCTTCCGGCTGGCTGGTTTATTGCTGATAAATCTGGAGCCGGTGAGCGTGGATCTCGCGGTATCATTGCAGCACTGGGGCCAGATGGTAAGCCCTCCCGTATCGTAGTTATCTACACGACGGGGAGTCAGGCAACTATGGA
600	gb|X54606|+|214-1075|ARO:3000874|TEM-2	ATGAGTATTCAACATTTCCGTGTCGCCCTTATTCCCTTTTTTGCGGCATTTTGC...TAA	861.0	46	852	806	861	ATGAGTATTCAACATTTCCGTGTCGCCCTTATTCCCTTTTTTGCGGCATTTTGCCTTCCTGTTTTTGCTCACCCAGAAACGCTGGTGAAAGTAAAAGATGCTGAAGATCAGTTGGGTGCACGAGTGGGTTACATCGAGCTGGATCTCAACAGCGGTAAGATCCTTGAGAGTTTTCGCCCCGAAGAACGTTTTCCAATGATGAGCACTTTTAAAGTTCTGCTATGTGGTGCGGTATTATCCCGTGTTGACGCCGGGCAAGAGCAACTCGGTCGCCGCATACACTATTCTCAGAATGACTTGGTTGAGTACTCACCAGTCACAGAAAAGCATCTTACGGATGGCATGACAGTAAGAGAATTATGCAGTGCTGCCATAACCATGAGTGATAACACTGCGGCCAACTTACTTCTGACAACGATCGGAGGACCGAAGGAGCTAACCGCTTTTTTGCACAACATGGGGGATCATGTAACCCGCCTTGATCGTTGGGAACCGGAGCTGAATGAAGCCATACCAAACGACGAGCGTGACACCACGATGCCTGCAGCAATGGCAACAACGTTGCGCAAACTATTAACTGGCGAACTACTTACTCTAGCTTCCCGGCAACAATTAATAGACTGGATGGAGGCGGATAAAGTTGCAGGACCACTTCTGCGCTCGGCCCTTCCGGCTGGCTGGTTTATTGCTGATAAATCTGGAGCCGGTGAGCGTGGATCTCGCGGTATCATTGCAGCACTGGGGCCAGATGGTAAGCCCTCCCGTATCGTAGTTATCTACACGACGGGGAGTCAGGCAACTATGGA
601	gb|AF313472|+|15593-16397|ARO:3002639|APH(3'')-Ib	TTGAATCGAACTAATATTTTTTTTGGTGAATCGCATTCTGACTGGTTGCCTGTC...TGA	804.0	10	759	749	804	TTGAATCGAACTAATATTTTTTTTGGTGAATCGCATTCTGACTGGTTGCCTGTCAGAGGCGGAGAATCTGGTGATTTTGTTTTTCGACGTGGTGACGGGCATGCCTTCGCGAAAATCGCACCTGCTTCCCGCCGCGGTGAGCTCGCTGGAGAGCGTGACCGCCTCATTTGGCTCAAAGGTCGAGGTGTGGCTTGCCCCGAGGTGATCAACTGGCAGGAGGAACAGGAGGGTGCATGCTTGGTGATAACGGCAATTCCGGGAGTACCGGCGGCTGATCTGTCTGGAGCGGATTTGCTCAAAGCGTGGCCGTCAATGGGGCAGCAACTTGGCGCTGTTCACAGCCTATCGGTTGATCAATGTCCGTTTGAGCGCAGGCTGTCGCGAATGTTCGGACGCGCCGTTGATGTGGTGTCCCGCAATGCCGTCAATCCCGACTTCTTACCGGACGAGGACAAGAGTACGCCGCAGCTCGATCTTTTGGCTCGTGTCGAACGAGAGCTACCGGTGCGGCTCGACCAAGAGCGCACCGATATGGTTGTTTGCCATGGTGATCCCTGCATGCCGAACTTCATGGTGGACCCTAAAACTCTTCAATGCACGGGTCTGATCGACCTTGGGCGGCTCGGAACAGCAGATCGCTATGCCGATTTGGCACTCATGATTGCTAACGCCGAAGAGAACTGGGCAGCGCCAGATGAAGCAGAGCGCGCCTTCGCTGTCCTATTCAATGTATTGGGGATCGAAGCCCC
602	gb|EF534736|+|213-1074|ARO:3001024|TEM-158	ATGAGTATTCAACATTTTCGTGTCGCCCTTATTCCCTTTTTTGCGGCATTTTGC...TAA	861.0	46	852	806	861	ATGAGTATTCAACATTTCCGTGTCGCCCTTATTCCCTTTTTTGCGGCATTTTGCCTTCCTGTTTTTGCTCACCCAGAAACGCTGGTGAAAGTAAAAGATGCTGAAGATCAGTTGGGTGCACGAGTGGGTTACATCGAGCTGGATCTCAACAGCGGTAAGATCCTTGAGAGTTTTCGCCCCGAAGAACGTTTTCCAATGATGAGCACTTTTAAAGTTCTGCTATGTGGTGCGGTATTATCCCGTGTTGACGCCGGGCAAGAGCAACTCGGTCGCCGCATACACTATTCTCAGAATGACTTGGTTGAGTACTCACCAGTCACAGAAAAGCATCTTACGGATGGCATGACAGTAAGAGAATTATGCAGTGCTGCCATAACCATGAGTGATAACACTGCGGCCAACTTACTTCTGACAACGATCGGAGGACCGAAGGAGCTAACCGCTTTTTTGCACAACATGGGGGATCATGTAACCCGCCTTGATCGTTGGGAACCGGAGCTGAATGAAGCCATACCAAACGACGAGCGTGACACCACGATGCCTGCAGCAATGGCAACAACGTTGCGCAAACTATTAACTGGCGAACTACTTACTCTAGCTTCCCGGCAACAATTAATAGACTGGATGGAGGCGGATAAAGTTGCAGGACCACTTCTGCGCTCGGCCCTTCCGGCTGGCTGGTTTATTGCTGATAAATCTGGAGCCGGTGAGCGTGGATCTCGCGGTATCATTGCAGCACTGGGGCCAGATGGTAAGCCCTCCCGTATCGTAGTTATCTACACGACGGGGAGTCAGGCAACTATGGA
603	gb|EU032604|+|0-861|ARO:3001152|SHV-103	ATGCGTTATATTCGCCTGTGTATTATCTCCCTGTTAGCCACCCTGCCGCTGGCG...TAA	861.0	16	822	806	861	ATGCGTTATATTCGCCTGTGTATTATCACCCTGTGAGCCACCCTGCCGCTGGCGGTACACGCCAGCCCGCAGCCGCTTGAGCAAATTAAACAAAGCGAAAGCCAGCTGTCGGGCCGCGTAGGCATGATAGAAATGGATCTGGCCAGCGGCCGCACGCTGACCGCCTGGCGCGCCGATGAACGCTTTCCCATGATGAGCACCTTTAAAGTAGTGCTCTGCGGCGCAGTGCTGGCGCGGGTGGATGCCGGTGACGAACAGCTGGAGCGAAAGATCCACTATCGCCAGCAGGATCTGGTGGACTACTCGCCGGTCAGCGAAAAACACCTTGCCGACGGCATGACGGTCGGCGAACTCTGCGCCGCCGCCATTACCATGAGCGATAACAGCGCCGCCAATCTGCTGCTGGCCACCGTCGGCGGCCCCGCAGGATTGACTGCCTTTTTGCGCCAGATCGGCGACAACGTCACCCGCCTTGACCGCTGGGAAACGGAACTGAATGAGGCGCTTCCCGGCGACGCCCGCGACACCACTACCCCGGCCAGCATGGCCGCGACCCTGCGCAAGCTGCTGACCAGCCAGCGTCTGAGCGCCCGTTCGCAACGGCAGCTGCTGCAGTGGATGGTGGACGATCGGGTCGCCGGACCGTTGATCCGCTCCGTGCTGCCGGCGGGCTGGTTTATCGCCGATAAGACCGGAGCTAGCAAGCGGGGTGCGCGCGGGATTGTCGCCCTGCTTGGCCCGAATAACAAAGCAGAGCGCATTGTGGTGATTTATCTGCGGGATACGCCGGCGAGCATGGCCGAGCG
604	gb|AJ277415|+|0-861|ARO:3000953|TEM-86	ATGAGTATTCAACATTTCCGTGTCGCCCTTATTCCCTTTTTTGCGGCATTTTGC...TAA	861.0	46	852	806	861	ATGAGTATTCAACATTTCCGTGTCGCCCTTATTCCCTTTTTTGCGGCATTTTGCCTTCCTGTTTTTGCTCACCCAGAAACGCTGGTGAAAGTAAAAGATGCTGAAGATCAGTTGGGTGCACGAGTGGGTTACATCGAGCTGGATCTCAACAGCGGTAAGATCCTTGAGAGTTTTCGCCCCGAAGAACGTTTTCCAATGATGAGCACTTTTAAAGTTCTGCTATGTGGTGCGGTATTATCCCGTGTTGACGCCGGGCAAGAGCAACTCGGTCGCCGCATACACTATTCTCAGAATGACTTGGTTGAGTACTCACCAGTCACAGAAAAGCATCTTACGGATGGCATGACAGTAAGAGAATTATGCAGTGCTGCCATAACCATGAGTGATAACACTGCGGCCAACTTACTTCTGACAACGATCGGAGGACCGAAGGAGCTAACCGCTTTTTTGCACAACATGGGGGATCATGTAACCCGCCTTGATCGTTGGGAACCGGAGCTGAATGAAGCCATACCAAACGACGAGCGTGACACCACGATGCCTGCAGCAATGGCAACAACGTTGCGCAAACTATTAACTGGCGAACTACTTACTCTAGCTTCCCGGCAACAATTAATAGACTGGATGGAGGCGGATAAAGTTGCAGGACCACTTCTGCGCTCGGCCCTTCCGGCTGGCTGGTTTATTGCTGATAAATCTGGAGCCGGTGAGCGTGGATCTCGCGGTATCATTGCAGCACTGGGGCCAGATGGTAAGCCCTCCCGTATCGTAGTTATCTACACGACGGGGAGTCAGGCAACTATGGA
605	gb|JQ340365|+|0-1434|ARO:3003583|basS	ATGTCCCGTGCCGCCGTCCCCTCCGTCCGCCGGCGCCTGCTGGTCAACCTGCTG...TGA	1434.0	8468	9837	1369	1434	CCGCCGTCCCCTCCGTCCGCCGGCGCCTGCTGGTCAACCTGCTGGTCGGCTTCGTGCTGTGCTGGCTGAGCGTGGCGGCGCTGACCTACCACCTCTCGCTGAAGCAGGTGAACCGACTGTTCGACGACGACATGGTGGACTTCGGCGAAGCCGCCCTGCGCCTGCTCGACCTTGCCACCGAAGACCAGGCCAGCGAGGACGGCTCGATCACCGAGATCATCGAACGCAGCCGCGAGGCGATCCAGGGCCTGCCCCTGCTGCGCCGCGAAAGCGCCCTCGGCTACGCCCTGTGGCGCGACGGCCAGCCGCTGCTGTCGAGCCTCAACCTGCCGCCGGAGATCACGGCCCAGGGCCCCGGCTTCAGCACCGTGGAAGCCCAGGGCACCCACTGGCGGGTGCTCCAGCTGAACATCGACGGCTTCCAGATCTGGATCAGCGAAAACCTGATCTACCGCCAGCACACCATGAACCTGCTGCTGTTCTATTCGCTGTTCCCGCTGCTGCTGGCGCTGCCGTTGCTCGGCGGCCTGGTCTGGTTCGGCGTTGCCCGCGGCCTGGCGCCGCTACGCGAAGTGCAGGCCGAGGTCCAGCAGCGCTCCGCGCGACACCTGCAGCCGATCGCGGTGGAGGCGGTGCCGCTGGAGATCCGCGGCCTCATCGACGAACTCAACCTCCTGCTCGAGCGCCTGCGCACCGCCCTCGAGGCCGAACGCCGACTGACCAGCGACGCCGCCCATGAGATCCGCACGCCGCTGGCCAGCCTGCGCACCCATGCCCAGGTCGCGCTGCGTTCGGAAGACCCCAAGGCCCACGCCCGCGGCCTGCTGCAAGTCAGTCGCAGCGTCGAGCGGATCAGCACCTTGATGGAGCAGATCCTGCTTCTCGCCCGCCTCGACGGCGACGCCCTGCTGGAGCAATTCCACCCGGTCAACCTCGCCACCCTGGCCGAAGACGTACTCTCCGAACTGGCGCGCCAGGCCATCGACAAGGACATCGAGCTGTCGTTGCACCAGGAGACCGTGCACGTGATGGGCATCGACCTGTGGCTGAAGGCGATGGTCGGCAACCTGGTGAGCAACGCCCTGCGCTACACGCCGGCCGGGGGCCAGGTCGAGATCCGCGTCGAGAATCGCGCCCAGCACGCCGTGCTGCGGGTGCGCGACAACGGCCCCGGGGTCGCCCTGGAAGAGCAGCAGGCGATCTTCACCCGCTTCTACCGCAGCCCCGCCACCAGCAGCGGCGAGGGCAGCGGCCTGGGCCTGCCGATCGTCAAGCGCATCGTCGAACTGCACTTCGGCAGTATCGGCCTGGGCAAGGGACTGGAGGGCAAAGGGCTGGAAGTACAGGTGTTCCTGCCGAAGACCCAGCC
606	gb|KJ584920.1|+|0-825|ARO:3001602|OXA-411	ATGAACATTAAAACACTCTTACTTATAACAAGCGCTATTTTTATTTCAGCCTGC...TAG	825.0	54149	54919	770	825	ATGAACATTAAAGCACTCTTACTTATAACAAGCGCTATTTTTATTTCAGCCTGCTCACCTTATATAGTGACTGCTAATCCAAATCACAGCGCTTCAAAATCTGATGTAAAAGCAGAGAAAATTAAAAATTTATTTAACGAAGCACACACTACGGGTGTTTTAGTTATCCAACAAGGCCAAACTCAACAAAGCTATGGTAATGATCTTGCTCGTGCTTCGACCGAGTATGTACCTGCTTCGACCTTCAAAATGCTTAATGCTTTGATCGGCCTTGAGCACCATAAGGCAACCACCACAGAAGTATTTAAGTGGGATGGTAAAAAAAGGTTATTCCCAGAATGGGAAAAGGACATGACCCTAGGCGATGCCATGAAAGCTTCCGCTATTCCAGTTTATCAAGATTTAGCTCGTCGTATTGGACTTGAGCTCATGTCTAAGGAAGTGAAGCGTGTTGGTTATGGCAATGCAGATATCGGTACCCAAGTCGATAATTTTTGGCTGGTGGGTCCTTTAAAAATTACTCCTCAGCAAGAGGCACAGTTTGCTTACAAGCTAGCTAATAAAACGCTTCCATTTAGCCAAAAAGTCCAAGATGAAGTGCAATCCATGCTATTCATAGAAGAAAAGAATGGAAACAAAATATACGCAAAAAGTGGTTGGGGATGGGATGTAAACCCACAAGTAGGCTGGTTAACTGGATGGGTTGTTCAGCCTCAAGGGAATATTGTAGCGTTCTCCCTTAACTTAGAAATGAAAAAAGGAATACCTAG
607	gb|V01499|+|230-1256|ARO:3002655|APH(4)-Ia	ATGAAAAAGCCTGAACTCACCGCGACGTCTGTCGAGAAGTTTCTGATCGAAAAG...TAG	1026.0	1046	2017	971	1026	ATGAAAAAGCCTGAACTCACCGCGACGTCTGTCGAGAAGTTTCTGATCGAAAAGTTCGACAGCGTCTCCGACCTGATGCAGCTCTCGGAGGGCGAAGAATCTCGTGCTTTCAGCTTCGATGTAGGAGGGCGTGGATATGTCCTGCGGGTAAATAGCTGCGCCGATGGTTTCTACAAAGATCGTTATGTTTATCGGCACTTTGCATCGGCCGCGCTCCCGATTCCGGAAGTGCTTGACATTGGGGAATTCAGCGAGAGCCTGACCTATTGCATCTCCCGCCGTGCACAGGGTGTCACGTTGCAAGACCTGCCTGAAACCGAACTGCCCGCTGTTCTGCAGCCGGTCGCGGAGGCCATGGATGCGATCGCTGCGGCCGATCTTAGCCAGACGAGCGGGTTCGGCCCATTCGGACCGCAAGGAATCGGTCAATACACTACATGGCGTGATTTCATATGCGCGATTGCTGATCCCCATGTGTATCACTGGCAAACTGTGATGGACGACACCGTCAGTGCGTCCGTCGCGCAGGCTCTCGATGAGCTGATGCTTTGGGCCGAGGACTGCCCCGAAGTCCGGCACCTCGTGCACGCGGATTTCGGCTCCAACAATGTCCTGACGGACAATGGCCGCATAACAGCGGTCATTGACTGGAGCGAGGCGATGTTCGGGGATTCCCAATACGAGGTCGCCAACATCTTCTTCTGGAGGCCGTGGTTGGCTTGTATGGAGCAGCAGACGCGCTACTTCGAGCGGAGGCATCCGGAGCTTGCAGGATCGCCGCGGCTCCGGGCGTATATGCTCCGCATTGGTCTTGACCAACTCTATCAGAGCTTGGTTGACGGCAATTTCGATGATGCAGCTTGGGCGCAGGGTCGATGCGACGCAATCGTCCGATCCGGAGCCGGGACTGTCGGGCGTACACAAATCGCCCGCAGAAGCGCGGCCGTCTGGACCGATGGCTGTGTAGAAGT
608	gb|Y17581|+|78-936|ARO:3000891|TEM-20	ATGAGTATTCAACATTTCCGTGTCGCCCTTATTCCCTTTTTTGCGGCATTTTGC...TGG	858.0	46	849	803	858	ATGAGTATTCAACATTTCCGTGTCGCCCTTATTCCCTTTTTTGCGGCATTTTGCCTTCCTGTTTTTGCTCACCCAGAAACGCTGGTGAAAGTAAAAGATGCTGAAGATCAGTTGGGTGCACGAGTGGGTTACATCGAGCTGGATCTCAACAGCGGTAAGATCCTTGAGAGTTTTCGCCCCGAAGAACGTTTTCCAATGATGAGCACTTTTAAAGTTCTGCTATGTGGTGCGGTATTATCCCGTGTTGACGCCGGGCAAGAGCAACTCGGTCGCCGCATACACTATTCTCAGAATGACTTGGTTGAGTACTCACCAGTCACAGAAAAGCATCTTACGGATGGCATGACAGTAAGAGAATTATGCAGTGCTGCCATAACCATGAGTGATAACACTGCGGCCAACTTACTTCTGACAACGATCGGAGGACCGAAGGAGCTAACCGCTTTTTTGCACAACATGGGGGATCATGTAACCCGCCTTGATCGTTGGGAACCGGAGCTGAATGAAGCCATACCAAACGACGAGCGTGACACCACGATGCCTGCAGCAATGGCAACAACGTTGCGCAAACTATTAACTGGCGAACTACTTACTCTAGCTTCCCGGCAACAATTAATAGACTGGATGGAGGCGGATAAAGTTGCAGGACCACTTCTGCGCTCGGCCCTTCCGGCTGGCTGGTTTATTGCTGATAAATCTGGAGCCGGTGAGCGTGGATCTCGCGGTATCATTGCAGCACTGGGGCCAGATGGTAAGCCCTCCCGTATCGTAGTTATCTACACGACGGGGAGTCAGGCAACTAT
609	gb|AY123251.1|+|811-1444|ARO:3002680|catB8	ATGAAAAACTACTTTAACAGCCCTTTCAAAGGGGAACTTCTTTCTGAGCAAGTG...TAA	633.0	724	1302	578	633	ATGAAAAACTACTTTAACAGCCCTTTCAAAGGGGAACTTCTTTCTGAGCAAGTGAAAAATCCAAATATCAGAGTAGGCCGGTATAGCTATTACTCTGGCTACTATCACGGGCACTCATTTGATGAATGCGCGCGATACTTGCTTCCAGATCGTGATGACGTTGATAAATTGATCATTGGCAGCTTTTGTTCTATAGGAAGCGGGGCTTCCTTCATCATGGCTGGCAATCAGGGGCATCGGCATGACTGGGCATCATCCTTCCCCTTCTTCTATATGCAAGAGGAGCCTGCTTTCTCAAGAGCACTCGACGCCTTCCAAAGAGCAGGTGATACCGTCATTGGCAATGATGTCTGGATAGGCTCGGAGGCAATGATTATGCCTGGCATCAAAATTGGAGACGGTGCCGTGATAGGTAGTCGCTCGTTGGTGACAAAAGATGTAGAGCCTTATGCCATCATCGGGGGAAATCCCGCAAAGCAAATTAAGAAGCGCTTCTCCGATGAGGAAATCTCATTGCTCATGGAGATGGAGTGGTGGAACTGGCCACTAGATAAAATTAAGACAGCAATGCCTCTGCT
610	gb|EU274581|+|0-861|ARO:3001153|SHV-104	TTGCGTTATATTCGCCTGTGTATTATCTCCCTGTTAGCCACCCTGCCGCTGGCG...TAA	861.0	17	822	805	861	TGCGTTATATTCGCCTGTGTATTATCACCCTGTGAGCCACCCTGCCGCTGGCGGTACACGCCAGCCCGCAGCCGCTTGAGCAAATTAAACAAAGCGAAAGCCAGCTGTCGGGCCGCGTAGGCATGATAGAAATGGATCTGGCCAGCGGCCGCACGCTGACCGCCTGGCGCGCCGATGAACGCTTTCCCATGATGAGCACCTTTAAAGTAGTGCTCTGCGGCGCAGTGCTGGCGCGGGTGGATGCCGGTGACGAACAGCTGGAGCGAAAGATCCACTATCGCCAGCAGGATCTGGTGGACTACTCGCCGGTCAGCGAAAAACACCTTGCCGACGGCATGACGGTCGGCGAACTCTGCGCCGCCGCCATTACCATGAGCGATAACAGCGCCGCCAATCTGCTGCTGGCCACCGTCGGCGGCCCCGCAGGATTGACTGCCTTTTTGCGCCAGATCGGCGACAACGTCACCCGCCTTGACCGCTGGGAAACGGAACTGAATGAGGCGCTTCCCGGCGACGCCCGCGACACCACTACCCCGGCCAGCATGGCCGCGACCCTGCGCAAGCTGCTGACCAGCCAGCGTCTGAGCGCCCGTTCGCAACGGCAGCTGCTGCAGTGGATGGTGGACGATCGGGTCGCCGGACCGTTGATCCGCTCCGTGCTGCCGGCGGGCTGGTTTATCGCCGATAAGACCGGAGCTAGCAAGCGGGGTGCGCGCGGGATTGTCGCCCTGCTTGGCCCGAATAACAAAGCAGAGCGCATTGTGGTGATTTATCTGCGGGATACGCCGGCGAGCATGGCCGAGCG
611	gb|AF024602|+|3155-3992|ARO:3002660|APH(6)-Id	ATGTTCATGCCGCCTGTTTTTCCTGCTCATTGGCACGTTTCGCAACCTGTTCTC...TAG	837.0	813	1595	782	837	ATGTTCATGCCGCCTGTTTTTCCTGCTCATTGGCACGTTTCGCAACCTGTTCTCATTGCGGACACCTTTTCCAGCCTCGTTTGGAAAGTTTCATTGCCAGACGGGACTCCTGCAATCGTCAAGGGATTGAAACCTATAGAAGACATTGCTGATGAACTGCGCGGGGCCGACTATCTGGTATGGCGCAATGGGAGGGGAGCAGTCCGGTTGCTCGGTCGTGAGAACAATCTGATGTTGCTCGAATATGCCGGGGAGCGAATGCTCTCTCACATCGTTGCCGAGCACGGCGACTACCAGGCGACCGAAATTGCAGCGGAACTAATGGCGAAGCTGTATGCCGCATCTGAGGAACCCCTGCCTTCTGCCCTTCTCCCGATCCGGGATCGCTTTGCAGCTTTGTTTCAGCGGGCGCGCGATGATCAAAACGCAGGTTGTCAAACTGACTACGTCCACGCGGCGATTATAGCCGATCAAATGATGAGCAATGCCTCGGAACTGCGTGGGCTACATGGCGATCTGCATCATGAAAACATCATGTTCTCCAGTCGCGGCTGGCTGGTGATAGATCCCGTCGGTCTGGTCGGTGAAGTGGGCTTTGGCGCCGCCAATATGTTCTACGATCCGGCTGACAGAGACGACCTTTGTCTCGATCCTAGACGCATTGCACAGATGGCGGACGCATTCTCTCGTGCGCTGGACGTCGATCCGCGTCGCCTGCTCGACCAGGCGTACGCTTATGGGTGCCTTTCCGCAGCTTGGAACGCGGATGGAGAAGAGGAGCA
612	gb|AF462019|+|26-656|ARO:3002681|catB9	ATGAACTTCTTTACGTCTCCATTTTCTGGGATTCCCTTAGATCAGCAAGTAACA...TAA	630.0	656	1231	575	630	ATGAACTTCTTTACGTCTCCATTTTCTGGGATTCCCTTAGATCAGCAAGTAACAAATCCGAACATTATTGTGGGAAAACACAGTTATTATTCTGGTTATTATCACGGGCACAGTTTCGATGATTGTGTGCGATATTTACATCCAGAAAGAGATGACGTTGATAAGTTAGTCATAGGGAGTTTTTGTTCTATAGGCTCTGGTGCTGTATTTATGATGGCCGGTAATCAAGGGCATCGCAGTGATTGGATAAGTACATTCCCATTTTTCTATCAGGATAATGATAATTTTGCAGATGCACGCGATGGTTTTACGCGTTCAGGAGACACAATTATTGGTCATGATGTGTGGATTGGCACTGAGGCTATGATAATGCCTGGGGTTAAAATTGGACATGGAGCGATAATCGCCAGTCGTTCAGTAGTGACTAAGGATGTTGCACCTTATGAAGTGGTCGGTTCAAATCCTGCTAAACATATCAAGTTTAGATTTTCTGATGTGGAAATAGCGATGTTACTTGAAATGGCATGGTGGAATTGGCCAGAATCGTGGTTGAAAGAGAGTATGCAGTCTCTGTG
613	gb|KJ584921.1|+|0-825|ARO:3001603|OXA-412	ATGAACGTTAAAGCACTCTTACTTATAACAAGCGCTATTTTTATTTCAGCCTGC...TAG	825.0	54149	54919	770	825	ATGAACATTAAAGCACTCTTACTTATAACAAGCGCTATTTTTATTTCAGCCTGCTCACCTTATATAGTGACTGCTAATCCAAATCACAGCGCTTCAAAATCTGATGTAAAAGCAGAGAAAATTAAAAATTTATTTAACGAAGCACACACTACGGGTGTTTTAGTTATCCAACAAGGCCAAACTCAACAAAGCTATGGTAATGATCTTGCTCGTGCTTCGACCGAGTATGTACCTGCTTCGACCTTCAAAATGCTTAATGCTTTGATCGGCCTTGAGCACCATAAGGCAACCACCACAGAAGTATTTAAGTGGGATGGTAAAAAAAGGTTATTCCCAGAATGGGAAAAGGACATGACCCTAGGCGATGCCATGAAAGCTTCCGCTATTCCAGTTTATCAAGATTTAGCTCGTCGTATTGGACTTGAGCTCATGTCTAAGGAAGTGAAGCGTGTTGGTTATGGCAATGCAGATATCGGTACCCAAGTCGATAATTTTTGGCTGGTGGGTCCTTTAAAAATTACTCCTCAGCAAGAGGCACAGTTTGCTTACAAGCTAGCTAATAAAACGCTTCCATTTAGCCAAAAAGTCCAAGATGAAGTGCAATCCATGCTATTCATAGAAGAAAAGAATGGAAACAAAATATACGCAAAAAGTGGTTGGGGATGGGATGTAAACCCACAAGTAGGCTGGTTAACTGGATGGGTTGTTCAGCCTCAAGGGAATATTGTAGCGTTCTCCCTTAACTTAGAAATGAAAAAAGGAATACCTAG
614	gb|AF250872|+|0-861|ARO:3000954|TEM-87	ATGAGTATTAAACATTTCCGTGTCGCCCTTATTCCCTTTTTTGCGGCATTTTGC...TAA	861.0	46	852	806	861	ATGAGTATTCAACATTTCCGTGTCGCCCTTATTCCCTTTTTTGCGGCATTTTGCCTTCCTGTTTTTGCTCACCCAGAAACGCTGGTGAAAGTAAAAGATGCTGAAGATCAGTTGGGTGCACGAGTGGGTTACATCGAGCTGGATCTCAACAGCGGTAAGATCCTTGAGAGTTTTCGCCCCGAAGAACGTTTTCCAATGATGAGCACTTTTAAAGTTCTGCTATGTGGTGCGGTATTATCCCGTGTTGACGCCGGGCAAGAGCAACTCGGTCGCCGCATACACTATTCTCAGAATGACTTGGTTGAGTACTCACCAGTCACAGAAAAGCATCTTACGGATGGCATGACAGTAAGAGAATTATGCAGTGCTGCCATAACCATGAGTGATAACACTGCGGCCAACTTACTTCTGACAACGATCGGAGGACCGAAGGAGCTAACCGCTTTTTTGCACAACATGGGGGATCATGTAACCCGCCTTGATCGTTGGGAACCGGAGCTGAATGAAGCCATACCAAACGACGAGCGTGACACCACGATGCCTGCAGCAATGGCAACAACGTTGCGCAAACTATTAACTGGCGAACTACTTACTCTAGCTTCCCGGCAACAATTAATAGACTGGATGGAGGCGGATAAAGTTGCAGGACCACTTCTGCGCTCGGCCCTTCCGGCTGGCTGGTTTATTGCTGATAAATCTGGAGCCGGTGAGCGTGGATCTCGCGGTATCATTGCAGCACTGGGGCCAGATGGTAAGCCCTCCCGTATCGTAGTTATCTACACGACGGGGAGTCAGGCAACTATGGA
615	gb|U15027|+|0-624|ARO:3002686|catP	ATGGTATTTGAAAAAATTGATAAAAATAGTTGGAACAGAAAAGAGTATTTTGAC...TAA	624.0	371	940	569	624	ATGGTATTTGAAAAAATTGATAAAAATAGTTGGAACAGAAAAGAGTATTTTGACCACTACTTTGCAAGTGTACCTTGTACATACAGCATGACCGTTAAAGTGGATATCACACAAATAAAGGAAAAGGGAATGAAACTATATCCTGCAATGCTTTATTATATTGCAATGATTGTAAACCGCCATTCAGAGTTTAGGACGGCAATCAATCAAGATGGTGAATTGGGGATATATGATGAGATGATACCAAGCTATACAATATTTCACAATGATACTGAAACATTTTCCAGCCTTTGGACTGAGTGTAAGTCTGACTTTAAATCATTTTTAGCAGATTATGAAAGTGATACGCAACGGTATGGAAACAATCATAGAATGGAAGGAAAGCCAAATGCTCCGGAAAACATTTTTAATGTATCTATGATACCGTGGTCAACCTTCGATGGCTTTAATCTGAATTTGCAGAAAGGATATGATTATTTGATTCCTATTTTTACTATGGGGAAATATTATAAAGAAGATAACAAAATTATACTTCCTTTGGCAATTCAAGTTCATCACGCAGTATGTGA
616	gb|JX310327|+|0-861|ARO:3001378|TEM-201	ATGAGTATTCAACATTTTCGTGTCGCCCTTATTCCCTTTTTTGCGGCATTTTGC...TAA	861.0	46	852	806	861	ATGAGTATTCAACATTTCCGTGTCGCCCTTATTCCCTTTTTTGCGGCATTTTGCCTTCCTGTTTTTGCTCACCCAGAAACGCTGGTGAAAGTAAAAGATGCTGAAGATCAGTTGGGTGCACGAGTGGGTTACATCGAGCTGGATCTCAACAGCGGTAAGATCCTTGAGAGTTTTCGCCCCGAAGAACGTTTTCCAATGATGAGCACTTTTAAAGTTCTGCTATGTGGTGCGGTATTATCCCGTGTTGACGCCGGGCAAGAGCAACTCGGTCGCCGCATACACTATTCTCAGAATGACTTGGTTGAGTACTCACCAGTCACAGAAAAGCATCTTACGGATGGCATGACAGTAAGAGAATTATGCAGTGCTGCCATAACCATGAGTGATAACACTGCGGCCAACTTACTTCTGACAACGATCGGAGGACCGAAGGAGCTAACCGCTTTTTTGCACAACATGGGGGATCATGTAACCCGCCTTGATCGTTGGGAACCGGAGCTGAATGAAGCCATACCAAACGACGAGCGTGACACCACGATGCCTGCAGCAATGGCAACAACGTTGCGCAAACTATTAACTGGCGAACTACTTACTCTAGCTTCCCGGCAACAATTAATAGACTGGATGGAGGCGGATAAAGTTGCAGGACCACTTCTGCGCTCGGCCCTTCCGGCTGGCTGGTTTATTGCTGATAAATCTGGAGCCGGTGAGCGTGGATCTCGCGGTATCATTGCAGCACTGGGGCCAGATGGTAAGCCCTCCCGTATCGTAGTTATCTACACGACGGGGAGTCAGGCAACTATGGA
617	gb|DQ823382|+|0-1569|ARO:3002830|vgaALC	ATGAAAATACTGTTAGAGGGACTTCATATAAAACATTATGTTCAAGATCGTTTA...TAA	1569.0	0	1045	1045	1569	ATAATAACTATATAGAAAAATTAGAACAGGATTTAAAAAATTGGCATGGAGCATTTATTATAGTTTCACATGATCGCGCTTTTTTAGATAACTTATGTACTACTATATGGGAAATTGACGAGGGGAGAATAACTGAATATAAGGGGAATTATAGTAACTATGTTGAACAAAAAGAATTAGAAAGACATCGAGAAGAATTAGAATATGAAAAATATGAAAAAGAAAAGAAACGATTGGAAAAAGCTATAAATATAAAAGAACAGAAAGCTCAACGAGCAACTAAAAAACCGAAAAACTTAAGTTCATCTGAAGGCAAAATAAAAGTAACAAAGCCATACTTTGCAAGTAAGCAAAAGAAGTTACGAAAAACTGTAAAATCTCTAGAAACCAGACTAGAAAAACTTGAAAGGGTCGAAAAGAGAAACGAACTTCCTCCAGTTAAAATGGATTTAGTGAACTTAAAAAGTGTAAAAAATAGAACTATAATACGTGGTGAAGATGTCTCGGGTACAATTGAAGGACGGGTATTGTGGAAAGCAAAAAGTTTTAGTATTCGCGGAGGAGACAAGATGGCAATTATCGGATCTAATGGTACAGGAAAGACAACGTTTATTAAAAAAATTGTGCATGGGAATCCTGGTATTTCGTTATCGCCATCTGTCAAAATCGGTTATTTTAGCCAAAAAATAGATACATTAGAATTAGATAAGAGTATTTTAGAAAATGTTCAATCTTCTTCACAACAAAATGAAACTCTTATTCGAACTATTCTAGCTAGAATGCATTTTTTTAGAGATGATGTTTATAAACCAATAAGTGTCTTAAGTGGTGGAGAGCGAGTTAAAGTAGCACTAACTAAAGTATTCTTAAGTGAAGTTAATACGTTGGTACTAGATGAACCAACAAACTTTCTTGATATGGAAGCTATAGAGGCGTTTGAATCTTTGTTAAAGGAATATAATGGCAGTATAATCTTTGTATCTCACGATCGTAAATTTATCGAAAAAGTAGCCACTCGAATAATGACAATTGATAATAAAGAAAT
618	gb|AY027590|+|112-973|ARO:3000955|TEM-88	ATGAGTATTCAACATTTTCGTGTCGCCCTTATTCCCTTTTTTGCGGCATTTTGC...TAA	861.0	46	852	806	861	ATGAGTATTCAACATTTCCGTGTCGCCCTTATTCCCTTTTTTGCGGCATTTTGCCTTCCTGTTTTTGCTCACCCAGAAACGCTGGTGAAAGTAAAAGATGCTGAAGATCAGTTGGGTGCACGAGTGGGTTACATCGAGCTGGATCTCAACAGCGGTAAGATCCTTGAGAGTTTTCGCCCCGAAGAACGTTTTCCAATGATGAGCACTTTTAAAGTTCTGCTATGTGGTGCGGTATTATCCCGTGTTGACGCCGGGCAAGAGCAACTCGGTCGCCGCATACACTATTCTCAGAATGACTTGGTTGAGTACTCACCAGTCACAGAAAAGCATCTTACGGATGGCATGACAGTAAGAGAATTATGCAGTGCTGCCATAACCATGAGTGATAACACTGCGGCCAACTTACTTCTGACAACGATCGGAGGACCGAAGGAGCTAACCGCTTTTTTGCACAACATGGGGGATCATGTAACCCGCCTTGATCGTTGGGAACCGGAGCTGAATGAAGCCATACCAAACGACGAGCGTGACACCACGATGCCTGCAGCAATGGCAACAACGTTGCGCAAACTATTAACTGGCGAACTACTTACTCTAGCTTCCCGGCAACAATTAATAGACTGGATGGAGGCGGATAAAGTTGCAGGACCACTTCTGCGCTCGGCCCTTCCGGCTGGCTGGTTTATTGCTGATAAATCTGGAGCCGGTGAGCGTGGATCTCGCGGTATCATTGCAGCACTGGGGCCAGATGGTAAGCCCTCCCGTATCGTAGTTATCTACACGACGGGGAGTCAGGCAACTATGGA
619	gb|KJ584922.1|+|0-825|ARO:3001604|OXA-413	ATGAACATTAAAACACTCTTACTTATAACAAGCGCTATTTTTATTTCAGCCTGC...TAG	825.0	54149	54919	770	825	ATGAACATTAAAGCACTCTTACTTATAACAAGCGCTATTTTTATTTCAGCCTGCTCACCTTATATAGTGACTGCTAATCCAAATCACAGCGCTTCAAAATCTGATGTAAAAGCAGAGAAAATTAAAAATTTATTTAACGAAGCACACACTACGGGTGTTTTAGTTATCCAACAAGGCCAAACTCAACAAAGCTATGGTAATGATCTTGCTCGTGCTTCGACCGAGTATGTACCTGCTTCGACCTTCAAAATGCTTAATGCTTTGATCGGCCTTGAGCACCATAAGGCAACCACCACAGAAGTATTTAAGTGGGATGGTAAAAAAAGGTTATTCCCAGAATGGGAAAAGGACATGACCCTAGGCGATGCCATGAAAGCTTCCGCTATTCCAGTTTATCAAGATTTAGCTCGTCGTATTGGACTTGAGCTCATGTCTAAGGAAGTGAAGCGTGTTGGTTATGGCAATGCAGATATCGGTACCCAAGTCGATAATTTTTGGCTGGTGGGTCCTTTAAAAATTACTCCTCAGCAAGAGGCACAGTTTGCTTACAAGCTAGCTAATAAAACGCTTCCATTTAGCCAAAAAGTCCAAGATGAAGTGCAATCCATGCTATTCATAGAAGAAAAGAATGGAAACAAAATATACGCAAAAAGTGGTTGGGGATGGGATGTAAACCCACAAGTAGGCTGGTTAACTGGATGGGTTGTTCAGCCTCAAGGGAATATTGTAGCGTTCTCCCTTAACTTAGAAATGAAAAAAGGAATACCTAG
620	gb|FJ194944|+|46-907|ARO:3001154|SHV-105	ATGCGTTATTTTCGCCTGTGTATTATCTCCCTGTTAGCCACCCTGCCGCTGGCG...TAA	861.0	16	822	806	861	ATGCGTTATATTCGCCTGTGTATTATCACCCTGTGAGCCACCCTGCCGCTGGCGGTACACGCCAGCCCGCAGCCGCTTGAGCAAATTAAACAAAGCGAAAGCCAGCTGTCGGGCCGCGTAGGCATGATAGAAATGGATCTGGCCAGCGGCCGCACGCTGACCGCCTGGCGCGCCGATGAACGCTTTCCCATGATGAGCACCTTTAAAGTAGTGCTCTGCGGCGCAGTGCTGGCGCGGGTGGATGCCGGTGACGAACAGCTGGAGCGAAAGATCCACTATCGCCAGCAGGATCTGGTGGACTACTCGCCGGTCAGCGAAAAACACCTTGCCGACGGCATGACGGTCGGCGAACTCTGCGCCGCCGCCATTACCATGAGCGATAACAGCGCCGCCAATCTGCTGCTGGCCACCGTCGGCGGCCCCGCAGGATTGACTGCCTTTTTGCGCCAGATCGGCGACAACGTCACCCGCCTTGACCGCTGGGAAACGGAACTGAATGAGGCGCTTCCCGGCGACGCCCGCGACACCACTACCCCGGCCAGCATGGCCGCGACCCTGCGCAAGCTGCTGACCAGCCAGCGTCTGAGCGCCCGTTCGCAACGGCAGCTGCTGCAGTGGATGGTGGACGATCGGGTCGCCGGACCGTTGATCCGCTCCGTGCTGCCGGCGGGCTGGTTTATCGCCGATAAGACCGGAGCTAGCAAGCGGGGTGCGCGCGGGATTGTCGCCCTGCTTGGCCCGAATAACAAAGCAGAGCGCATTGTGGTGATTTATCTGCGGGATACGCCGGCGAGCATGGCCGAGCG
621	gb|AY039040|+|188-1022|ARO:3000956|TEM-89	ATGAGTATTCAACATTTCCGTGTCGCCCTTATTCCCTTTTTTGCGGCATTTTGC...ATA	834.0	46	825	779	834	ATGAGTATTCAACATTTCCGTGTCGCCCTTATTCCCTTTTTTGCGGCATTTTGCCTTCCTGTTTTTGCTCACCCAGAAACGCTGGTGAAAGTAAAAGATGCTGAAGATCAGTTGGGTGCACGAGTGGGTTACATCGAGCTGGATCTCAACAGCGGTAAGATCCTTGAGAGTTTTCGCCCCGAAGAACGTTTTCCAATGATGAGCACTTTTAAAGTTCTGCTATGTGGTGCGGTATTATCCCGTGTTGACGCCGGGCAAGAGCAACTCGGTCGCCGCATACACTATTCTCAGAATGACTTGGTTGAGTACTCACCAGTCACAGAAAAGCATCTTACGGATGGCATGACAGTAAGAGAATTATGCAGTGCTGCCATAACCATGAGTGATAACACTGCGGCCAACTTACTTCTGACAACGATCGGAGGACCGAAGGAGCTAACCGCTTTTTTGCACAACATGGGGGATCATGTAACCCGCCTTGATCGTTGGGAACCGGAGCTGAATGAAGCCATACCAAACGACGAGCGTGACACCACGATGCCTGCAGCAATGGCAACAACGTTGCGCAAACTATTAACTGGCGAACTACTTACTCTAGCTTCCCGGCAACAATTAATAGACTGGATGGAGGCGGATAAAGTTGCAGGACCACTTCTGCGCTCGGCCCTTCCGGCTGGCTGGTTTATTGCTGATAAATCTGGAGCCGGTGAGCGTGGATCTCGCGGTATCATTGCAGCACTGGGGCCAGATGGTAAGCCCTCCCGTATCGTAGTTATCTA
622	gb|KC900516|+|0-858|ARO:3001382|TEM-205	ATGAGTATTCAACATTTCCGTGTCGCCCTTATTCCCTTTTTTGCGGCATTTTGC...TGG	858.0	46	849	803	858	ATGAGTATTCAACATTTCCGTGTCGCCCTTATTCCCTTTTTTGCGGCATTTTGCCTTCCTGTTTTTGCTCACCCAGAAACGCTGGTGAAAGTAAAAGATGCTGAAGATCAGTTGGGTGCACGAGTGGGTTACATCGAGCTGGATCTCAACAGCGGTAAGATCCTTGAGAGTTTTCGCCCCGAAGAACGTTTTCCAATGATGAGCACTTTTAAAGTTCTGCTATGTGGTGCGGTATTATCCCGTGTTGACGCCGGGCAAGAGCAACTCGGTCGCCGCATACACTATTCTCAGAATGACTTGGTTGAGTACTCACCAGTCACAGAAAAGCATCTTACGGATGGCATGACAGTAAGAGAATTATGCAGTGCTGCCATAACCATGAGTGATAACACTGCGGCCAACTTACTTCTGACAACGATCGGAGGACCGAAGGAGCTAACCGCTTTTTTGCACAACATGGGGGATCATGTAACCCGCCTTGATCGTTGGGAACCGGAGCTGAATGAAGCCATACCAAACGACGAGCGTGACACCACGATGCCTGCAGCAATGGCAACAACGTTGCGCAAACTATTAACTGGCGAACTACTTACTCTAGCTTCCCGGCAACAATTAATAGACTGGATGGAGGCGGATAAAGTTGCAGGACCACTTCTGCGCTCGGCCCTTCCGGCTGGCTGGTTTATTGCTGATAAATCTGGAGCCGGTGAGCGTGGATCTCGCGGTATCATTGCAGCACTGGGGCCAGATGGTAAGCCCTCCCGTATCGTAGTTATCTACACGACGGGGAGTCAGGCAACTAT
623	gb|KJ584914.1|+|0-825|ARO:3001605|OXA-414	ATGAACATTAAAGCACTCTTACTTATAACAAGCGCTATTTTTATTTCAGCCTGC...TAG	825.0	54149	54919	770	825	ATGAACATTAAAGCACTCTTACTTATAACAAGCGCTATTTTTATTTCAGCCTGCTCACCTTATATAGTGACTGCTAATCCAAATCACAGCGCTTCAAAATCTGATGTAAAAGCAGAGAAAATTAAAAATTTATTTAACGAAGCACACACTACGGGTGTTTTAGTTATCCAACAAGGCCAAACTCAACAAAGCTATGGTAATGATCTTGCTCGTGCTTCGACCGAGTATGTACCTGCTTCGACCTTCAAAATGCTTAATGCTTTGATCGGCCTTGAGCACCATAAGGCAACCACCACAGAAGTATTTAAGTGGGATGGTAAAAAAAGGTTATTCCCAGAATGGGAAAAGGACATGACCCTAGGCGATGCCATGAAAGCTTCCGCTATTCCAGTTTATCAAGATTTAGCTCGTCGTATTGGACTTGAGCTCATGTCTAAGGAAGTGAAGCGTGTTGGTTATGGCAATGCAGATATCGGTACCCAAGTCGATAATTTTTGGCTGGTGGGTCCTTTAAAAATTACTCCTCAGCAAGAGGCACAGTTTGCTTACAAGCTAGCTAATAAAACGCTTCCATTTAGCCAAAAAGTCCAAGATGAAGTGCAATCCATGCTATTCATAGAAGAAAAGAATGGAAACAAAATATACGCAAAAAGTGGTTGGGGATGGGATGTAAACCCACAAGTAGGCTGGTTAACTGGATGGGTTGTTCAGCCTCAAGGGAATATTGTAGCGTTCTCCCTTAACTTAGAAATGAAAAAAGGAATACCTAG
624	gb|CP001182.1|+|2873299-2874451|ARO:3003796|Acinetobacter_baumannii_AmpC_beta-lactamase	ATGCGATTTAAAAAAATTTCTTGTCTACTTTTATCCCCGCTTTTTATTTTTAGT...TAA	1152.0	63	1160	1097	1152	ATGCGATTTAAAAAAATTTCTTGTCTACTTTTATCCCCGCTTTTTATTTTTAGTACCTCAATTTATGCGGGCAATACACCAAAAGACCAAGAAATTAAAAAACTGGTAGATCAAAACTTTAAACCGTTATTAGAAAAATATGATGTGCCAGGTATGGCTGTGGGTGTTATTCAAAATAATAAAAAGTATGAAATGTATTATGGTCTTCAATCTGTTCAAGATAAAAAAGCCGTAAATAGCAGTACTATTTTTGAGCTAGGTTCTGTCAGTAAATTATTTACCGCGACAGCAGGTGGATATGCAAAAAATAAAGGAAAAATCTCTTTTGACGATACGCCTGGTAAGTATTGGAAAGAACTAAAAAATACACCGATTGACCAAGTTAACTTACTTCAACTCGCGACGTATACAAGTGGTAACCTTGCCTTGCAATTTCCAGATGAAGTAAAAACAGATCAGCAAGTTTTAACATTTTTTAAAGACTGGAAACCTAAAAACTCAATCGGTGAATATCGACAATATTCAAACCCAAGCATTGGTTTATTTGGAAAAGTTGTAGCTTTGTCTATGAATAAACCTTTCGACCAAGTCTTAGAAAAAACAATTTTTCCGGCCCTTGGCTTAAAACATAGCTATGTAAATGTACCTAAGACCCAGATGCAAAACTATGCTTTTGGCTATAACCAAGAAAATCAGCCGATTCGAGTTAACCCCGGCCCACTCGATGCCCCAGCATATGGCGTCAAATCGACACTACCCGACATGTTGAGTTTTATTCATGCCAACCTAAATCCACAAAAATATCCAGCAGATATTCAACGGGCAATTAATGAAACACATCAGGGTCGCTATCAAGTAAATACCATGTATCAGGCACTCGGTTGGGAAGAGTTTTCTTATCCGGCAACGTTACAAACTTTATTAGACAGTAATTCAGAACAGATTGTGATGAAACCTAATAAAGTGACTGCTATTTCAAAGGAACCTTCAGTTAAGATGTACCATAAAACTGGCTCAACTACCGGTTTCGGAACATATGTGGTGTTTATTCCTAAAGAAAATATTGGTTTAGTCATGTTAACCAATAAACGTATTCC
625	gb|AM941847|+|0-861|ARO:3001155|SHV-106	ATGCGTTTTATTCGCCTGTGTATTATCTCCCTGTTAGCCACCCTGCCGCTGGCG...TAA	861.0	16	822	806	861	ATGCGTTATATTCGCCTGTGTATTATCACCCTGTGAGCCACCCTGCCGCTGGCGGTACACGCCAGCCCGCAGCCGCTTGAGCAAATTAAACAAAGCGAAAGCCAGCTGTCGGGCCGCGTAGGCATGATAGAAATGGATCTGGCCAGCGGCCGCACGCTGACCGCCTGGCGCGCCGATGAACGCTTTCCCATGATGAGCACCTTTAAAGTAGTGCTCTGCGGCGCAGTGCTGGCGCGGGTGGATGCCGGTGACGAACAGCTGGAGCGAAAGATCCACTATCGCCAGCAGGATCTGGTGGACTACTCGCCGGTCAGCGAAAAACACCTTGCCGACGGCATGACGGTCGGCGAACTCTGCGCCGCCGCCATTACCATGAGCGATAACAGCGCCGCCAATCTGCTGCTGGCCACCGTCGGCGGCCCCGCAGGATTGACTGCCTTTTTGCGCCAGATCGGCGACAACGTCACCCGCCTTGACCGCTGGGAAACGGAACTGAATGAGGCGCTTCCCGGCGACGCCCGCGACACCACTACCCCGGCCAGCATGGCCGCGACCCTGCGCAAGCTGCTGACCAGCCAGCGTCTGAGCGCCCGTTCGCAACGGCAGCTGCTGCAGTGGATGGTGGACGATCGGGTCGCCGGACCGTTGATCCGCTCCGTGCTGCCGGCGGGCTGGTTTATCGCCGATAAGACCGGAGCTAGCAAGCGGGGTGCGCGCGGGATTGTCGCCCTGCTTGGCCCGAATAACAAAGCAGAGCGCATTGTGGTGATTTATCTGCGGGATACGCCGGCGAGCATGGCCGAGCG
626	gb|KM433671|+|0-822|ARO:3003160|OXA-422	ATGAATAAATATTTTACTTGCTATGTGGTTGCTTCTCCTTTTCTTTCTGGTTGT...TAA	822.0	80	847	767	822	ATGAATAAATATTTTACTTGCTATGTGGTTGCTTCTCTTTTTCTTTCTGGTTGTACGGTTCAGCATAATTTAATAAATGAAACCCCGAGTCAGATTGTTCAAGGACATAATCAGGTGATTCATCAATACTTTGATGAAAAAAACACCTCAGGTGTGCTGGTTATTCAAACAGATAAAAAAATTAATCTATATGGTAATGCTCTAAGCCGCGCAAATACAGAATATGTGCCAGCCTCTACATTTAAAATGTTGAATGCCCTGATCGGATTGGAGAACCAGAAAACGGATATTAATGAAATATTTAAATGGAAGGGCGAGAAAAGGTCATTTACCGCTTGGGAAAAAGACATGACACTAGGAGAAGCCATGAAGCTTTCTGCAGTCCCAGTCTATCAGGAACTTGCGCGACGTATCGGTCTTGATCTCATGCAAAAAGAAGTAAAACGTATTGGTTTCGGTAATGCTGAAATTGGACAGCAGGTTGATAATTTCTGGTTGGTAGGACCATTAAAGGTTACGCCTATTCAAGAGGTAGAGTTTGTTTCCCAATTAGCACATACACAGCTTCCATTTAGTGAAAAAGTGCAGGCTAATGTAAAAAATATGCTTCTTTTAGAAGAGAGTAATGGCTACAAAATTTTTGGAAAGACTGGTTGGGCAATGGATATAAAACCACAAGTGGGCTGGTTGACCGGCTGGGTTGAGCAGCCAGATGGAAAAATTGTCGCTTTTGCATTAAATATGGAAATGCGGTCAGAAATGCCGGC
627	gb|KC783461|+|0-861|ARO:3001383|TEM-206	ATGAGTATTCAACATTTTCGTGTCACCCTTATTCCCTTTTTTGCGGCATTTTGC...TAA	861.0	46	852	806	861	ATGAGTATTCAACATTTCCGTGTCGCCCTTATTCCCTTTTTTGCGGCATTTTGCCTTCCTGTTTTTGCTCACCCAGAAACGCTGGTGAAAGTAAAAGATGCTGAAGATCAGTTGGGTGCACGAGTGGGTTACATCGAGCTGGATCTCAACAGCGGTAAGATCCTTGAGAGTTTTCGCCCCGAAGAACGTTTTCCAATGATGAGCACTTTTAAAGTTCTGCTATGTGGTGCGGTATTATCCCGTGTTGACGCCGGGCAAGAGCAACTCGGTCGCCGCATACACTATTCTCAGAATGACTTGGTTGAGTACTCACCAGTCACAGAAAAGCATCTTACGGATGGCATGACAGTAAGAGAATTATGCAGTGCTGCCATAACCATGAGTGATAACACTGCGGCCAACTTACTTCTGACAACGATCGGAGGACCGAAGGAGCTAACCGCTTTTTTGCACAACATGGGGGATCATGTAACCCGCCTTGATCGTTGGGAACCGGAGCTGAATGAAGCCATACCAAACGACGAGCGTGACACCACGATGCCTGCAGCAATGGCAACAACGTTGCGCAAACTATTAACTGGCGAACTACTTACTCTAGCTTCCCGGCAACAATTAATAGACTGGATGGAGGCGGATAAAGTTGCAGGACCACTTCTGCGCTCGGCCCTTCCGGCTGGCTGGTTTATTGCTGATAAATCTGGAGCCGGTGAGCGTGGATCTCGCGGTATCATTGCAGCACTGGGGCCAGATGGTAAGCCCTCCCGTATCGTAGTTATCTACACGACGGGGAGTCAGGCAACTATGGA
628	gb|AM941848|+|0-861|ARO:3001156|SHV-107	ATGCGTTATATTCGCCTGTGTATTATCTCCCTGTTAGCCACCCTGCCGCTGGCG...TAA	861.0	16	822	806	861	ATGCGTTATATTCGCCTGTGTATTATCACCCTGTGAGCCACCCTGCCGCTGGCGGTACACGCCAGCCCGCAGCCGCTTGAGCAAATTAAACAAAGCGAAAGCCAGCTGTCGGGCCGCGTAGGCATGATAGAAATGGATCTGGCCAGCGGCCGCACGCTGACCGCCTGGCGCGCCGATGAACGCTTTCCCATGATGAGCACCTTTAAAGTAGTGCTCTGCGGCGCAGTGCTGGCGCGGGTGGATGCCGGTGACGAACAGCTGGAGCGAAAGATCCACTATCGCCAGCAGGATCTGGTGGACTACTCGCCGGTCAGCGAAAAACACCTTGCCGACGGCATGACGGTCGGCGAACTCTGCGCCGCCGCCATTACCATGAGCGATAACAGCGCCGCCAATCTGCTGCTGGCCACCGTCGGCGGCCCCGCAGGATTGACTGCCTTTTTGCGCCAGATCGGCGACAACGTCACCCGCCTTGACCGCTGGGAAACGGAACTGAATGAGGCGCTTCCCGGCGACGCCCGCGACACCACTACCCCGGCCAGCATGGCCGCGACCCTGCGCAAGCTGCTGACCAGCCAGCGTCTGAGCGCCCGTTCGCAACGGCAGCTGCTGCAGTGGATGGTGGACGATCGGGTCGCCGGACCGTTGATCCGCTCCGTGCTGCCGGCGGGCTGGTTTATCGCCGATAAGACCGGAGCTAGCAAGCGGGGTGCGCGCGGGATTGTCGCCCTGCTTGGCCCGAATAACAAAGCAGAGCGCATTGTGGTGATTTATCTGCGGGATACGCCGGCGAGCATGGCCGAGCG
629	gb|KC818234|+|0-861|ARO:3001384|TEM-207	ATGAGTATTCAACATTTTCGTGTCGCCCTTATTCCCTTTTTTGCGGCATTTTGC...TAA	861.0	46	852	806	861	ATGAGTATTCAACATTTCCGTGTCGCCCTTATTCCCTTTTTTGCGGCATTTTGCCTTCCTGTTTTTGCTCACCCAGAAACGCTGGTGAAAGTAAAAGATGCTGAAGATCAGTTGGGTGCACGAGTGGGTTACATCGAGCTGGATCTCAACAGCGGTAAGATCCTTGAGAGTTTTCGCCCCGAAGAACGTTTTCCAATGATGAGCACTTTTAAAGTTCTGCTATGTGGTGCGGTATTATCCCGTGTTGACGCCGGGCAAGAGCAACTCGGTCGCCGCATACACTATTCTCAGAATGACTTGGTTGAGTACTCACCAGTCACAGAAAAGCATCTTACGGATGGCATGACAGTAAGAGAATTATGCAGTGCTGCCATAACCATGAGTGATAACACTGCGGCCAACTTACTTCTGACAACGATCGGAGGACCGAAGGAGCTAACCGCTTTTTTGCACAACATGGGGGATCATGTAACCCGCCTTGATCGTTGGGAACCGGAGCTGAATGAAGCCATACCAAACGACGAGCGTGACACCACGATGCCTGCAGCAATGGCAACAACGTTGCGCAAACTATTAACTGGCGAACTACTTACTCTAGCTTCCCGGCAACAATTAATAGACTGGATGGAGGCGGATAAAGTTGCAGGACCACTTCTGCGCTCGGCCCTTCCGGCTGGCTGGTTTATTGCTGATAAATCTGGAGCCGGTGAGCGTGGATCTCGCGGTATCATTGCAGCACTGGGGCCAGATGGTAAGCCCTCCCGTATCGTAGTTATCTACACGACGGGGAGTCAGGCAACTATGGA
630	gb|CP006845.1|+|539695-540745|ARO:3002814|clbA	ATGCAACAAAAAAACAAGTATATAAGAATCCAAGAGTTCCTGAAGCAAAATAAA...TAA	1050.0	1,0	304,426	303;426	1050	TTTAATGAAATAACGGTTTTTCCTAAATCCTTGAGAAAATTGTTAATGAATGAGTTTGGAGAGTCAATTTTAAATATTGCTGCTTTAAAAGTGCAGCATTCTGAGCAAGTAACAAAAGTCTTATTTGAAATTTCAGGAGACGAAAAAATAGAAACGGTCAATATCAAATATAAAGCTGGCTGGGAGTCATTTTGTATATCCTCGTAGTGCGGCTGTCATTTTGGCTGTACATTTTGTGCAACAGGAGATATTGGTTTAAAACGCAGCTTAACATCAGATGAAATGACTGACCAAATGTTGTAC;CAGATGAAATGAGTGACCAAATTTTGTACATTCACTTAAAAGGACATTCAATTGACAGTATTTCTTTTATGGGAATGGGAGAAGCATTAGCTAATGTACAAGTTTTTGATGCTTCACATGTGCTTACAAATCCGGAGTTGTTTGCTTTAAGCCCTCGTCGCTTATCTATTTCGACCATAGGTATTATTCCGGGCAATAAAAAAATCACTCAGGATTATCCGCAGGTCAACCTGCCGTTTTCATTACATTCTCCTTTTAATGAACAGCGAAGCAAGTTAATCCCGATTAATGAACGCTTCCCGTTATTGGAGGTAATGGACACATTAGATGAGCATATACGTGTGACCTCAAGAAAAGTTTATATTGCTTATATTATGCTGCCGGGAGTTAATGATTCTATTGATCATGCGAATGAAGTAGTACGTC
631	gb|KC865667|+|183-1044|ARO:3001385|TEM-208	ATGAGTATTCAACATTTTCGTGTCGCCCTTATTCCCTTTTTTGCGGCATTTTGC...TAA	861.0	46	852	806	861	ATGAGTATTCAACATTTCCGTGTCGCCCTTATTCCCTTTTTTGCGGCATTTTGCCTTCCTGTTTTTGCTCACCCAGAAACGCTGGTGAAAGTAAAAGATGCTGAAGATCAGTTGGGTGCACGAGTGGGTTACATCGAGCTGGATCTCAACAGCGGTAAGATCCTTGAGAGTTTTCGCCCCGAAGAACGTTTTCCAATGATGAGCACTTTTAAAGTTCTGCTATGTGGTGCGGTATTATCCCGTGTTGACGCCGGGCAAGAGCAACTCGGTCGCCGCATACACTATTCTCAGAATGACTTGGTTGAGTACTCACCAGTCACAGAAAAGCATCTTACGGATGGCATGACAGTAAGAGAATTATGCAGTGCTGCCATAACCATGAGTGATAACACTGCGGCCAACTTACTTCTGACAACGATCGGAGGACCGAAGGAGCTAACCGCTTTTTTGCACAACATGGGGGATCATGTAACCCGCCTTGATCGTTGGGAACCGGAGCTGAATGAAGCCATACCAAACGACGAGCGTGACACCACGATGCCTGCAGCAATGGCAACAACGTTGCGCAAACTATTAACTGGCGAACTACTTACTCTAGCTTCCCGGCAACAATTAATAGACTGGATGGAGGCGGATAAAGTTGCAGGACCACTTCTGCGCTCGGCCCTTCCGGCTGGCTGGTTTATTGCTGATAAATCTGGAGCCGGTGAGCGTGGATCTCGCGGTATCATTGCAGCACTGGGGCCAGATGGTAAGCCCTCCCGTATCGTAGTTATCTACACGACGGGGAGTCAGGCAACTATGGA
632	gb|FO834906.1|+|304977-306633|ARO:3005053|ArnT	ATGAAAAGCATTCGCTATGGCGTCTCTCTGATTGCGCTGTTTGCGCTGTATTAT...TGA	1656.0	684	2285	1601	1656	ATGAAAAGCATTCGCTATGGCGTCTCTCTGATTGCGCTGTTTGCGCTGTATTATCTGCTGCCGCTCAATTTCCGTTTGCTCTGGCAACCCGACGAAACCCGCTACGCGGAGATCAGCCGTGAAATGCTGGCCACCGGCGACTGGGTGGTACCGCATTTTCTCGGCCTGCGCTACTTCGAAAAACCGATTGCCGGTTACTGGATCAACAGTATCGGTCAGTGGCTGTTTGGCCATAATAACTTCGGCGTACGCTTCGGGTCGGTCTTCGCCATCACCATGACCGCCCTGCTGGTGGCCTGGCTGGCGTGGCGGATCTTTCGTGATAAGCGGGTAGCTATCCTGTCGCCGATTATCTTCCTCACCGCGATGCTGGTGTATGCGATTGGCACCTATGCGGTGCTGGACCCGATGATCACCCTGTGGCTGGCGCTGGCGATGTGCAGCTTCTGGGGCGCGGCGCAGGCGCACAGCCGCAGCGGCAAAATACTGGGCTACGTGCTGCTGGGCGTCGCCTGCGGGATGGGGGTGATGACCAAGGGCTTCCTGGCGCTGGCGGTGCCGGTGGTGGGCGTTCTGCCGTGGGTGATCGCTCGTAAACGCTGGCGTGAAGTGCTGACCTACGGCTGGCTGGCGGTAATCGTCTGTACGCTGGTGGTGCTGCCCTGGGGGCTGGCTATCGCTCAGCGCGAGCCGGACTTCTGGCGCTACTTCTTCTGGGTCGAGCATATTCAGCGTTTTGCTGAAAAAGACGCCCAGCACAAAGCGCCGTTCTGGTACTACATCCCGTTCCTGATCGCCGGCAGTCTGCCGTGGCTGGCCCTGCTGCCGGGGGCGCTAAAGCGCGGCTGGCTTGAGCGCGATGAGGCCCGCGGCGCGCTGTATCTGTTAGGTTGGGTGGCGATGCCGTTCCTGTTCTTCAGTATCGCCAAAGGCAAACTGCCGACCTATATTCTGCCGTGCTTTGCGCCGCTGTCGATCCTGATGGCCCGCTACGCGCTGGAGGCCGCAAAGACCGGCGCGAAAGCGTTGCGCATCAACGGGATGATCAACCTGGGCGTTGGTTTGCTGGGGCTTATCGCCGTGCTGGTGGTCTCGCCGTGGGGCTTCATGCATAAGCCGGTGTGGACCAAGATTGAGCTGTATAAATGTCTGCTGGCGGCGATCGCTTTTGCCGTCTGGGCGCTGATGGGCTGGCTGGCGATGAAAGACTCTGGCCGCCGCTGGAGCCTCGCCGCGCTCTGTCCGCTCGGCCTGGCGCTGCTGGTGGGCTTCGCCATCCCGGACCGGGTTATCGACAGCAAACAGCCGCAGTTCCTCGTGGATATCGTCAGCGAATCCCTGCAGCCCAGCCGTTACGTCCTGACCAACAACGTTGGGATCGCCGGCGGCCTGGCCTGGGAGCTGAAGCGAAGCGATATTATTATGTTCGACAAACAGGGTGAGCTGAAGTACGGTCTCGACTGGCCGGATGCTCAGGGAAGCTTTGTCAGCCAGGCCGGTTTTGCCGACTGGCTGGCCGCGCATCGTCAGCAGGGGCCGGTCTCGCTGGTGCTGTTGATGGATAAAGGAGAGAGTATGCTCGACTTACCGTTACCGAAACC
633	gb|KF240808|+|0-861|ARO:3001386|TEM-209	ATGAGTATTCAACATTTCCGTGTCGCCCTTATTCCCTTTTTTGCGGCATTTTGC...TAA	861.0	46	852	806	861	ATGAGTATTCAACATTTCCGTGTCGCCCTTATTCCCTTTTTTGCGGCATTTTGCCTTCCTGTTTTTGCTCACCCAGAAACGCTGGTGAAAGTAAAAGATGCTGAAGATCAGTTGGGTGCACGAGTGGGTTACATCGAGCTGGATCTCAACAGCGGTAAGATCCTTGAGAGTTTTCGCCCCGAAGAACGTTTTCCAATGATGAGCACTTTTAAAGTTCTGCTATGTGGTGCGGTATTATCCCGTGTTGACGCCGGGCAAGAGCAACTCGGTCGCCGCATACACTATTCTCAGAATGACTTGGTTGAGTACTCACCAGTCACAGAAAAGCATCTTACGGATGGCATGACAGTAAGAGAATTATGCAGTGCTGCCATAACCATGAGTGATAACACTGCGGCCAACTTACTTCTGACAACGATCGGAGGACCGAAGGAGCTAACCGCTTTTTTGCACAACATGGGGGATCATGTAACCCGCCTTGATCGTTGGGAACCGGAGCTGAATGAAGCCATACCAAACGACGAGCGTGACACCACGATGCCTGCAGCAATGGCAACAACGTTGCGCAAACTATTAACTGGCGAACTACTTACTCTAGCTTCCCGGCAACAATTAATAGACTGGATGGAGGCGGATAAAGTTGCAGGACCACTTCTGCGCTCGGCCCTTCCGGCTGGCTGGTTTATTGCTGATAAATCTGGAGCCGGTGAGCGTGGATCTCGCGGTATCATTGCAGCACTGGGGCCAGATGGTAAGCCCTCCCGTATCGTAGTTATCTACACGACGGGGAGTCAGGCAACTATGGA
634	gb|HM751100|+|0-861|ARO:3001157|SHV-108	ATGCGTTATATTCGCCTGTGTATTATCTCCCTGTTAGCCACCCTGCCGCTGGCG...TAA	861.0	16	822	806	861	ATGCGTTATATTCGCCTGTGTATTATCACCCTGTGAGCCACCCTGCCGCTGGCGGTACACGCCAGCCCGCAGCCGCTTGAGCAAATTAAACAAAGCGAAAGCCAGCTGTCGGGCCGCGTAGGCATGATAGAAATGGATCTGGCCAGCGGCCGCACGCTGACCGCCTGGCGCGCCGATGAACGCTTTCCCATGATGAGCACCTTTAAAGTAGTGCTCTGCGGCGCAGTGCTGGCGCGGGTGGATGCCGGTGACGAACAGCTGGAGCGAAAGATCCACTATCGCCAGCAGGATCTGGTGGACTACTCGCCGGTCAGCGAAAAACACCTTGCCGACGGCATGACGGTCGGCGAACTCTGCGCCGCCGCCATTACCATGAGCGATAACAGCGCCGCCAATCTGCTGCTGGCCACCGTCGGCGGCCCCGCAGGATTGACTGCCTTTTTGCGCCAGATCGGCGACAACGTCACCCGCCTTGACCGCTGGGAAACGGAACTGAATGAGGCGCTTCCCGGCGACGCCCGCGACACCACTACCCCGGCCAGCATGGCCGCGACCCTGCGCAAGCTGCTGACCAGCCAGCGTCTGAGCGCCCGTTCGCAACGGCAGCTGCTGCAGTGGATGGTGGACGATCGGGTCGCCGGACCGTTGATCCGCTCCGTGCTGCCGGCGGGCTGGTTTATCGCCGATAAGACCGGAGCTAGCAAGCGGGGTGCGCGCGGGATTGTCGCCCTGCTTGGCCCGAATAACAAAGCAGAGCGCATTGTGGTGATTTATCTGCGGGATACGCCGGCGAGCATGGCCGAGCG
635	gb|AE004091.2|+|3450837-3451509|ARO:3005063|cprR	ATGCATATCCACGTACTCGTCGTCGAAGACAACTTCGATCTCGCCGGCACCGTC...TGA	672.0	2	619	617	672	ATGCATATCCACGTACTCGTCGTCGAAGACAACTTCGATCTCGCCGGCACCGTCATCGACTACCTCGAGGCCGCCGGGGTGGTCTGCGATCACGCCCGCGACGGCCAGGCCGGCCTCAACCTGGCGCGCGCCAACCGCTACGACGTGATCCTGCTGGACATCATGCTGCCGCGCATCAACGGCCGGCAGGTCTGTCGCCAGCTGCGCGAAGCCGGCCTGCAGACCCCGGTACTCATGCTCACCGCCCTGGATACCCTGCAGGACAAGCTCGACGGCTTCGACGCCGGCGCCGACGACTATCTGCTCAAGCCCTTCGAACTGCCGGAGCTGCTGGTCCGCCTGCAAGCCCTCAGCCGGCGCCGCAGCGGCCAGGCCCAGCGCCTGCAGGTCGACGACCTGGTGATGGACCTCGACAGCCGCCAGGCCAGCCGCGGCGGCACGCCCCTGGCGCTGTCCCCCACCGCCTGGAAGATCCTCGAGTGCCTGATGCGCGCCAGCCCCGCGCTGGTCACCCGCGAGCAGCTGGGGCGCAGCGTCTGGGGCGACGAGCCGCCGGAAAGCAACACCCTCAACGTGCACATGCACCACCTGCGCAGCACCGTCGACAAGGGGTTCGC
636	gb|Y17582|+|0-858|ARO:3000892|TEM-21	ATGAGTATTCAACATTTCCGTGTCGCCCTTATTCCCTTTTTTGCGGCATTTTGC...TGG	858.0	46	849	803	858	ATGAGTATTCAACATTTCCGTGTCGCCCTTATTCCCTTTTTTGCGGCATTTTGCCTTCCTGTTTTTGCTCACCCAGAAACGCTGGTGAAAGTAAAAGATGCTGAAGATCAGTTGGGTGCACGAGTGGGTTACATCGAGCTGGATCTCAACAGCGGTAAGATCCTTGAGAGTTTTCGCCCCGAAGAACGTTTTCCAATGATGAGCACTTTTAAAGTTCTGCTATGTGGTGCGGTATTATCCCGTGTTGACGCCGGGCAAGAGCAACTCGGTCGCCGCATACACTATTCTCAGAATGACTTGGTTGAGTACTCACCAGTCACAGAAAAGCATCTTACGGATGGCATGACAGTAAGAGAATTATGCAGTGCTGCCATAACCATGAGTGATAACACTGCGGCCAACTTACTTCTGACAACGATCGGAGGACCGAAGGAGCTAACCGCTTTTTTGCACAACATGGGGGATCATGTAACCCGCCTTGATCGTTGGGAACCGGAGCTGAATGAAGCCATACCAAACGACGAGCGTGACACCACGATGCCTGCAGCAATGGCAACAACGTTGCGCAAACTATTAACTGGCGAACTACTTACTCTAGCTTCCCGGCAACAATTAATAGACTGGATGGAGGCGGATAAAGTTGCAGGACCACTTCTGCGCTCGGCCCTTCCGGCTGGCTGGTTTATTGCTGATAAATCTGGAGCCGGTGAGCGTGGATCTCGCGGTATCATTGCAGCACTGGGGCCAGATGGTAAGCCCTCCCGTATCGTAGTTATCTACACGACGGGGAGTCAGGCAACTAT
637	gb|EU418913|+|16-877|ARO:3001158|SHV-109	ATGCGTTATATTCGCCGGTGTATTATCTCCCTGTTAGCCACCCTGCCGCTGGCG...TAA	861.0	16	822	806	861	ATGCGTTATATTCGCCTGTGTATTATCACCCTGTGAGCCACCCTGCCGCTGGCGGTACACGCCAGCCCGCAGCCGCTTGAGCAAATTAAACAAAGCGAAAGCCAGCTGTCGGGCCGCGTAGGCATGATAGAAATGGATCTGGCCAGCGGCCGCACGCTGACCGCCTGGCGCGCCGATGAACGCTTTCCCATGATGAGCACCTTTAAAGTAGTGCTCTGCGGCGCAGTGCTGGCGCGGGTGGATGCCGGTGACGAACAGCTGGAGCGAAAGATCCACTATCGCCAGCAGGATCTGGTGGACTACTCGCCGGTCAGCGAAAAACACCTTGCCGACGGCATGACGGTCGGCGAACTCTGCGCCGCCGCCATTACCATGAGCGATAACAGCGCCGCCAATCTGCTGCTGGCCACCGTCGGCGGCCCCGCAGGATTGACTGCCTTTTTGCGCCAGATCGGCGACAACGTCACCCGCCTTGACCGCTGGGAAACGGAACTGAATGAGGCGCTTCCCGGCGACGCCCGCGACACCACTACCCCGGCCAGCATGGCCGCGACCCTGCGCAAGCTGCTGACCAGCCAGCGTCTGAGCGCCCGTTCGCAACGGCAGCTGCTGCAGTGGATGGTGGACGATCGGGTCGCCGGACCGTTGATCCGCTCCGTGCTGCCGGCGGGCTGGTTTATCGCCGATAAGACCGGAGCTAGCAAGCGGGGTGCGCGCGGGATTGTCGCCCTGCTTGGCCCGAATAACAAAGCAGAGCGCATTGTGGTGATTTATCTGCGGGATACGCCGGCGAGCATGGCCGAGCG
638	gb|KF513179|+|0-861|ARO:3001388|TEM-211	ATGAGTATTAAACATTTCCGTGTCGCCCTTATTCCCTTTTTTGCGGCATTTTGC...TAA	861.0	46	852	806	861	ATGAGTATTCAACATTTCCGTGTCGCCCTTATTCCCTTTTTTGCGGCATTTTGCCTTCCTGTTTTTGCTCACCCAGAAACGCTGGTGAAAGTAAAAGATGCTGAAGATCAGTTGGGTGCACGAGTGGGTTACATCGAGCTGGATCTCAACAGCGGTAAGATCCTTGAGAGTTTTCGCCCCGAAGAACGTTTTCCAATGATGAGCACTTTTAAAGTTCTGCTATGTGGTGCGGTATTATCCCGTGTTGACGCCGGGCAAGAGCAACTCGGTCGCCGCATACACTATTCTCAGAATGACTTGGTTGAGTACTCACCAGTCACAGAAAAGCATCTTACGGATGGCATGACAGTAAGAGAATTATGCAGTGCTGCCATAACCATGAGTGATAACACTGCGGCCAACTTACTTCTGACAACGATCGGAGGACCGAAGGAGCTAACCGCTTTTTTGCACAACATGGGGGATCATGTAACCCGCCTTGATCGTTGGGAACCGGAGCTGAATGAAGCCATACCAAACGACGAGCGTGACACCACGATGCCTGCAGCAATGGCAACAACGTTGCGCAAACTATTAACTGGCGAACTACTTACTCTAGCTTCCCGGCAACAATTAATAGACTGGATGGAGGCGGATAAAGTTGCAGGACCACTTCTGCGCTCGGCCCTTCCGGCTGGCTGGTTTATTGCTGATAAATCTGGAGCCGGTGAGCGTGGATCTCGCGGTATCATTGCAGCACTGGGGCCAGATGGTAAGCCCTCCCGTATCGTAGTTATCTACACGACGGGGAGTCAGGCAACTATGGA
639	gb|AY453161|+|500-1430|ARO:3000090|BLA1	ATGATAGTTTTGAAAAACAAGAAAATGCTAAAAATAGGGATGTGTGTTGGTATA...TGA	930.0	455,0	951,287	496;287	930	ATGATAGTTTTGAAAAACAAGAAAATGCTAAAAATAGGGATGTGTGTTGGTATATTAGGTTTAAGTATTACAAGCCTAGTAACTTTTACAGGAGGTGCATTGCAAGTTGAAGCGAAAGAAAAGACTGGACAAGTGAAACATAAAAATCAGGCGACGCATAAAGAGTTCTCTCAACTTGAGAAAAAATTTGATGCTCGATTAGGTGTATATGCGATTGATACTGGTACAAATCAAACAATCTCTTATCGATCTAACGAAAGATTTGCCTTCGCATCAACCTACAAGGCTTTAGCAGCAGGAGTATTACTACAGCAAAACTCAATTGATTCATTAAATGAAGTAATCACATATACGAAAGAAGACTTAGTGGATTATTCACCTGTTACAGAGAAACATGTAGATACTGGAATGAAACTAGGAGAAATTGCTGAGGCAGCTGTTCGTTCAAGCGATAATACTGCAGGGAACATTTTATTTAATAAAATAGGAGGACCGA;ATTCGTGACACCAGTACAGCGAAAGCAATTGCTACGAATCTTAAAGCTTTTACGGCCGGAAATGCGCTTCCAAATCATAAACGTAACATTCTTACAAAGTGGATGAAAGGAAATGCTACAGGAGACAAACTTATTCGTGCAGGTGTGCCTACTAACTGGGTAGTTGCAGATAAATCAGGAGCTGGAAGTTACGGGACACGAAATGATATTGCTATCGTTTGGCCACCAAATAGAGCACCTATTATCATCGCAATTTTATCTAGTAAAGATGAAAAAGGGGCTACCTA
640	gb|X98101|+|73-934|ARO:3001070|SHV-11	ATGCGTTATATTCGCCTGTGTATTATCTCCCTGTTAGCCACCCTGCCGCTGGCG...TAA	861.0	16	822	806	861	ATGCGTTATATTCGCCTGTGTATTATCACCCTGTGAGCCACCCTGCCGCTGGCGGTACACGCCAGCCCGCAGCCGCTTGAGCAAATTAAACAAAGCGAAAGCCAGCTGTCGGGCCGCGTAGGCATGATAGAAATGGATCTGGCCAGCGGCCGCACGCTGACCGCCTGGCGCGCCGATGAACGCTTTCCCATGATGAGCACCTTTAAAGTAGTGCTCTGCGGCGCAGTGCTGGCGCGGGTGGATGCCGGTGACGAACAGCTGGAGCGAAAGATCCACTATCGCCAGCAGGATCTGGTGGACTACTCGCCGGTCAGCGAAAAACACCTTGCCGACGGCATGACGGTCGGCGAACTCTGCGCCGCCGCCATTACCATGAGCGATAACAGCGCCGCCAATCTGCTGCTGGCCACCGTCGGCGGCCCCGCAGGATTGACTGCCTTTTTGCGCCAGATCGGCGACAACGTCACCCGCCTTGACCGCTGGGAAACGGAACTGAATGAGGCGCTTCCCGGCGACGCCCGCGACACCACTACCCCGGCCAGCATGGCCGCGACCCTGCGCAAGCTGCTGACCAGCCAGCGTCTGAGCGCCCGTTCGCAACGGCAGCTGCTGCAGTGGATGGTGGACGATCGGGTCGCCGGACCGTTGATCCGCTCCGTGCTGCCGGCGGGCTGGTTTATCGCCGATAAGACCGGAGCTAGCAAGCGGGGTGCGCGCGGGATTGTCGCCCTGCTTGGCCCGAATAACAAAGCAGAGCGCATTGTGGTGATTTATCTGCGGGATACGCCGGCGAGCATGGCCGAGCG
641	gb|KF663615|+|0-858|ARO:3001390|TEM-213	ATGAGTATTCAACATTTCCGTGTCGCCCTTATTCCCTTTTTTGCGGCATTTTGC...TGG	858.0	46	849	803	858	ATGAGTATTCAACATTTCCGTGTCGCCCTTATTCCCTTTTTTGCGGCATTTTGCCTTCCTGTTTTTGCTCACCCAGAAACGCTGGTGAAAGTAAAAGATGCTGAAGATCAGTTGGGTGCACGAGTGGGTTACATCGAGCTGGATCTCAACAGCGGTAAGATCCTTGAGAGTTTTCGCCCCGAAGAACGTTTTCCAATGATGAGCACTTTTAAAGTTCTGCTATGTGGTGCGGTATTATCCCGTGTTGACGCCGGGCAAGAGCAACTCGGTCGCCGCATACACTATTCTCAGAATGACTTGGTTGAGTACTCACCAGTCACAGAAAAGCATCTTACGGATGGCATGACAGTAAGAGAATTATGCAGTGCTGCCATAACCATGAGTGATAACACTGCGGCCAACTTACTTCTGACAACGATCGGAGGACCGAAGGAGCTAACCGCTTTTTTGCACAACATGGGGGATCATGTAACCCGCCTTGATCGTTGGGAACCGGAGCTGAATGAAGCCATACCAAACGACGAGCGTGACACCACGATGCCTGCAGCAATGGCAACAACGTTGCGCAAACTATTAACTGGCGAACTACTTACTCTAGCTTCCCGGCAACAATTAATAGACTGGATGGAGGCGGATAAAGTTGCAGGACCACTTCTGCGCTCGGCCCTTCCGGCTGGCTGGTTTATTGCTGATAAATCTGGAGCCGGTGAGCGTGGATCTCGCGGTATCATTGCAGCACTGGGGCCAGATGGTAAGCCCTCCCGTATCGTAGTTATCTACACGACGGGGAGTCAGGCAACTAT
642	gb|KP050491|+|0-861|ARO:3001391|TEM-214	ATGAGTATTCAACATTTTCGTGTCGCCCTTTTTCCCTTTTTTGCGGCATTTTGC...TAA	861.0	46	852	806	861	ATGAGTATTCAACATTTCCGTGTCGCCCTTATTCCCTTTTTTGCGGCATTTTGCCTTCCTGTTTTTGCTCACCCAGAAACGCTGGTGAAAGTAAAAGATGCTGAAGATCAGTTGGGTGCACGAGTGGGTTACATCGAGCTGGATCTCAACAGCGGTAAGATCCTTGAGAGTTTTCGCCCCGAAGAACGTTTTCCAATGATGAGCACTTTTAAAGTTCTGCTATGTGGTGCGGTATTATCCCGTGTTGACGCCGGGCAAGAGCAACTCGGTCGCCGCATACACTATTCTCAGAATGACTTGGTTGAGTACTCACCAGTCACAGAAAAGCATCTTACGGATGGCATGACAGTAAGAGAATTATGCAGTGCTGCCATAACCATGAGTGATAACACTGCGGCCAACTTACTTCTGACAACGATCGGAGGACCGAAGGAGCTAACCGCTTTTTTGCACAACATGGGGGATCATGTAACCCGCCTTGATCGTTGGGAACCGGAGCTGAATGAAGCCATACCAAACGACGAGCGTGACACCACGATGCCTGCAGCAATGGCAACAACGTTGCGCAAACTATTAACTGGCGAACTACTTACTCTAGCTTCCCGGCAACAATTAATAGACTGGATGGAGGCGGATAAAGTTGCAGGACCACTTCTGCGCTCGGCCCTTCCGGCTGGCTGGTTTATTGCTGATAAATCTGGAGCCGGTGAGCGTGGATCTCGCGGTATCATTGCAGCACTGGGGCCAGATGGTAAGCCCTCCCGTATCGTAGTTATCTACACGACGGGGAGTCAGGCAACTATGGA
643	gb|HQ877615|+|0-861|ARO:3001159|SHV-110	ATGCGTTATATTCGCCTGTGTATTATCTCCCTGTTAGCCACCCTGCCGCTGGCG...TAA	861.0	16	822	806	861	ATGCGTTATATTCGCCTGTGTATTATCACCCTGTGAGCCACCCTGCCGCTGGCGGTACACGCCAGCCCGCAGCCGCTTGAGCAAATTAAACAAAGCGAAAGCCAGCTGTCGGGCCGCGTAGGCATGATAGAAATGGATCTGGCCAGCGGCCGCACGCTGACCGCCTGGCGCGCCGATGAACGCTTTCCCATGATGAGCACCTTTAAAGTAGTGCTCTGCGGCGCAGTGCTGGCGCGGGTGGATGCCGGTGACGAACAGCTGGAGCGAAAGATCCACTATCGCCAGCAGGATCTGGTGGACTACTCGCCGGTCAGCGAAAAACACCTTGCCGACGGCATGACGGTCGGCGAACTCTGCGCCGCCGCCATTACCATGAGCGATAACAGCGCCGCCAATCTGCTGCTGGCCACCGTCGGCGGCCCCGCAGGATTGACTGCCTTTTTGCGCCAGATCGGCGACAACGTCACCCGCCTTGACCGCTGGGAAACGGAACTGAATGAGGCGCTTCCCGGCGACGCCCGCGACACCACTACCCCGGCCAGCATGGCCGCGACCCTGCGCAAGCTGCTGACCAGCCAGCGTCTGAGCGCCCGTTCGCAACGGCAGCTGCTGCAGTGGATGGTGGACGATCGGGTCGCCGGACCGTTGATCCGCTCCGTGCTGCCGGCGGGCTGGTTTATCGCCGATAAGACCGGAGCTAGCAAGCGGGGTGCGCGCGGGATTGTCGCCCTGCTTGGCCCGAATAACAAAGCAGAGCGCATTGTGGTGATTTATCTGCGGGATACGCCGGCGAGCATGGCCGAGCG
644	gb|AE004091.2|+|3451505-3452801|ARO:3005064|cprS	ATGAAACGCGGCCTGAGCCTGATCCCCATCGTCGGCGGCGGCGTCACCCTGATC...TGA	1296.0	670	1911	1241	1296	ATGAAACGCGGCCTGAGCCTGATCCCCATCGTCGGTGGCGGCGTCAGCCTGATCCTCGCCGGGGTGCTGCTGGTCTACACGCGCATGCTCGGCGACTACGGCGAGACCGGCGCCCTCTACCTGCTCAGCATGATGATGGAAGAGGAAGGGCTGTACTTCGCCCAGCGCTACCAGGAAGACCCGGCTACGCCGGCGCCGGACAGCTACTACTTCAAGGGCAGCGTCGGCACCGCGGGGCTGCCGCCGAAACTCAGGGAGATGCTCGACACCCCCCCCTACAAGAGCATCGGCGCCATGCAACTGCTCGGCAACTGGGACGACGATGACGAAGAGGAGGATGACGACGCGCCCAGCGACGATGCCTACGTGGTAGTCCGCCAGCCACTGGCCGACGGCAAGACGCTCTACCTCTACGACAACGACGCCGCCGGCAGCATCGACACGCCGTTGTCCGACGCCATCATCGATGCCCGCGTCAGGCAGACCTGGATCGTCACCCTATCGGTCACCCTGCCTTCGCTGGCCGCCGTCGGCCTGCTGGTCTGGTTCATCGTCGCGCCGTTGCGCAAGCTGACGCGCTGGTCGATGACCCTCGACGACCTCGCCCCGGACAGCCAGCGGCCGCGCTTCAACTACCGCGAACTCAACGTGCTGGCGGATACCCTGTGGAACAGCGTGACCCGGATCAAGGACTTCAGCCAGCGCGAGGAGCGCTTCCTGCGCTACGCCAGCCATGAGCTGCGCACCCCGCTGGCGGTGATCGGCATGAACCTGGAGTTGCTCGACCAACCCGGCCGCGCGCCCTCCCCGCATGCCTTGCAACGCATCCGCCGCTCGGCGCTGGGCATGCAGCAGATGACCGAGACCCTGCTCTGGCTCAGCCGCGAGAGCGGCGAACTGCGCGACGACGGACACATCGAGGTCGGTCGCCTGCTGGAGGAGCTGCTCGAGGAACAGCAGGCGCTGAGCCAGCGCCGCGGCCTGACCTTCCACCTCGACGTGGAGCCACACAGCCTGCCGCAGACCCGCGCACGGATCATCATCGGCAACCTGCTGCGCAACGCCCTGCAGTACAGCGACGAGGGCGTGGTGGAAATCGTCGTGCGCGACCGCAGCCTGCTGATCAGCAACCCCATTGGTGCGGCCCAGGGCACGGACGAGTCGATGGCGTTCGGTTATGGCCTGGGCCTCGACCTGGTCCAGCGCCTATGCCAGAAGAGCGGCTGGCGCCTGCATTACAG
645	gb|KP050492|+|0-861|ARO:3001392|TEM-215	ATGAGTATTCAACATTTTCGTGTCGCCCTTATTCCCTTTTTTGCGGCATTTTGC...TAA	861.0	46	852	806	861	ATGAGTATTCAACATTTCCGTGTCGCCCTTATTCCCTTTTTTGCGGCATTTTGCCTTCCTGTTTTTGCTCACCCAGAAACGCTGGTGAAAGTAAAAGATGCTGAAGATCAGTTGGGTGCACGAGTGGGTTACATCGAGCTGGATCTCAACAGCGGTAAGATCCTTGAGAGTTTTCGCCCCGAAGAACGTTTTCCAATGATGAGCACTTTTAAAGTTCTGCTATGTGGTGCGGTATTATCCCGTGTTGACGCCGGGCAAGAGCAACTCGGTCGCCGCATACACTATTCTCAGAATGACTTGGTTGAGTACTCACCAGTCACAGAAAAGCATCTTACGGATGGCATGACAGTAAGAGAATTATGCAGTGCTGCCATAACCATGAGTGATAACACTGCGGCCAACTTACTTCTGACAACGATCGGAGGACCGAAGGAGCTAACCGCTTTTTTGCACAACATGGGGGATCATGTAACCCGCCTTGATCGTTGGGAACCGGAGCTGAATGAAGCCATACCAAACGACGAGCGTGACACCACGATGCCTGCAGCAATGGCAACAACGTTGCGCAAACTATTAACTGGCGAACTACTTACTCTAGCTTCCCGGCAACAATTAATAGACTGGATGGAGGCGGATAAAGTTGCAGGACCACTTCTGCGCTCGGCCCTTCCGGCTGGCTGGTTTATTGCTGATAAATCTGGAGCCGGTGAGCGTGGATCTCGCGGTATCATTGCAGCACTGGGGCCAGATGGTAAGCCCTCCCGTATCGTAGTTATCTACACGACGGGGAGTCAGGCAACTATGGA
646	gb|CP000813.4|-|2349398-2350187|ARO:3004759|BPU-1	TTGAAGAAAAAGTATATAAAAAGGCTGTTTTCTTGCATCATGCTGATGGCATTT...TAG	789.0	15235	15969	734	789	TTGAAGAAAAAGTATATAAAATGGCTGTTTTCTAGCATCATGCTGATGGCACTTTGTATCAGCCAGCCTTCATCAACTGAAGCAAGATCACCAGCGTGGTCAGTAGATGAATTCTTTAAAAATCGGGAAGGCACGTTTGTGATTCAAGAAGTAAAAGAAAAGTCACCTTGAGTGTATAACAAAAAAAGAGCGAAAGAGCGCTTTGCACCTCAATCGACATTTAAGGTAACAAATGCCTTAATCGGACTCCAAACGGGCGCAGTGAGAGATGAATATGACATCAAATATTGGGATGGAGTAAAAAGAGAGATTGAGAGCTGGAACAGGGATCATACATTAGGATCTGGGATGAGAGATTCAGTCGTCTGGTACTATCAAGCCATGGCGCGTGACATTGGAGAAGAACGCATGAATCATTGGGTGAAAGCCATTCATTATGGGAACAAAGACATATCTGGCGGAATCGATCAATTTTGGTTAAGCAGTACCCTGCGAATTTCTCCAATCGAACAAGTTCGTTTCCTCAAACAGCTATATGAAGAGACTCTTCCATTTGACCTAACTGTCATAAGAACAGTCAAACGAATGATGGTACAAGAAGAAGAGAAACACGCCACCCTATACGGAAAAACAGGCTCGGGATCAGGTATCGGCTGGTACGTAGGCTTTATCAAACATGAAAATAAAACCTACATTTTCGCCACAAATATCGAAGGCACCGGCATAGAAGCAAA
647	gb|KF944358|+|0-861|ARO:3001393|TEM-216	ATGAGTATTCAACATTTTCGTGTCTCCCTTATTCCCTTTTTTGCGGCATTTTGC...TAA	861.0	46	852	806	861	ATGAGTATTCAACATTTCCGTGTCGCCCTTATTCCCTTTTTTGCGGCATTTTGCCTTCCTGTTTTTGCTCACCCAGAAACGCTGGTGAAAGTAAAAGATGCTGAAGATCAGTTGGGTGCACGAGTGGGTTACATCGAGCTGGATCTCAACAGCGGTAAGATCCTTGAGAGTTTTCGCCCCGAAGAACGTTTTCCAATGATGAGCACTTTTAAAGTTCTGCTATGTGGTGCGGTATTATCCCGTGTTGACGCCGGGCAAGAGCAACTCGGTCGCCGCATACACTATTCTCAGAATGACTTGGTTGAGTACTCACCAGTCACAGAAAAGCATCTTACGGATGGCATGACAGTAAGAGAATTATGCAGTGCTGCCATAACCATGAGTGATAACACTGCGGCCAACTTACTTCTGACAACGATCGGAGGACCGAAGGAGCTAACCGCTTTTTTGCACAACATGGGGGATCATGTAACCCGCCTTGATCGTTGGGAACCGGAGCTGAATGAAGCCATACCAAACGACGAGCGTGACACCACGATGCCTGCAGCAATGGCAACAACGTTGCGCAAACTATTAACTGGCGAACTACTTACTCTAGCTTCCCGGCAACAATTAATAGACTGGATGGAGGCGGATAAAGTTGCAGGACCACTTCTGCGCTCGGCCCTTCCGGCTGGCTGGTTTATTGCTGATAAATCTGGAGCCGGTGAGCGTGGATCTCGCGGTATCATTGCAGCACTGGGGCCAGATGGTAAGCCCTCCCGTATCGTAGTTATCTACACGACGGGGAGTCAGGCAACTATGGA
648	gb|AB200915.1|-|1831-2305|ARO:3005084|dfrA31	ATGAAAATATCCATTATGGCAGCAGTTTCTGAGAATGGAGTAATTGGCTCTGGA...TAA	474.0	7	426	419	474	ATGAAAATATCCATTATGGCAGCAGTTTCTGAGAATGGAGTAATTGGCTCTGGATTGGATATACCTTGGCATGTACAAGGTGAGCAGCTCCTGTTCAAAGCTATGACTTACAATCATTGGCTTTTAGTCGGTCGTAAAACTGTCGACTCAATGGGTAAACTTCCCAATAGGAAATATGCTGTGGTTACTCGCTCAGAAATGGTCTCGAATGATCCAGATGTTATTTATTTCACCAGCATTGAATCGGCATTATCTTACTTAGACAATACGACAACACATGTCTTTGTTTCTGGTGGTGGTGAAATTTACAAAGCATTAATCGAACAAGCAGATGTTATCCATCTTTCAGTGATTCATAAGCACATCTCTGGCGACGTGTTTTTCCCTTCAGTTCCACAGAGTTTCAAACAAACATTTGA
649	gb|AB372881|+|8-869|ARO:3001160|SHV-111	ATGCGTTATATTCGCCTGTGTATTATCTCCCTGTTAGCCACCCTGCCGCTGGCG...TAA	861.0	16	822	806	861	ATGCGTTATATTCGCCTGTGTATTATCACCCTGTGAGCCACCCTGCCGCTGGCGGTACACGCCAGCCCGCAGCCGCTTGAGCAAATTAAACAAAGCGAAAGCCAGCTGTCGGGCCGCGTAGGCATGATAGAAATGGATCTGGCCAGCGGCCGCACGCTGACCGCCTGGCGCGCCGATGAACGCTTTCCCATGATGAGCACCTTTAAAGTAGTGCTCTGCGGCGCAGTGCTGGCGCGGGTGGATGCCGGTGACGAACAGCTGGAGCGAAAGATCCACTATCGCCAGCAGGATCTGGTGGACTACTCGCCGGTCAGCGAAAAACACCTTGCCGACGGCATGACGGTCGGCGAACTCTGCGCCGCCGCCATTACCATGAGCGATAACAGCGCCGCCAATCTGCTGCTGGCCACCGTCGGCGGCCCCGCAGGATTGACTGCCTTTTTGCGCCAGATCGGCGACAACGTCACCCGCCTTGACCGCTGGGAAACGGAACTGAATGAGGCGCTTCCCGGCGACGCCCGCGACACCACTACCCCGGCCAGCATGGCCGCGACCCTGCGCAAGCTGCTGACCAGCCAGCGTCTGAGCGCCCGTTCGCAACGGCAGCTGCTGCAGTGGATGGTGGACGATCGGGTCGCCGGACCGTTGATCCGCTCCGTGCTGCCGGCGGGCTGGTTTATCGCCGATAAGACCGGAGCTAGCAAGCGGGGTGCGCGCGGGATTGTCGCCCTGCTTGGCCCGAATAACAAAGCAGAGCGCATTGTGGTGATTTATCTGCGGGATACGCCGGCGAGCATGGCCGAGCG
650	gb|HG934763|+|0-861|ARO:3001394|TEM-217	ATGAGTATTCAACATTTTCGTGTCGCCCTTATTCCCTTTTTTGCGGCATTTTGC...TAA	861.0	46	852	806	861	ATGAGTATTCAACATTTCCGTGTCGCCCTTATTCCCTTTTTTGCGGCATTTTGCCTTCCTGTTTTTGCTCACCCAGAAACGCTGGTGAAAGTAAAAGATGCTGAAGATCAGTTGGGTGCACGAGTGGGTTACATCGAGCTGGATCTCAACAGCGGTAAGATCCTTGAGAGTTTTCGCCCCGAAGAACGTTTTCCAATGATGAGCACTTTTAAAGTTCTGCTATGTGGTGCGGTATTATCCCGTGTTGACGCCGGGCAAGAGCAACTCGGTCGCCGCATACACTATTCTCAGAATGACTTGGTTGAGTACTCACCAGTCACAGAAAAGCATCTTACGGATGGCATGACAGTAAGAGAATTATGCAGTGCTGCCATAACCATGAGTGATAACACTGCGGCCAACTTACTTCTGACAACGATCGGAGGACCGAAGGAGCTAACCGCTTTTTTGCACAACATGGGGGATCATGTAACCCGCCTTGATCGTTGGGAACCGGAGCTGAATGAAGCCATACCAAACGACGAGCGTGACACCACGATGCCTGCAGCAATGGCAACAACGTTGCGCAAACTATTAACTGGCGAACTACTTACTCTAGCTTCCCGGCAACAATTAATAGACTGGATGGAGGCGGATAAAGTTGCAGGACCACTTCTGCGCTCGGCCCTTCCGGCTGGCTGGTTTATTGCTGATAAATCTGGAGCCGGTGAGCGTGGATCTCGCGGTATCATTGCAGCACTGGGGCCAGATGGTAAGCCCTCCCGTATCGTAGTTATCTACACGACGGGGAGTCAGGCAACTATGGA
651	gb|FJ905898.1|+|328-802|ARO:3004547|dfrA6	ATGAAAATATCCATTATGGCAGCTGTTTCCGAGAATGGAGTAATTGGCTCTGGA...TAA	474.0	7	426	419	474	ATGAAAATATCCATTATGGCAGCAGTTTCTGAGAATGGAGTAATTGGCTCTGGATTGGATATACCTTGGCATGTACAAGGTGAGCAGCTCCTGTTCAAAGCTATGACTTACAATCATTGGCTTTTAGTCGGTCGTAAAACTGTCGACTCAATGGGTAAACTTCCCAATAGGAAATATGCTGTGGTTACTCGCTCAGAAATGGTCTCGAATGATCCAGATGTTATTTATTTCACCAGCATTGAATCGGCATTATCTTACTTAGACAATACGACAACACATGTCTTTGTTTCTGGTGGTGGTGAAATTTACAAAGCATTAATCGAACAAGCAGATGTTATCCATCTTTCAGTGATTCATAAGCACATCTCTGGCGACGTGTTTTTCCCTTCAGTTCCACAGAGTTTCAAACAAACATTTGA
652	gb|K00544|+|0-663|ARO:3002672|Bacillus_pumilus_cat86	TTGTTTAAACAAATAGACGAAAATTATCTGCGAAAAGAGCACTTTCACCATTAT...TGA	663.0	2119	2726	607	663	TGTTTAAACAAATAGACGAAAATTATCCGCGAAAAGAGCACTTTCACCATTATATGACGTTAACCCGATGCTCATATAGCTTGGTGATCAATCTAGACATCACGACATTGCATGCAATATTAAAAGAAAAAAAGCTAAAAGTATATCCTGTGCAAATTTATTTGTTAGCAAGAGCTGTGCAAAAAATACCGGAGTTTCGGATGGATCAAGTGAACGATGAACTGGGTTACTGGGAGATTCTCCATCCTAGTTATACGATTCTAAATAAAGAAACAAAGACATTTTCAAGTATTTGGACGCCTTATGACGAAAACTTTGCTCAGTTTTATAAAAGCTGTGTAACCGACATTGAAACATTTAGCAAAAGCAGCAACCTATTTCCGAAACCTCATATGCCAGAAAACATGTTCAATATTTCAAGTCTACCGTGGATTGATTTTACTTCTTTTAACCTTAATGTATCTACAGACGAAACTTATTTACTGCCAATATTTACGTTAGGTCAATTTAAGGCGAAAGAAGAAAAAATCATCCTGCCCGTCGCCATACAAGTACATCATGCAGTTTGTGATGGCTATCATGCCGGTCAATATGTTGAATATTTGAG
653	gb|KJ776406|+|16-877|ARO:3001340|SHV-119	ATGCGTCATATTCGCCTGTGTATTATCTCCCTGTTAGCCACCCTGCCGCTGGCG...TAA	861.0	16	822	806	861	ATGCGTTATATTCGCCTGTGTATTATCACCCTGTGAGCCACCCTGCCGCTGGCGGTACACGCCAGCCCGCAGCCGCTTGAGCAAATTAAACAAAGCGAAAGCCAGCTGTCGGGCCGCGTAGGCATGATAGAAATGGATCTGGCCAGCGGCCGCACGCTGACCGCCTGGCGCGCCGATGAACGCTTTCCCATGATGAGCACCTTTAAAGTAGTGCTCTGCGGCGCAGTGCTGGCGCGGGTGGATGCCGGTGACGAACAGCTGGAGCGAAAGATCCACTATCGCCAGCAGGATCTGGTGGACTACTCGCCGGTCAGCGAAAAACACCTTGCCGACGGCATGACGGTCGGCGAACTCTGCGCCGCCGCCATTACCATGAGCGATAACAGCGCCGCCAATCTGCTGCTGGCCACCGTCGGCGGCCCCGCAGGATTGACTGCCTTTTTGCGCCAGATCGGCGACAACGTCACCCGCCTTGACCGCTGGGAAACGGAACTGAATGAGGCGCTTCCCGGCGACGCCCGCGACACCACTACCCCGGCCAGCATGGCCGCGACCCTGCGCAAGCTGCTGACCAGCCAGCGTCTGAGCGCCCGTTCGCAACGGCAGCTGCTGCAGTGGATGGTGGACGATCGGGTCGCCGGACCGTTGATCCGCTCCGTGCTGCCGGCGGGCTGGTTTATCGCCGATAAGACCGGAGCTAGCAAGCGGGGTGCGCGCGGGATTGTCGCCCTGCTTGGCCCGAATAACAAAGCAGAGCGCATTGTGGTGATTTATCTGCGGGATACGCCGGCGAGCATGGCCGAGCG
654	gb|AJ920369|+|23-860|ARO:3001071|SHV-12	ATGCGTTATATTCGCCTGTGTATTATCTCCCTGTTAGCCACCCTGCCGCTGGCG...GCG	837.0	16	798	782	837	ATGCGTTATATTCGCCTGTGTATTATCACCCTGTGAGCCACCCTGCCGCTGGCGGTACACGCCAGCCCGCAGCCGCTTGAGCAAATTAAACAAAGCGAAAGCCAGCTGTCGGGCCGCGTAGGCATGATAGAAATGGATCTGGCCAGCGGCCGCACGCTGACCGCCTGGCGCGCCGATGAACGCTTTCCCATGATGAGCACCTTTAAAGTAGTGCTCTGCGGCGCAGTGCTGGCGCGGGTGGATGCCGGTGACGAACAGCTGGAGCGAAAGATCCACTATCGCCAGCAGGATCTGGTGGACTACTCGCCGGTCAGCGAAAAACACCTTGCCGACGGCATGACGGTCGGCGAACTCTGCGCCGCCGCCATTACCATGAGCGATAACAGCGCCGCCAATCTGCTGCTGGCCACCGTCGGCGGCCCCGCAGGATTGACTGCCTTTTTGCGCCAGATCGGCGACAACGTCACCCGCCTTGACCGCTGGGAAACGGAACTGAATGAGGCGCTTCCCGGCGACGCCCGCGACACCACTACCCCGGCCAGCATGGCCGCGACCCTGCGCAAGCTGCTGACCAGCCAGCGTCTGAGCGCCCGTTCGCAACGGCAGCTGCTGCAGTGGATGGTGGACGATCGGGTCGCCGGACCGTTGATCCGCTCCGTGCTGCCGGCGGGCTGGTTTATCGCCGATAAGACCGGAGCTAGCAAGCGGGGTGCGCGCGGGATTGTCGCCCTGCTTGGCCCGAATAACAAAGCAGAGCGCATTGTGGTGATTTATCTGCGGGA
655	gb|AP009048|-|4338624-4340268|ARO:3003576|eptA	ATGTTGAAGCGCCTACTAAAAAGACCCTCTTTGAATTTACTCGCCTGGCTATTG...TGA	1644.0	7278	8867	1589	1644	ATGTTGAAGCGCCTACTAAAAAGACCCTCTTTGAATTTACTCGCCTGGCTATTGTTGGCCGCTTTTTATATCTCTATCTGCCTGAATATTGCCTTTTTTAAACAGGTGTTGCAGGCGCTGCCGCTGGATTCGCTGCATAACGTACTGGTTTTCTTGTCGATGCCGGTCGTCGCTTTCAGCGTGATTAATATTGTCCTGACACTAAGCTCTTTCTTATGGCTTAATCGACCACTGGCCTGCCTGTTTATTCTGGTTGGCGCGGCTGCACAATATTTCATAATGACTTACGGCATCGTCATCGACCGCTCGATGATTGCCAATATTATTGATACCACTCCGGCAGAAAGTTATGCGCTGATGACACCGCAAATGTTATTAACGCTGGGATTCAGCGGCGTGCTTGCTGCGCTGATTGCCTGCTGGATAAAAATCAAACCTGCCACCTCGCGTCTGCGCAGTGTTCTTTTCCGTGGAGCCAATATTCTGGTTTCTGTACTACTGATTTTGCTGGTCGCCGCACTGTTTTATAAAGACTACGCCTCGTTGTTCCGCAATAACAAAGAGCTGGTGAAATCCTTAAGCCCCTCTAACAGCATTGTTGCCAGCTGGTCATGGTACTCCCATCAGCGACTGGCAAATCTACCGCTGGTGCGAATTGGTGAAGACGCCCACCGCAACCCGTTAATGCAGAACGAAAAACGTAAAAATTTGACCATCCTGATTGTCGGCGAAACCTCGCGGGCGGAGAACTTCTCCCTCAACGGCTACCCGCGTGAAACTAACCCGCGGCTGGCGAAAGATAACGTGGTCTATTTCCCTAATACCGTATCTTGCGGCACGGCAACGGCAGTTTCAGTACCGTGCATGTTCTCGGATATGCCGCGTGAGCATTACAAAGAAGAGCTGGCACAGCACCAGGAAGGCGTGCTGGATATCATTCAGCGAGCGGGCATCAACGTGCTGTGGAATGACAACGATGGCGGCTGTAAAGGTGCCTGCGACCGCGTGCCTCACCAGAACGTCACCGCGCTGAATCTGCCTGGTCAGTGCATCAACGGCGAATGCTATGACGAAGTGCTGTTCCACGGGCTGGAAGAGTACATCAATAACCTGCAGGGTGATGGCGTGATTGTCTTACACACCATCGGCAGCCACGGTCCGACCTATTACAACCGCTATCCGCCGCAGTTCAGGAAATTTACCCCAACCTGCGACACCAATGAGATCCAGACCTGTACCAAAGAGCAACTGGTGAACACTTACGACAACACGCTGGTTTACGTCGACTATATTGTTGATAAAGCGATTAATCTGCTGAAAGAACATCAGGATAAATTTACCACCAGCCTGGTTTATCTTTCTGACCACGGTGAATCGTTAGGTGAAAATGGCATCTATCTGCACGGTCTGCCTTATGCCATCGCCCCGGATAGCCAAAAACAGGTGCCGATGCTGCTGTGGCTGTCGGAGGATTATCAAAAACGGTATCAGGTTGACCAGAACTGCCTGCAAAAACAGGCGCAAACGCAACACTATTCACAAGACAATTTATTCTCCACGCTATTGGGATTAACTGGCGTTGAGACGAA
656	gb|FO203501.1|+|5123640-5125365|ARO:3005047|eptB	GTGCCACAGCGTCAGGCGGTGTTTTATTCTTCTTTTTCCAGGTTTGCTTGCATG...TAA	1725.0	7394,0	8579,537	1185;537	1725	GTGCCACAGCGTCAGGCGGTGTTTTATTCTTCTTTTTCCAGGTTTGCTTGCATGAAATATATTAGAACGATGACGCAGCAGAAGCTTAGTTTTTGGCTGGCGCTGTACATCGGCTGGTTTATGAACGTCGCCGTTTTTTTCCGGCGTTTCGATGGTTATGCTCAAGAGTTCACTTTCTGGAAAGGGCTTTCCGGTGTTGTTGAACTGGTTGCCACGGTATTTGTCACCTTCTTCCTGTTACGTCTTCTGTCGCTGTTCGGCCGCCGTATCTGGCGCATTCTGGCGACGCTGATTGTCCTGTTTTCCGCCGCGGCGAGTTACTACATGACGTTCCTCAATGTGGTGATTGGCTACGGGATCATCGCTTCGGTGATGACCACCGATATCGACCTGTCGAAAGAGGTCATCGGCTGGCACCTGATCCTCTGGCTGGTGGCGGTGAGCGCGCCGCCGTTGCTGTTCATCTGGAGCAACCGCTGCCGCCATACGCTGCTGCGCCAGCTGCGCACCCCGGGCCAGCGGGTTAAAAACGTGCTGATCGTGGTGCTGGCCGGACTGATTGTCTGGGGACCCATCCGCCTGCTAGAGCTGCGCCAGCATGATGTGGAGCGCCATTCGGAAGTGGATATGCCGAGCTATGGCGGGGTGATCGCCAACTCTTACCTGCCGTCGAACTGGTTGTCGGCGCTGGGTCTGTACGCCTGGGCGCAGGTGGATGAATCCTCAGACAACAAATCGCTGATTAACCCGGCGAAGAAGTTCACCTACGTCGCGCCGGAAGGTCTGGATGATACCTACGTGGTGTTTATCATTGGCGAAACGACCCGCTGGGACCATATGGGCATCCTCGGCTATAGCCGCAATACCACGCCAGAGCTGGAGAAAGAGAAGAATCTCGTCGCCTTCCGCGGTTACTCGTGCGATACCGCTACCAAACTGTCGTGACGCTGCATGTTTGTGCGCGAGGGCGGGGCGGAAGATAACCCACAGCGGACGCTCAAAGAGCAGAATGTCTTTGCCGTGCTGCATCAGCTGGGCTTCAGCGGCAATCTGTACGCCATGCAGAGCGAGATGTGGTTCTACAGCAACACGATGGCCAACAATATCGCCTACCGCGAGCAGATTGGCGCCGAGCCGCGCAACCGCGGTAAGAGCGTTGACGATATGCTGCTGGTGGATGAGATG;GCCGCGCAACCGCGGTAAGAGCGTTGACGATATGCTGCTGGTGGCTGAGATGAAGCGCGGTATGGCGCAGGGCAACGCCTCCGGTAAGCATCTGATCATTCTCCACACCAAAGGCTCCCACTTTAACTACACCCAACGCTACCCGCGCAGCTTCGCCCAGTGGAAACCGGAGTGCGTCGGCGTCGACAACAAGTGCTCGAAAGCGGAACTGATCAATTCCTACGACAATAGCGTGACCTATGTCGATCACTTTATCGTCAGCGTCCTCGACCAGCTGCGGGATAAGAAAGCGATTGTGTTCTATGCCGCCGACCACGGGGAGTCGATTAACGAGCGTGAACACCTGCACGGTACGCCGCGCAAGATGGCGCCGCCGGAGCAGTTCCGCGTGCCGATGATGGTGTGGATGTCGGATAAGTACCTGGAAAATCCCGATCACGCCGCCGCGTTTGCCCATCTGCAGCAGCAGGCTGCGATGAAGGTGCCGCGCCGTCACGTCGAGCTGTACGACACCATTATGGGCTGCCTCGGCTATAC
657	gb|AE004091.2|+|1221690-1222098|ARO:3000149|fosA	ATGCTTACCGGTCTCAATCACCTGACCCTGGCGGTCGCCGACCTGCCGGCCAGC...TAG	408.0	25069	25422	353	408	ATGCTTACCGGTCTCAATCACCTGACCCTGGCGGTCGCCGACCTGCCGGCCAGCATCGCCTTCTACCGCGATCTTCTCGGCTTTCGCCTGGAAGCGCGCTGGGACCAGGGCGCCTATCTCGAACTGGGTTCGCTGTGGCTGTGCCTGTCCCGGGAGCCGCAGTACGGCGGGCCGGCCGCGGACTACACGCACTACGCCTTCGGCATCGCCGCCGCGGACTTCGCCCGCTTCGCCGCGCAGCTGCGCGCGCATGGCGTGCGCGAATGGAAGCAGAACCGCAGCGAGGGCGATTCGTTCTACTTCCTCGACCCGGACGGCCATCGCCTGGAGGCCCACGTCGGCGACCTGCGCAG
658	gb|AL009126|+|916777-919348|ARO:3003324|Bacillus_subtilis_mprF	TTGCTGATTAAAAAGAATGCTTTATCAATATTAAAAATCGTTTTTCCTATTGCT...TAA	2571.0	0,0,0,0	213,221,446,656	213;221;446;656	2571	GCGGATAAAGTGAAAAATCCGATTTTCGCATATATTGGAGCTTCAGTTGTTGAATGGCTCATGGCCGGGAACGTCATCTATTTTGCTTTGTTCGCTATGGGCATTCATGCAGATATCAGGTATGTTTTCGGGGTGTTCGTCATTGCGGCGATCGGAGGAATGATCAGCCTCGTGCCGGGCGGCTTCGGCTCGTTTGACCTTTTATTTTTGCTG;TAAACGGACAAAACGTTCCTATACGATGGCCATTACAGCGCTTGTCGGCGGCTTTGTGTTCAGCTTTTTAAAAGGGCTTAACATCAGCGCGATATTCGTACTGCCGATGATTATCGTATTGCTTGTGCTATTGAAAAAACAATTTGTCCGCGAACAGGCATCCTATACACTGGGACAATTGATATTCGCTGTGGCGCTGTTTACTGTGGCGCTCTTTAACT;TTTAACTACAATCTGATCGCGGGCTTTATTTGGGACCGGATGAAGAAGGTGCTGCGTCACGAATATTTCGTCCACAGCACCTCGCATATTACACATGCAACCATCATGGCGATCATTATTGTGCCGCTGTTCTTCTTGATATTTACAGTGGTCTATCATAAGAGAACGAAACCGATCGGAGAGAAAGCTGACCCTGAGCGTCTTGCTGCGTTTCTCAATGAAAAAGGCGGCAACGCGCTGAGCCATCTTGGTTTTCTTGGAGATAAGCGGTTTTATTTTTCTAGTGATGGGAATGCACTGCTTCTGTTTGGGAAAATCGCCAGAAGGCTGGTCGTGCTCGGCGATCCGTCTGGCCAAAGAGAATCATTCCCGCTCGTGCTGGAAGAATTTCTGAACGAAGCGCATCAGAAGGGATTCAGTGTTTTGTTCTATCAAATTGAACGAGA;GCGCTGTATCATGATTTTGGCTACAACTTCTTTAAATTGGGCGAGGAAGCATATGTAGATTTAAATACATTTACCTTGACTGGGAAGAAAAAAGCCGGCCTTCGGGCAATCAATAACCGCTTTGAGCGGGAGGAGTATACTTTCCATGTGGATCATCCCCCATTTTCTGATGCGTTTTTGGAGGAGCTGAAGCAAATCTCAGACGAATGGCTCGGCTCGAAAAAAGAGAAGGGATTCTCGCTCGGATTTTTTGATCCTTCTTATTTACAGAAAGCGCCGATCGCCTATATGAAAAATGCAGAAGGAGAGATCGTTGCATTCGCAAATGTCATGCCGATGTACCAGGAAGGAGAGATATCGGTTGATCTGATGCGCTATCGCGGCGACGCTCCAAATGGCATTATGGACGCATTGTTTATCCGTATGTTTTTATGGGCAAAGGAAGAGGGCTGCACGTCATTTAATATGGGGATGGCACCCTTGGCTAATGTCGGCACTGCCTTTACATCCTTCTGGTCCGAAAGGTTTGCCGCTGTCATTTTTAATAATGTCAGATACATGTACAGCTTCAGCGGCCTAAGAGCCTTTAAAGAAAAATACAAACCGGAGTGGCGAGGGAAATACTTAGCGTATCGGAAAAACAGATCTCTTTCTGT
659	gb|U00096.3|-|721055-721733|ARO:3003841|kdpE	GTGACAAACGTTCTGATTGTTGAAGATGAACAGGCTATTCGTCGCTTTCTGCGC...TGA	678.0	6263	6886	623	678	GTGACAAACGTTCTGATTGTTGAAGATGAACAGGCTATTCGTCGCTTTCTGCGCACGGCGCTGGAGGGCGACGGGATGCGCGTCTATGAGGCCGAAACGCTGCAACGCGGCTTGCTGGAAGCGGCTACCCGTAAGCCAGATTTGATTATTCTCGATCTCGGCCTGCCCGATGGTGATGGGATTGAGTTTATCCGCGACCTGCGCCAGTGGAGCGCGGTGCCGGTGATTGTGCTTTCCGCACGCAGCGAAGAGAGCGACAAAATCGCCGCGCTGGATGCCGGAGCGGATGATTATCTGAGTAAGCCGTTTGGCATTGGCGAATTGCAGGCCCGTCTGCGCGTCGCTTTACGCCGCCACTCCGCTACCGCCGCGCCCGATCCGCTGGTGAAATTTTCCGATGTTACCGTCGATTTAGCCGCCCGCGTGATTCACCGGGGTGAGGAAGAGGTGCATCTCACACCAATTGAGTTCCACCTGCTGGCGGTGCTGCTCAACAATGCCGGAAAAGTACTCACCCAGCGCCAGCTCCTTAACCAGGTGTGGGGGCCAAACGCGGTCGAACACAGTCACTATTTGCGTATTTATATGGGACATCTGCGACAAAAACTGGAACAGGATCCCGC
660	gb|AY453162|+|500-1271|ARO:3004189|Bla2	ATGAAAAATACATTATTAAAATTAGGGGTATGTGTTAGTTTACTAGGAATAACT...TAA	771.0	1446	2162	716	771	ATGAAAAATACATTATTAAAATTAGGGGTATGTGTTAGTTTACTAGGAATAACTCCATTTGTTAGTACAATTTCTTCTGTACAAGCAGAACGAAAGGTAGAGCATAAAGTAATAAAAAATGAGACAGGAACTATTTCAATTTCTCAGTTAAACAAAAATGTTTGGGTTCATACGGAGTTAGGTTATTTTAACGGAGAAGCAGTTCCTTCGAACGGTTTAATCCTTAATACTTCTAAAGGATTAGTACTTGTCGATTCTTCTTGGGATGATAAGTTAACGAAGGAATTAATAGAGATGGCAGAAAAGAAATTTAAGAAGAGTGTAACGGATGTTATTATTACACATGCACACGCTGATCGGATTGGTGGAATAAAAACGTTGAAAGAAAGAGGCATTAAAGCGCATAGTACAACGTTAACTGCGGAACTAGCAAAGAAAAATGGATATGAAGAACCACTTGGAGACTTACAAGCAATTACGAAATTGAAGTTTGGAAATATGAAAGTAGAAACGTTTTATCCAGGGAAAGGACATACAGAAGATAATATCGTCGTATGGTTACCACAATACAACATGTTAGTTGGAGGCTGTTTAGTGAAGTCTGCGTCCGCGAAAGATTTAGGAAATATTACTGATGCTTATGTAAATGAATGGTCTACATCGATTGAGAATGTGCTGAAGCGATATGAAAATATAAATTTTGTAGTACCTGGTCA
661	gb|AE014292|+|568280-570923|ARO:3003772|Brucella_suis_mprF	TTGCTCTGGTGGGACGACATTTCGATGAGCCTGATTGATGATGAAATACCTTCT...TGA	2643.0	29696	32284	2588	2643	TTGCTCTGGTGGGACGACATTTCGATGAGCCTGATTGATGATGAAATACCTTCTTCGCAACCGCAAGTGTCAGGTAGGCATTTCGGCTGGTTGAAACAATATCAGCATTTTCTGTTTCCAATCGCAGGCATCGCCATTGCGTTATTGGCTATTTATGATCTGGAAAATCTTCTCAGGCACACCTCCCGCACCGAAACGCTTGCAGCCCTTCACAATATTTCATGGACGACGCTCGCACTGGCCGTCTTTTTCACAGCATTAAGCTATGCCGCAGTGGCGCTTTATGATGTCGTGGCGGTGGACACCATAGCGCCCAACCAGATACCGCGCCGCATCGCGGCGGTGGCGGGTGCTGCGGGCTATGCGATTTCCAACGCGCTCGGCTTCTCGCTCCTGACCGGCGGGGCGCTGCGTTATCGCATTTATGCCGCAGAAGGCATAAGCCTGGCCGATATCGGCAAGATCGTCGGCACCTCATGGTTCGCCATCTGGTTCGCCCTCATCATCATGGTGGGCGCAGCCCTGCTGATCGATCCGCAGGACGTGCCTTTTCTTTCCGCCATCGATATACGGATTGATATTGTCGCAGGCATTCTCATCCTTGGCGGCATTGGCTGGCTGATCTACTGGCTTTCGCATGGCGAACGCAATGTCAGCATCGGTTCGTTCAGCCTGCGCCTGCCCAATTCAAAAGGCGCGCTCACGCAGATTTTTGCGGGCGTGGTGGATGTGGGCGCTGCCGCGGCCACGCTCTATGTGCTGTTGCCGGAAGGGGCTGTGCCAAGCTTCGCCGTCTTTGCGCTCGTTTATGTCATCGCCATCGTGCTTGGCATTGCAAGCCACGCGCCAGGCGGCCTCGGCGCTTTTGAGGCAACAATCATCGCAGGGCTTGGCCTCGGTGGAAAACCCGATGCAATTGCGGGCCTGCTGGCCTATCGCCTCATTTACACGGTTCTTCCCCTCGTGGTTGCCACCGCCGGAATCCTCATCTGGGAGGTCATGCGCCGCCGCCATATGCTCGACAAGCAGGCCCGATTCGCCAAGCGGCTGGTGGAGCCGCTGGTTCCGGGGCTTTCAGCCAGCATCATCTTTCTCGGTGGCATCATCCTGCTTATCTCAGGCGCCACGCCCGATATGCGCTATCGTGTGAAGTTGCTGTCCGACATCGTGCCGGAATTTCTTGTGGAGATGTCGCATCTGGCGGCAAGCCTCGTCGGCGTTGCTCTTCTCATCGTCGCGCGCGGCCTTTCCAAACGGCTGGAGCGCGCCTGGGTGGCCGCGATGGTGCTTCTTCTTTGCGGCGCGGTGTTTTCGATCGCAAAAGGACTGGACTGGGAAGAGGCAAGCATTTTGTGCCTTTTTGCCCTTTCACTCTGGGGCTTTCGCGATTCCTTCTACCGTCGTCCGATTGCCGGCCCGTTTGAACTGAGCTGGAACTGGATCGCAACCGTTGGAACCACGGTTCTCGTGTCCACCTGGCTTGGTTTTTTCGTCTACCGCCATATCGAATATTCAAGCGATCTCTGGTGGGATTTCGCGTGGAACGGCAACGCCCCGCGTTTCCTGCGCGCCACCGTTCTGGTTTTCGCAGTCGTGGCGGCAGTCGGCCTTCATTCGATCATCAACCGGCATGGCCAGCGCAGGCGCAAGGTTGATCATTCCATCCCCGATGCCGTGCCCGCACTCGTCGCCCGGTGCCCGCATACAGATGCAGCCCTTGCCATGCTGGGCGACAAGCAATTTCTGCTGGCGCCCGACGACAGCGCGTTCATCATGTATGCGCAGTCGGGCGGCAGCCTGATCGCGCTTGGCGAGCCTATCGGCGATGCCGAAGCGGGCAAGGAACTTGCCTGGTCTTTCCATTCGCTTGCCGACCGTCTGGCGCTGCGCACTGTCTTCTATGGTGTCGGCCCGCAAAGCCTGCCGCTTTTCCTCGATATGGGCCTGATTGCGCTCAAGCTGGGTGAAGTCGCACGCGTTGACCTGACAGATTTTTCGCTGGAAGGCCCGCGCCGCCAGCCCTTCCGTTATGCCGACCGCAAGGTGGACAAGGATGGGCTGACCTTCGAGATTATCCCTGCTGCGGACGTGCCGCCGCTGATCCCGCGCCTGCGCGCAATTTCCGACGCTTGGCTCGACCATAAATCAGGCAGCGAAAAGGGTTTTTCGCTTGGCTATTTCAACGATGAGTATTTAAAGCGTTTCGATATTGCCGTGCTGAAGAAAGACGGCGAAATCGTTGCTTTCGCCAATATATGGCGCGGTGCCGACAAGTATGAGATCACGGTCGACCTGATGCGCTACATGCCCAATGTGCACAAGCTCCTGATGGATGCGCTGTTCGCCAAGCTGCTGACCTTTTCCAAGCAAGAAGGCTACAAATGGTTTAACCTTGGCGCGGCCCCGCTTTCCGGCCTTAGCGGCAGCAGGCTTGCCTCGCGCTGGAACCGTTTCGGCTCGTTCATCTATCGCCGTGGGGCCGATCTTTATCACTTCGACGGGCTCAAAGTCTTCAAGGAAAAATTCGATCCCGTCTGGACCCCGCATTATATGGTTTGCCCCGGCGGGCTTGAAACGCCGCGCGCCCT
662	gb|AJ579365.1|+|4149-5628|ARO:3003111|lsaB	ATGTCAATGATACATGTACAAAATTTAACTTTCTCTTATCCGAGTAGTTTTGAT...TAA	1479.0	1200	2620	1420	1479	ATGTCAATGATACAAGTACAAAATTTAACTTTCTCTTATCCGAGTAGTTTTGATAATATTTTTGAAGATATAAGCTTTCAAATTGATACAGATTGGAAGCTTGGATTTATTGGTCGAAATGGACGAGGGAAAACAACGTTCTTTAATTTATTACTAGGTAAATTTGAATATAAGGGGAAAATCATTTCTTCGGTCGATTTTAACTACTTCCCATATCCAGTAGAAGATAAAAGTAAGTATACGCATGAAATTTTAGAAGAAATATGCCCTCAAGCTGAGGACTGGGAATTTCTTCGAGAAATAGCTTATTTAAATGTGGATGCCGAAGCCATGTACCGCCCATTTGAAACTTTATCAAACGGTGAACAAACAAAGGTATTGCTTGCTGCTCTATTTTTAAACGAAGGGCAATTTTTATTAATTGATGAACCAACAAATCATTTAGATACTGAAGCTCGTAAGATGGTTTCTAATTACTTGAGGAAGAAAAAAGGGTTTATTTTAATTTCTCATGACCGTAACTTTTTAGATGGTTGTGTTGATCATATCTTGTCTATAAATAGAGCAGATATTGAGGTTCAAAGTGGAAATTATTCTTCATGGAAGTTGAACTTTGACCGACAGCAGGAACATGAACAAGCAACAAATGAACGCTTGCAGAAGGATATTGGACGGTTAAATCAATCTTCAAAACGTTCGGCTGGTTGGTCTAACCAAGTCGAAGCTTCAAAAAATGCAACAACGAATTCTGGTTCTAAATTGGACAAAGGTTTTGTAGGGCATAAAGCAGCAAAATTGATGAAACGCTCTAAGAACCTTGAGGCTCGACAACAAAAAGCGATTGAAGAAAAGTCGAAGCTTCTAAAAAACATTGAAAAAACGGAGTCCTTACAGTTAGAATCGATGGAATATAAATCGAAGGAACTCATTCAATTAACAGATGTGTCTGTAATGTATGATGGTCAAGTTGTCAACAAACCAATAAGTTTTAATGTTGAACAAGGAGATAGAATTGTACTGGACGGAAAGAACGGCAGTGGAAAAAGTAGTATTTTAAAATTAATTTTAGGCGATCCAATACAGCATACAGGCACGTCAAATAAGGGTTCTAATCTGATAATTTCTTATGTTCAGCAAGACACCTCTCATTTAAAGGGGATGCTATCTGACTTTATTGAAGAAAATGAGATTGATGAAACGTTGTTTAAGTCCATTTTGAGAAAGATGGATTTTGACCGAATACAGTTTGAAAAAGATATATCTCATTATTCAGGTGGTCAGAAGAAAAAATTGCTTATCGCTAAAAGTTTATGTGAAAAAGCTCACCTGTATATTTGGGATGAACCATTAAACTTTATTGATATTTACTCTCGCATGCAAATTGAAGAGCTTATTCAAACCTTTAATCCGACTATAGTTT
663	gb|AY152390|+|0-1335|ARO:3003785|Chlamydia_trachomatis_intrinsic_murA_conferring_resistance_to_fosfomycin	ATGCCTGGTATCAAGGTTTTTGGAGAAACGGTCTTAAGAGGATCTGTGCGCGTG...TAA	1335.0	722	2002	1280	1335	ATGCCTGGTATCAAGGTTTTTGGAGAAACGGTCTTAAGAGGATCTGTGCGCGTGTCAGGAGCTAAAAATGCTACAACTAAATTACTTGTAGCCTCCTTACTTTCGGATCAGCGAACGATTTTAAAGAATGTCCCTAATATTGAAGATGTTCGGCAAACGGTAGATCTTTGTCGGGTTTTAGGGGCGATTGTAGAGTGGGATCAGCAAGCGCAAGTGATTGAAATTCACACTCCGCGCATTTTATTGTCCAAGGTTCCTCCGCAATTTTCTTGTGTTAATCGGATTCCTATTTTGCTGTTAGGAGCGTTGTTACGTCGTTGTCCTTATGGGATTTTTGTTCCTATTTTGGGAGGGGATGCTATAGGACCTCGTACGCTACATTTCCATTTAGAAGGATTGAAGAAGCTTGGAGCAGAGATAGTAATTAGTGATGAAGGCTATTGGGCTTCAGCTCCAAATGGTCTTGTTGGAGCACACATCACGTTACCCTACCCTTCTGTGGGAGCCACAGAAAACCTCATCCTTGCTTCTGTAGGGGCTCAAGGACGAACGATTATTAAGAATGCTGCTCTTGAAGTGGAAATCATTGATTTGATTGTCTTTTTACAGAAAGCAGGCATGGAGATTACAACAGATAATGATAAGACCATCGAAATTTTTGGATGTCAGGATTTCTATTCTGTTGAGCACTCCATTATTCCAGATAAAATCGAGGCTGCTTCTTTCGGTATGGCTGCGGTAGTTTCTCAGGGAAGGATCTTCGTAGAACAAGCGCGCCATGAGCATATGATCCCTTTTTTAAAGGTATTAAGATCGATAGGAGGGGGATTCTCTGTACATGAGAATGGGATCGAATTTTTCTACGATAAGCCTTTGAAAGGGGGAGTTCTTCTAGAAACGGATGTGCATCCAGGGTTTATTACAGATTGGCAACAACCTTTTGCCGTATTGCTCTCTCAGTCAGAAGGTTGTTCGGTGATCCATGAGACAGTGCATGAGAATCGTCTTGGGTATTTGAAAGGTTTGGTAAAAATGGGAGCGCATTGTGATTTATTTCACGAGTGTTTGAGTGCTAAGTCGTGTCGCTATTCTACAGGGAATCATCCTCATAGCGCAGTCATTCATGGTCCGACTCCTTTGCAGGCAACAGACTTAGTGATTCCTGATTTGCGCGCAGGATTTGCTTATGTCATGGCCGCACTCATTGCAGAAGGCGGAGCCTCATGGATTGAGAATACCGAGATGCTGGATCGAGGGTACACTGATTGGCGAGGGAAATT
664	gb|M36726.1|+|295-1150|ARO:3000596|ErmX	ATGTCTGCATACGGACAGGGCCGTCACGAGCATGGCCAAAATTTTCTCACCAAC...TAA	855.0	235	1035	800	855	ATGTCTGCATACGGACACGGCCGTCACGAGCATGGCCAAAATTTTCTCACCAACCACAAGATCATCAACTCCATCATCGACCTTGTGAAACAAACCTCCGGCCCCATCATTGAGATCGGACCAGGAAGCGGTGCCCTCACTCACCCGATGGCCCACTTGGGGAGGGCGATAACGGCAGTTGAAGTGGACGCAAAACTAGCTGCCAAAATCACACAAGAAACCTCCTCGGCGGCGGTCGAAGTGGTCCATGATGATTTCCTTAACTTCCGGTTACCCGCCACTCCCTGCGTCATTGTGGGAAACATTCCCTTTCACCTCACCACTGCCATTCTTCGAAAGTTGCTGCATGCGCCAGCATGGACTGACGCTGTACTCCTCATGCAGTGGGAAGTCGCTCGCCGCCGGGCCGGGGTAGGCGCAAGCACGATGATGACGGCTCAGTGGTCCCCATGGTTCACATTTCACCTGGGTTCTCGGGTACCAAGGTCTGCTTTCCGGCCACAGCCAAACGTTGACGGGGGGATCTTAGTGATCCGCCGGGTGGGTGACCCGAAGATTCCGATAGAGCAGCGCAAAGCCTTTCAGGCGATGGTGCACACCGTTTTCACTGCCCGGGGACGCGGGATAGGGGAAATTCTCCGAAGGGCAGGGTTGTTTTCATCACGTTCAGAAACACAATCATGGTTGCGCTCGCGAGGAATCGACCCCGCGACCCTACCTCCCAGATTGCACACCAACGACTGGATCGATCTCTTCCAGGTGACTGGTTCCTCTCTACCTCACCATCGACCCATTTCACC
665	gb|D16251.1|-|1625-2531|ARO:3000316|mphA	ATGACCGTAGTCACGACCGCCGATACCTCCCAACTGTACGCACTTGCAGCCCGA...TGA	906.0	68,0	448,247	380;247	906	ATGACCGTAGTCACGACCGCCGATACCTCCCAACTGTACGCACTTGCAGCCCGACATGGGCTCAAGCTCCATGGCCCGCTGACTGTCAATGAGCTTGGGCTCGACTATAGGATCGTGATCGCCACCGTCGACGATGGACGTCGGTGGGTGCTGCGCATCCCGCGCCGAGCCGAGGTAAGCGCGAAGGTCGAACCAGAGGCGCGGGTGCTGGCAATGCTCAAGAATCGCCTGCCGTTCGCGGTGCCGGACTGGCGCGTGGCCAACGCCGAGCTCGTTGCCTATCCCATGCTCGAAGACTCGACTGCGATGGTCATCCAGCCTGGTTCGTCCACGCCCGACTGGGTCGTGCCGCAGGACTCGGAGGTCTTCGCGGAGAGCTT;CGGGGATGCTCATCCGTACACCGACGCAGGCCCGTCAGAAGGTGGCCGACGACGTTGACCGCGTCCGACGCGAGTTCGTGGTGAACGACAAGCGCCTCCACCGGTGGCAGCACTGGCTCGACGACGATTCGTCGTGGCCAGATTTCTCCGTGGTGGTGCATGGCGATCTCTACGTGGGCCATGTGCTCATCGACAACACGGAGCGCGTCAGCGGGATGATCGACTGGAGCGAGGCTCGCGTTGGTGA
666	gb|DQ839391.1|-|12872-13757|ARO:3003741|mphE	ATGACAATTCAAGATATTCAATCACTTGCTGAAGCACACGGCTTGTTGCTTACG...TAA	885.0	4740	5570	830	885	ATGACAATTCAAGATATTCAATCACTTGCTGAAGCACACGGCTTGTTGCTTACGGACAAAATGAATTTCAATGAAATGGGCATTGATTTTAAGGTCGTTTTTGCTCTTGATACAAAGGGGCAACAATGGTTGCTGCGTATTCCTCGTCGTGATGGCATGAGGGAACAAATCAAGAAAGAAAAACGCATTTTAGAATTGGTAAAAAAACATCTTTCTGTAGAGGTTCCTGATTGGAGAATTTCATCTACAGAATTAGTGGCTTATCCCATACTTAAAGATAATCCTGTTTTAAATTTGGATGCTGAAACCTATGAAATAATTTGGAATATGGACAAAGATAGCCCGAAATACATAACATCTTTGGCAAAAACCTTATTTGAAATCCATAGTATTCCTGAAAAAGAAGTTCGGGAAAATGATTTGAAAATTATGAAACCTTCAGATTTAAGACCTGAAATAGCAAACAATTTGCAGTTAGTAAAATCTGAAATTGGTATAAGTGAGCAATTGGAAACCCGCTACAGAAAATGGTTGGATAATGATGTTCTATGGGCAGATTTCACCCAATTTATACATGGCGATTTATATGCTGGGCATGTACTAGCTTCAAAGGATGGAGCTGTTTCAGGCGTTATTGATTGGTCAACAGCCCATATAGATGACCCAGCGATTGATTTTGCTGGGCATGTAACTTTGTTTGGAGAAGAAAGCCTCAAAACTCTAATCATCGAGTATGAAAAACTAGGGGGTAAAGTTTGGAATAAACTATATGAACAGACTTTAGAAAGAGCAGCGGCCTCTCCTTTGATGTATGGTTTATTTGCCTTAGA
667	gb|U00096.3|-|4377810-4378944|ARO:3004290|Escherichia_coli_ampC	ATGTTCAAAACGACGCTCTGCGCCTTATTAATTACCGCCTCTTGCTCCACATTT...TAA	1134.0	5462	6541	1079	1134	ATGTTCAAAACGACGCTCTGCGCCTTATTAATTACCGCCTCTTGCTCCACATTTGCTGCCCCTCAACAAATCAACGATATTGTGCATCGCACAATTACCCCGCTTATAGAGCAACAAAAGATCCCCGGTATGGCGGTGGCGGTAATTTATCAGGGTAAACCTTATTACTTTACCTGGGGCTATGCGGACATCGCCAAAAAGCAGCCCGTCACACAGCAAACGTTGTTTGAGTTAGGTTCGGTCAGCAAAACATTTACGGGCGTGCTTGGTGGCGATGCTATTGCTCGAGGGGAAATCAAGTTAAGCGATCCCGCAACAAAATACTGGCCTGAACTTACCGCTAAACAGTGGAATGGGATCACACTATTACATCTTGCGACCTACACCGCTGGCGGCCTGCCATTGCAGATGCCGGATGAAGTGAAATCCTCAAGCGACTTGCTGCGCTTCTATCAAAACTGGCAGCCTGCATGGGCTCCAGGAACACAACGTCTGTATGCCAACTCCAGTATCGGTTTGTTCGGCGCACTGGCTGTGAAGCCGTCTGGTTTGAGTTTTGAGCAGGCGATGCAAACTCGTGTCTTCCAGCCACTCAAACTCAACCATACGTGGATTAATGTACCGCCCGCAGAAGAAAAGAATTACGCCTGGGGATATCGCGAAGGCAAGGCAGTTCATGTTTCGCCAGGGGCGTTAGATGCTGAAGCTTATGGTGTGAAGTCGACCATTGAAGATATGGCCCGCTGGGTGCAAAGCAATTTAACCCCCCTTGATATCAATGAGAAAACGCTTCAACAAGGGATACAACTGGCACAATCTCGCTACTGGCAAACCGGCGATATGTATCAGGGCCTGGGCTGGGAAATGCTGGACTGGCCGGTCAATCCTGACAGCATCATTAACGGCAGTGACAATAAAATTGCACTGGCAGCACGCCCGGTAAAAGCGATTAAGCCCCCAACTCCTGCAGTACGCGCATCATGGGTACATAAAACGGGGGCGACCGGCGGATTTGGTAGCTATGTCGCGTTTATTCCAGAAAAAGAGCTGGGTATCGTGATGCTGGCTAACAAAAACTA
668	gb|CP010314.1|+|275837-276758|ARO:3004541|mphK	ATGACAAACCTTAACGAAAAACAGCTTATCACTGAGATTGTCGGGCTTGCACGC...TAA	921.0	920,0,0	1224,321,224	304;321;224	921	ATGACAAACCTTAACGAAAAACAGCTTATCACTGAGATTGTCGGGCTTGCACGCAGCCAAGGTTTGACGGTTCATTCTGAGAACGCGCAATTGAATGAAACCGGAATGGACTTTCAAGTTGTATTTGCCAAGGACGACACAGGTATGCCATGGGTGCTGCGAAAACCGCGGCGAAGTGATGTTGTGGAAAGAGCATCCGCAGAAGGCATAACGCTTGCCTTTCTCCGCGCGAATCTGACTGCTGATGTGCCGGATTGGAGAATTCATACACCGGAATTGATCGCTTACCCCATGTTAAAAGGAA;GGAATTGATCGCTTACCCCATGTTAAAAGGAACGCCGGCTGCTGGAATTGACTTGGAACAAAAGCAATATGTATGGAATATGGATCATCAGCCGCCGTCAGACGACTTTGTCCGCACACTTGCCGACATACTGGCTGAATTACATGGCACGGATCAAATATCTGCTGGGCAATCCGGAATAGAAGTGATAAGGCTAGAAGATTTCAGGCAAATGACAGCAGACTCTATGGTTGATGTGAAGAATAAGCTTGGCGTATTACGACGCTTTGGGAAAGATGGCAAAAGTGGATAGATGATGATGCATACTGGCCGGGTTTCTCT;AGATGATGATGCATACTGGCCGGGTTTCTCTTCTTTGATACACGGCGATCTCCAGCCCCCGCATATTCTTATCGACCAAAATGAACGTGTCACAGGACTTCTGGATTGGACAGAAGCGAAGGTTGCTGACCCAGCCAAGGATTTTGTTCTTTATCAAACCATTTTCGGAGAAAAAGAAACTGCCCGTTTGCTTGAATACTATGATCAAGCAGGCGGCCGAATAT
669	gb|EU294228.1|+|21241-22717|ARO:3003109|msrE	ATGAGTTTAATTATTAAAGCGAGAAACATACGCTTGGATTATGCTGGGCGTGAT...TAA	1476.0	3209	4630	1421	1476	ATGAGTTTAATTATTAAAGCGAGAAACATACGCTTGGATTATGCTGGGCGTGATGTTTTGGATATTGATGAATTGGAAATTCACTCTTATGACCGTATTGGTCTTGTGGGTGATAACGGAGCAGGAAAGAGTAGTTTACTCAAAGTACTTAATGGCGAAATTGTTTTAGCCGAAGCGACATTACAGCGTTTTGGTGATTTTGCACATATCAGCCAACTGGGCGGAATCGAAATAGAAACGGTCGAAGACCGGGCAATGTTATCTCGCCTTGGTGTTTCCAATGTACAAAACGACACAATGAGTGGCGGAGAGGAAACTCGTGCAAAAATTGCTGCCGCATTTTCCCAACAAGTACATGGCATTCTAGCGGATGAACCAACCAGCCACCTTGATCTCAATGGAATAGATCTACTTATTGGTCAACTTAAAGCATTTGATGGAGCATTACTTGTTATCAGTCATGACCGATATTTTCTTGATATGGTTGTAGACAAGATATGGGAGTTAAAAGACGGTAAAATTACGGAATATTGGGGTGGTTACTCGGATTACTTGCGTCAAAAAGAAGAAGAGCGACAACACCAAGCCGTAGAATATGAGCTGATGATGAAGGAACGGGAGCGATTAGAATCTGCTGTGCAAGAAAAACGCCAGCAAGCTAATCGATTAGACAATAAGAAAAAAGGAGAAAAATCCAAAAACTCTACCGAAAGTGCTGGACGACTTGGGCATGCAAAAATGACTGGCACCAAGCAAAGAAAACTGTATCAGGCAGCTAAGAGTATGGAAAAGCGTTTGGCTGCATTAGAAGATATTCAAGCACCAGAGCATTTGCGTTCTATTCGTTTTCGTCAAAGTTCAGCCCTAGAACTGCACAATAAGTTCCCGATTACGGCAGATGGTCTGAGCTTAAAATTTGGTAGCCGTACTATCTTTGATGACGCTAACTTTATAATACCGCTTGGCGCTAAAGTCGCTATAACTGGATCGAATGGAACAGGGAAAACGTCCTTGTTAAAAATGATATCAGAACGTGCTGATGGATTAACCATATCTCCAAAAGCTGAAATTGGCTACTTTACACAAACAGGATATAAATTTAACACGCATAAATCTGTGCTCTCCTTTATGCAGGAAGAGTGCGAGTACACAGTTGCGGAAATTCGTGCAGTATTGGCTTCAATGGGGATCGGAGCGAATGATATTCAAAAAAACTTATCCGACTTATCGGGAGGTGAAATCATCAAACTGCTTTTATCCAAAATGCTTTTAGGAAAATATAATATTTTGCTTATGGATGAACCAGGAAACTATCTTGACCTAAAAAGTATTGCCGCATTAGAAACAATGATGAAGTCCTATGCAGGAACTATTATCTTCGTATCTCATGACAAGCAATTGGTCGATAATATTGCTGACAT
670	gb|FN649414.1|+|2765050-2766355|ARO:3004611|Escherichia_coli_ampC1_beta-lactamase	ATGAAACGGACAATGCTCTATCTTTCTCTGCTGGCTGTTAGTTGTAGCGTCAGC...TAA	1305.0	413	1663	1250	1305	ATGAAACGGACAATGCTCTATCTTTCTCTGCTGGCTGTTAGTTGTAGCGTCAGCGCCGCAAAATACCCTGTTCTGACAGAAAGCTCGCCAGAGAAAGCAGGGTTTAACGTCAAACGGCTTAACCAGATGGATCGCTGGATTAGCCAGCAAGTTGATGCCGGTTATCCCGGCGTAAACCTGCTGATCATTAAAGATAATCAGATTGTGTATCGCAAAGCCTGGGGAGCGGCGAAAAAGTACGATGGCAGCGTGTTGATGGAACAGCCTGTCAAAGCCACCACCGGGACGCTGTATGACCTGGCCTCAAACACCAAAATGTACGCCACGAACTTCGCCCTGCAAAAGCTGATGAGCGAAGGCAAACTGCATCCTGACGATCGGATTGCGAAATATATTCCGGGGTTTGCCGATAGTCCAAATGACACCATTAAAGGCAAAAACACCCTGCGGATTTCTGACCTGCTGCATCACAGCGGCGGTTTCCCGGCAGATCCGCAATACCCGAATAAAGCGGTCGCGGGCGCGTTATATTCCTAGGATAAAGGCCAGACGCTGGAGATGATCAAGCGCACGCCGCTGGAATATCAGCCCGGCAGCAAACATATCTACAGCGATGTCGATTATATGCTGCTTGGATTTATCGTCGAGTCGGTTACCGGTCAGCCGCTTGACCGCTATGTTGAAGAGTCGATTTATCGCCCGCTCGGCCTGACACATACGGTATTTAACCCGCTGCTGAAAGGCTTTAAACCGCAACAAATTGCCGCCACGGAATTGAACGGCAATACCCGCGATGGCGTGATCCATTTCCCGAATATCCGCACCTCCACTCTCTGGGGTCAGGTGCACGATGAAAAAGCCTTTTATTCGATGGGCGGCGTTTCCGGGCACGCAGGTTTGTTTTCCAATACCGGCGATATTGCGGTGTTAATGCAAACGATGCTGAACGGCGGGGGCTATGGCGATGTGCAGCTGTTCAGTGCGGAAACGGTGAAGATGTTCACCACCAGCTCTAAGGAAGATGCCACTTTTGGCCTCGGCTGGCGCGTGAATGGTAATGCCACCATGACGCCGACGTTTGGCACGCTGGCAAGCCCGCAAACCTACGGTCACACTGGCTGGACCGGGACAGTAACCGTTATCGATCCGGTCAATCATATGGCGATTGTGATGTTAAGCAACAAGCCCCATTCGCCAGTTGCCGATCCACAAAAAAATCCCAATATGTTCGAAAGCGGTCAGTTACCGAT
671	gb|U00096|+|2367070-2368039|ARO:3003578|pmrF	ATGTTTGAAATCCACCCTGTTAAGAAAGTCTCGGTGGTTATTCCCGTTTATAAC...TAA	969.0	3046	3960	914	969	ATGTTTGAAATCCACCCTGTTAAGAAAGTCTCGGTGGTTATTCCCGTTTATAACGAGCAGGAAAGCTTACCGGAATTAATCAGGCGCACCACCACAGCCTGTGAATCGTTGGGGAAAGAGTATGAGATCCTGCTGATTGATGACGGCAGTAGCGATAATTCCGCGCATATGCTGGTCGAAGCCTCACAAGCGGAGAACAGCCATATTGTGTCTATTTTGCTTAACCGCAATTACGGGCAACATTCAGCGATTATGGCGGGATTCAGTCACGTTACTGGCGACTTAATTATTACCCTTGATGCCGATCTCCAGAATCCGCCAGAAGAAATCCCCCGCCTAGTGGCAAAAGCCGATGAAGGTTACGACGTGGTAGGGACTGTACGCCAGAACCGCCAGGACAGCTGGTTTCGTAAAACAGCTTCGAAGATGATTAACCGGCTTATTCAGCGCACCACCGGCAAAGCGATGGGTGACTACGGTTGTATGCTGCGCGCCTATCGCCGTCATATTGTCGATGCGATGTTGCACTGCCATGAACGTAGCACCTTTATCCCGATTCTGGCGAATATCTTCGCCCGCCGTGCCATTGAAATTCCAGTACATCATGCCGAGCGTGAGTTTGGTGAATCCAAATACAGTTTTATGCGCCTGATTAATTTGATGTACGACCTGGTGACCTGCCTTACCACAACGCCGCTACGTATGCTGAGTCTGCTCGGCAGCATTATTGCGATTGGAGGTTTTAGCATTGCGGTGCTGCTGGTGATTTTACGCCTGACCTTCGGACCACAATGGGCGGCAGAAGGCGTCTTTATGCTATTTGCCGTGCTGTTTACTTTTATTGGCGCTCAGTTTATCGGCATGGGATTACTCGGTGAATATATCGGCAGGATCTACACCGATGTCCGCGCCCG
672	gb|JF969163|+|1053-1893|ARO:3000410|sul1	ATGGTGACGGTGTTCGGCATTCTGAATCTCACCGAGGACTCCTTCTTCGATGAG...TAG	840.0	1306	2091	785	840	ATGGTGACGGTGTTCGGCATTCTGAATCTCACCGAGGACTCCTTCTTCGATGAGAGCCGGCGGCTAGACCCCGCCGGCGCTGTCACCGCGGCGATCGAAATGCTGCGAGTCGGATCAGACGTCGTGGATGTCGGACCGGCCGCCAGCCATCCGGACGCGAGGCCTGTATCGCCGGCCGATGAGATCAGACGTATTGCGCCGCTCTTAGACGCCCTGTCCGATCAGATGCACCGTGTTTCAATCGACAGCTTCCAACCGGAAACCCAGCGCTATGCGCTCAAGCGCGGCGTGGGCTACCTGAACGATATCCAAGGATTTCCTGACCCTGCGCTCTATCCCGATATTGCTGAGGCGGACTGCAGGCTGGTGGTTATGCACTCAGCGCAGCGGGATGGCATCGCCACCCGCACCGGTCACCTTCGACCCGAAGACGCGCTCGACGAGATTGTGCGGTTCTTCGAGGCGCGGGTTTCCGCCTTGCGACGGAGCGGGGTCGCTGCCGACCGGCTCATCCTCGATCCGGGGATGGGATTTTTCTTGAGCCCCGCACCGGAAACATCGCTGCACGTGCTGTCGAACCTTCAAAAGCTGAAGTCGGCGTTGGGGCTTCCGCTATTGGTCTCGGTGTCGCGGAAATCCTTCTTGGGCGCCACCGTTGGCCTTCCTGTAAAGGATCTGGGTCCAGCGAGCCTTGCGGCGGAACTTCACGCGATCGGCAATGGCGCTGACTACGTCCGCACCCACGCGCCTGGAGATCTGCGAAGCGCAATCACCTTCTCGGAAAC
673	gb|AP012030.1|-|395553-396711|ARO:3004612|Escherichia_coli_ampH	TTGAAACGTAGTCTGCTTTTTTCTGCCGTGCTGTGTGCGGCGTCATTGACCTCC...TGA	1158.0	3880	4973	1093	1158	TTGAAACGTAGTCTGCTTTTTTCTGCCGTGCTGTGTGCGGCGTCATTGACCTCCGTCCATGCGGCGCAGCCGATCACTGAACCGGAGTTTGCCTCTGATATTGTCGATCGTTATGCCGATCATATTTTTTACGGCAGCGGTGCCACGGGGATGGCGCTGGTTGTTATCGACGGTAACCAGCGCGTCTTTCGCAGTTATGGCGAAACGCGACCTGGTAATAACGTTCGCCCGCAGCTGGATTCGGTCGTGCGTATTGCTTCCCTCACCAAGCTAATGACCAGTGAAATGCTGGTGAAATTGCTCGACCAGGGGACCGTGAAGTTAAACGATCCGCTAAGTAAATATGCTCCGCCAGGCGCACGCGTGCCAACCTACAATGGGACGCCCATTACCCTAGTGAATCTGGCAACCCATACCAGCGCCCTGCCCCGTGAACAGCCCGGTGGCGCGGCACATCGTCCGGTGTTTGTCTGGCCAACGCGCGAGCAACGCTGGAAATACCTTTCTACGGCGAAGCTGAAAGCCGCGCCAGGCAGTCAGGCGGCGTACTCTAACCTTGCGTTCGACCTGCTGGCAGATGCACTGGCGAATGCGTCCGGCAAGCCTTATACCCAGTTGTTTGAAGAGCAGATTACCCGTCCATTGGGGATGAAAGACACCACCTACACCCCCTCACCGGATCAGTGCCGCCGTTTAATGGTTGCTGAGCGCGGTGCCAGTCCGTGCAATAACACGCTGGCGGCAATTGGCAGCGGCGGCGTCTATTCCACGCCTGGCGATATGATGCGCTGGATGCAGCAGTATTTATCATCTGATTTTTATCAGCGCAGTAACCAGGCAGATCGCATGCAGACGTTGATTTATCAGCGCGCGCAGTTTACCAAAGTGATTGGCATGGATGTCCCCGGCAAAGCGGATGCGCTTGGTTTAGGCTGGGTATATATGGCCCCGAAAGAGGGTCGTCCGGGGATTATTCAGAAGACAGGCGGTGGTGGCGGTTTCATTACCTATATGGCGATGATCCCGCAGAAGAATATTGGCGCGTTTGTGGTGGTCACTCGTTCGCCGTTGACGCGCTTTAAAAATATGAGCG
674	gb|AY055428.1|-|20268-21084|ARO:3000412|sul2	ATGAATAAATCGCTCATCATTTTCGGCATCGTCAACATAACCTCGGACAGTTTC...TAA	816.0	21	782	761	816	ATGAATAAATCGCTCATCATTTTCGGCATCGTCAACATAACCTCGGACAGTTTCTCCGATGGAGGCCGGTATCTGGCGCCAGACGCAGCCATTGCGCAGGCGCGTAAGCTGATGGCCGAGGGGGCAGATGTGATCGACCTCGGTCCGGCATCCAGCAATCCCGACGCCGCGCCTGTTTCGTCCGACACAGAAATCGCGCGTATCGCGCCGGTGCTGGACGCGCTCAAGGCAGATGGCATTCCCGTCTCGCTCGACAGTTATCAACCCGCGACGCAAGCCTATGCCTTGTCGCGTGGTGTGGCCTATCTCAATGATATTCGCGGTTTTCCAGACGCTGCGTTCTATCCGCAATTGGCGAAATCATCTGCCAAACTCGTCGTTATGCATTCGGTGCAAGACGGGCAGGCAGATCGGCGCGAGGCACCCGCTGGCGACATCATGGATCACATTGCGGCGTTCTTTGACGCGCGCATCGCGGCGCTGACGGGTGCCGGTATCAAACGCAACCGCCTTGTCCTTGATCCCGGCATGGGGTTTTTTCTGGGGGCTGCTCCCGAAACCTCGCTCTCGGTGCTGGCGCGGTTCGATGAATTGCGGCTGCGCTTCGATTTGCCGGTGCTTCTGTCTGTTTCGCGCAAATCCTTTCTGCGCGCGCTCACAGGCCGTGGTCCGGGGGATGTCGGGGCCGCGACACTCGCTGCAGAGCTTGCCGCCGCCGCAGGTGGAGCTGACTTCATCCGCACACACGAGCCGCGCCCCTT
675	gb|CP001633.1|-|630303-631167|ARO:3004801|FTU-1	ATGCGTCTATTAGTTACAACTTTATCATTAATCCCGAGTATCATACTAGCTGCT...TAA	864.0	3008,0	3596,274	588;274	864	ATGCGTCTATTAGTTACAACTTTATCATTAATCCCGAGTATCATACTAGCTGCTCCTCAATTAGATGATTCTTTTAAAAATCTGGAAAACAAATATGATGGAAAAATTGGCATCTACACTCTCAACACTGATGATAAAACTAACATCAAATATAACGAAAGCTATCACTTCCCTATTTGTAGTGTTTTCAAGTTTTTATTAGTTGGTGCAATTTTAGATTATGATATGCATAATCAAGGCTTCTTAGATAAAAAAATTCCAATAAATCAAGATGATATTGGTAAACTCGGATATGCTCCTATTACTGCTAAAAACGTTGGTAAAACTCTAACAATATCACAACTTAACTACGCTGCTATCCTAAGTGATAGTCCTGCCAGTAACATATTAGTTAGAGAACTTGGAGGTTTACAAAACTTAAATAAATTTATAAAAAAATTAGGTGATAACGATACTATAATTACTGCTGATGAACCAGAAATTAATTATACTCAGCCACATAGTAATATAAATAAAACAACTCCAAAGGCTATTACTAAAGATATTTATAAATTAGCATTTGGCAATATTCTAGATAAAAAACATAAA;CTAAAGATATTTATAAATTAGCATATGGCAATATTCTAGATAAAAAACATAAAGATATTATTATAAAGTATCTAGAAGATAATAATACTGGTGCAAATAGAATAGCTTTTAGCATGCCTAAAGATTGGATAATTGGCGATAAAACTGGAACTTGTGGTCAATATGCAGCAACTAATGATGTAGCTATTATATGGCCTAAAAATCAGCAACCTATTGCGTTAGGAATTTTATATACTAACCCTAATGATAAAAATGCACCAAGTAATGAAGAAAT
676	gb|FJ196385|-|8531-9323|ARO:3000413|sul3	ATGAGCAAGATTTTTGGAATCGTAAATATAACCACCGATAGTTTTTCCGATGGA...TAG	792.0	233	970	737	792	ATGAGCAAGATTTTTGGAATCGTAAATATAACCACCGATAGTTTTTCCGATGGAGGACTTTATTTAGATACAGATAAGGCAATTGAGCATGCTCTGCATTTGGTTGAAGATGGAGCAGATGTGATTGATTTGGGAGCCGCTTCCAGTAATCCTGATACAACTGAAGTGGGCGTTGTGGAAGAAATCAAAAGACTCAAACCTGTCATTAAGGCTTTAAAAGAAAAAGGCATTTCTATTTCTGTTGATACATTTAAACCTGAGGTTCAGAGTTTTTGCATAGAACAAAAGGTTGATTTTATTAATGATATTCAAGGTTTTCCTTATCCTGAGATTTATTCAGGCTTGGCAAAGTCAGATTGCAAACTTGTGTTGATGCACTCCGTTCAGCGAATTGGTGCAGCTACTAAAGTTGAAACGAATCCGGAAGAGGTTTTTACTTCCATGATGGAATTTTTTAAAGAAAGAATTGCTGCTTTAGTTGAGGCTGGTGTAAAGCGTGAACGAATTATTCTTGATCCGGGTATGGGCTTCTTTTTAGGCTCTAATCCAGAAACATCTATTCTTGTTTTGAAGCGTTTCCCTGAAATTCAAGAAGCTTTTAATTTGCAAGTAATGATTGCAGTGTCACGGAAATCATTCTTAGGTAAAATAACTGGAACCGATGTGAAATCTCGTTTAGCACCAACTCTTGCAGCAGAAATGTATGCATACAAAAAAGGTGCAGATTATCTCCGCAC
677	gb|KP143090.1|-|1199-1619|ARO:3003209|FosA5	ATGCTGAGTGGACTGAATCACCTGACCCTGGCAGTCAGCCAGCTGGCGCCGAGC...TGA	420.0	929	1286	357	420	ATGCTGAGTGGACTGAATCACCTGACCCTGGCAGTCAGCCAGCTGGCGCCGAGCGTGGCGTTTTATCAGCAGCTGCTGGGCATGACGCTGCATGCCCGCTGGGACAGCGGGGCTTATCTCTCCTGCGGCGATTTGTGGCTGTGCCTGTCGCTGGATCCGCAGCGGCGCGTTACTCCGCCGGAAGAGAGCGACTACACCCATTATGCGTTTAGTATTAGCGAAGCCGATTTTGCTAGCTTCGCCGCCCGCCTTGAGGCTGCCGGCGTGGCGGTCTGGAAGCTGAACCGTAGCGAAGGTGCCTCGCACTATTTCCTCGATCCCGATGGCCATAAGCTGGAGCTGCACGTCGGCAGTCTC
678	gb|KU254579.1|+|59421-59841|ARO:3004111|FosA6	ATGCTGAGTGGACTGAATCACCTGACCCTGGCAGTCAGCCAGCTGGCGCCGAGC...TGA	420.0	929	1294	365	420	ATGCTGAGTGGACTGAATCACCTGACCCTGGCAGTCAGCCAGCTGGCGCCGAGCGTGGCGTTTTATCAGCAGCTGCTGGGCATGACGCTGCATGCCCGCTGGGACAGCGGGGCTTATCTCTCCTGCGGCGATTTGTGGCTGTGCCTGTCGCTGGATCCGCAGCGGCGCGTTACTCCGCCGGAAGAGAGCGACTACACCCATTATGCGTTTAGTATTAGCGAAGCCGATTTTGCTAGCTTCGCCGCCCGCCTTGAGGCTGCCGGCGTGGCGGTCTGGAAGCTGAACCGTAGCGAAGGTGCCTCGCACTATTTCCTCGATCCCGATGGCCATAAGCTGGAGCTGCACGTCGGCAGTCTCGCCCAGCG
679	gb|AE016877.1|+|1972251-1972668|ARO:3000172|FosB	TTGTTAAGGGGAATCAATCATATTTGTTTTTCGGTATCTAATTTAGAAAACTCT...TAG	417.0	69	431	362	417	TTGTTAAGGGGAATCAATCATATTTGTTTTTCGGTATCTAATTTAGAAAACTCTATTATGTTTTATGAAAAAGTATTAGAAGGAGAATTATTAGTTAAAGGAAGAAAATTGGCTTATTTTAACATATGTGGAGTATGGATAGCGCTTAATGAAGAGACGCATATTCCGAGAAATGAGATTCATCAATCTTATACGCACATTGCATTTTCTGTTGAACAAGAAGACTTTAAATGTCTAATACAGCGATTAGAAGAAAATGATGTTCATATTTTACAAGGAAGAGAACGTGATGTAAGAGATTACGAATCTATATACTTTGTTGATCCTGACGGTCATAAATTTGAGTTTCACTCAGGGACACT
680	gb|FN594949|+|25244-27167|ARO:3000556|tet44	ATGAAAATAATCAACATTGGTATTCTTGCTCATGTAGATGCAGGAAAGACGACC...TAA	1923.0	1263	3131	1868	1923	ATGAAAATAATCAACATTGGTATTCTTGCTCATGTAGATGCAGGAAAGACGACTTTAACGGAAAGTCTGCTTTATACAAGTGGAGCGATTTTAGAATTAGGCAGTGTAGATAAGGGAACAACAAGGACAGATACTATGTTTTTAGAACGTCAGCGTGGAATCACAATTCAGGCAGCAGTTACTTCTTTTAATTGGAATGACTACAAAATCAATATTGTAGATACTCCTGGACATACAGATTTTATAACAGAAGTGTATCGTTCCTTATCTGTTCTTGATGGAGCTATTTTAGTAATTTCTGCTAAAGATGGTGTACAAGCACAAACAAGAATACTATTCCATGCACTTCAAAAAATGAATATACCAACAATTATTTTTATAAATAAAATAGATCAGTATGGAATTAACTTAAATAATATTTATCAAAATATCAAAGAAAAACTTTCAAATGATATTATTGTTATGCAAAATGTAACATTAACTCCAGAAATATCAATTAAAAATATCATTGATTTAGATGAATGGGATCCTGTAATTTCCAAAAATGATAAACTTTTAAAAAAATATATTGCAGGAGAAAAATTGACTATACAGGAATTAACGCAGGAAGAATATAGGTGTGTTAAAAAAGGTTCGTTGTTTCCTATATACCATGGAAGTGCTAAAAATAATATAGGAACTCAACAACTCATTGAAGCTATTTCAAATCTTTTTTGTCCTGAAATGAATAAGAATTATTCAGAACTATGTGGAAGAGTTTTTAAAATTGAATATACAGACCATAAGCAAAGATTAGTTTATTTGCGTCTTTACAGTGGAACATTACACTTACGAGATACAATTGTATTGTCAGAAAAAAAGAAAGTGAAACTTACAGAAATATATATTCCTTCAAATGGAGAAATGATACAGACAGAAATAGTTTGTTCTGGAGATATTTTTATAATACCTAACAATACATTAAGATTGAACGATATTATAGGAAATGAAAAGATTTTGCCATGCAATGTATGGAATGACAAGCCTGTACCAATGCTACGAACAAGAATTGAACCGATAAAAATAGAAGAGAGAGAAAAATTATTGGATGCTCTTACAGAAATTGCAGATACTGATCCTCTTTTACGTTATTGTGTTGATACGATAACACATGAAATCGTCATTTCTTTTTTAGGAACAGTGCAGTTAGAAGTTATCTGTTCTCTGTTGATTGAAAAATATCACATAAACATAAGAATCGAAGATCCAACCGTAATTTATTTGGAAAAGCCATTACAAAAGGCAGATTATACTATTCATATTGAAGTACCACCAAATCCATTTTGGGCATCAATTGGATTATCAATAACTCCACTTCCAATTGGCAGTGGAATACAGTACGAAAGCAAAGTTTCACTCGGTTATTTAAATCAAAGTTTCCAAAATGCAGTAAGAGAAGGTATTAATTATGGACTGGAGCAAGGTTTGTATGGCTGGGAAGTAACAGATTGTAAAATATGTTTTGAATATGGTGTTTATTATAGCCCTGTTAGTACTCCCTCGGATTTTCGTTTTCTTGCCCCAATTGTACTTGAACAAACATTGAAAAAAGCGGGAACGCAATTATTAGAGCCATATCTTTCGTTTATACTTTTTACACCACAGGGATACCTTTCTCGTGCATATAATGATGCACAAAAACATTGTGCAATAATTGAAACTAGTCAATCAAAAAATGATGAAATTATTTTTACAGGACATATTCCTGTACGTTGTATTAATGAATATCGTAATACTTTAACTCTATATACAAATGGGCAAGCAGTTTTTTTGACAGAATTAAAAGGTTATCAAATTGCTACTTGTGAACCAGTTATTCAATCACGTAG
681	gb|AJ011502.1|+|300-1425|ARO:3004122|Klebsiella_pneumoniae_OmpK37	ATGAAAAGAAAAGTACTGGCCCTCGTTATTCCGGCTTTATTAGCCGCCGGTGCC...TGA	1125.0	219,1	1113,228	894;227	1125	ATGAAAAGAAAAGTACTGGCCCTCGTTACTCCGGCTTTATTAGCCGCAGGTGCCGCGCATGCGGCGGAAATTTATAATAAAGACGGGAATAAATTAGATCTCTATGGCAAGGTAGATGGTCTGCATTATTTCTCCAGCGACTCGAAAAAAGACGGCGATCAAACTTATTTACGTTTTGGCTTTAAAGGCGAAACCCAGATCAACGATATGCTTACCGGCTATGGCCAGTGGGAATATAACGTTCAGGCCAACAACACCGAGACCTCCAGCGATCAGGCGTGGACCCGTCTGGCATTCGCCGGTATCAAAGTGGGCGATTACGGCTCCTTCGACTACGGTCGTAACTACGGCGTGCTGTACGACGTTGAAGGCTGGACCGATATGCTGCCGGAGTTCGGCGGCGACTCCTACACCTATGCGGATAACTTTATGGCAGGCCGCGCCAACGGCGTCGCAACCTACCGCAACAGCGATTTCTTCGGTCTGGTGGAGGGTCTGAACTTCGCCCTGCAGTATCAGGGTAAAAACGAAGGCCAGAACGCGCAGGATATCAACGTCGGCACCAATAACCGCAGCAGCGACAGCGATGTTCGCTTCGACAATGGCGATGGTTTCGGCCTCTCCACTTCCTACGACTTCGGCATGGGTATCAGCGCGGCGGCAGCTTACACCTCGTCTGACCGTACAGGCGACCAGCAACACTATACTCACACCGAACGATACGCCAAAGGCGACAAAGCGGACGCCTGGACCGCCGGCCTGAAGTACGACGCCAACGATATTTACCTGGCGACCATGTACTCTGAAACCCGCAATATGACGCCATACGGCTCTACCAGCAGTACCAACGGTGGCGGTATCGCCAATAAAACGCAAAACTTCGAAGTCACCGCG;CAAAACTTCGAAGTCACCGCGCAGTATCAGTTCGACTTCGGCCTGCGTCCGGCCATCTCCTACCTGCAGTCCAAAGGCAAAGATCTGTACAATAACGGCCGCTATGCCGATAAAGATCTGGTCAAATATATGGACGTTGGCGCGACCTATTACTTCAACCGTAATATGTCCACCTATGTTGATTACAAAATCAACCTGCTGGATGGTAACGACAAATTCTACGAAGA
682	gb|M18896.2|+|206-2126|ARO:3000190|tetO	ATGAAAATAATTAACTTAGGCATTCTGGCTCACGTTGACGCAGGAAAGACAACA...TAA	1920.0	253	2118	1865	1920	ATGAAAATAATTAACTTAGGCATTCTGGCTCACGTTGACGCAGGAAAGACAACATTAACGGAAAGTTTATTGTATACCAGTGGTGCAATTGCAGAACTAGGGAGCGTAGATGAAGGCACAACAAGGACAGATACAATGAATTTGGAGCGTCAAAGGGGAATCACTATCCAGACAGCAGTGACATCTTTTCAGTGGGAGGATGTAAAAGTCAACATTATAGATACGCCAGGCCATATGGATTTTTTGGCGGAAGTATACCGTTCTTTATCCGTATTAGACGGAGCAGTATTATTAGTTTCTGCAAAGGATGGCATACAGGCACAGACCCGTATACTGTTTCATGCACTACAGATAATGAAGATTCCGACAATTTTTTTCATCAATAAAATTGACCAAGAGGGGATTGATTTGCCAATGGTATATCGGGAAATGAAAGCAAAGCTTTCTTCGGAAATTATAGTGAAGCAAAAGGTTGGGCAGCATCCCCATATAAATGTAACGGACAATGACGATATGGAACAGTGGGATGCGGTAATTATGGGAAACGATGAACTATTAGAGAAATATATGTCAGGGAAACCGTTTAAAATGTCAGAACTGGAACAGGAAGAAAACAGGAGATTCCAAAACGGAACGTTATTTCCCGTTTATCACGGAAGCGCTAAAAACAATCTGGGGATTCGGCAGCTTATAGAAGTAATTGCCAGTAAATTTTATTCATCAACGCCTGAAGGTCAATCTGAACTATGCGGGCAGGTTTTTAAGATTGAATATTCAGAGAAAAGGCGGCGTTTTGTTTATGTGCGTATATATAGCGGAACATTGCATTTGAGGGATGTTATTAGAATATCTGAAAAAGAGAAAATAAAAATCACAGAGATGTGTGTTCCGACAAACGGTGAATTATATTCATCCGATACAGCCTGCTCTGGTGATATTGTAATTTTACCAAATGATGTTTTGCAGCTAAACAGTATTTTGGGGAACGAAATACTGTTGCCGCAGAGAAAATTTATTGAAAATCCTCTCCCTATGCTCCAAACAACGATTGCAGTAAAGAAATCTGAACAGCGGGAAATATTGCTTGGGGCACTTACAGAAATTTCAGATGGCGACCCTCTTTTAAAATATTATGTGGATACTACAACGCATGAGATTATACTTTCTTTTTTGGGGAATGTGCAGATGGAAGTCATTTGTGCCATCCTTGAGGAAAAATATCATGTGGAGGCAGAAATAAAAGAGCCTACTGTTATATATATGGAAAGACCGCTTAGAAAAGCAGAATATACCATCCACATAGAAGTCCCGCCAAATCCTTTCTGGGCTTCTGTCGGGTTGTCCATAGAGCCGCTCCCTATTGGAAGCGGAGTGCAGTATGAAAGCAGAGTTTCACTTGGATATTTAAATCAATCGTTCCAAAATGCGGTTATGGAGGGGGTTCTTTATGGCTGCGAGCAGGGGCTGTATGGATGGAAAGTGACAGACTGTAAAATCTGTTTTGAATATGGATTGTATTATAGTCCTGTAAGTACCCCCGCAGACTTTCGGCTGCTTTCCCCTATCGTATTGGAGCAGGCTTTAAAAAAAGCAGGGACAGAACTATTAGAGCCATATCTCCACTTTGAAATTTATGCACCGCAGGAATATCTCTCACGGGCGTATCATGATGCTCCAAGGTATTGTGCAGATATTGTAAGTACTCAGATAAAGAATGACGAGGTCATTCTGAAAGGAGAAATCCCTGCTAGATGTATTCAAGAATACAGGAACGATTTAACTTATTTCACAAATGGGCAGGGAGTCTGCTTGACAGAGTTAAAAGGATACCAGCCAGCTATTGGTAAATTTATTTGCCAACCCCG
683	gb|CP045110.1|-|521271-522372|ARO:3005051|LpsB	ATGAAAGTGATGCAACTTCTCCCAGAACTCAATAGCGGTGGCGTAGAACGCGGC...TAA	1101.0	116380	117426	1046	1101	ATGAAAGTGATGCAACTTCTCCCAGAACTTAATAGCGGTGGCGTAGAACGCGGCACACTGGAAATTGCACGTGCACTGGTTGCACAAGGTCATCAGTCTCTAGTTGTGTCTAATGGCGGGCGTTTGGTCTCACAACTTGAAGCTGAAGGTTCCACACACTTAACGCTGCCTATCCATAAAAAATCATTGTCAAGCTTGTGGCAAATCCGTCCATTACGTCAGCTGATTGAAGAGCACCAACCAGACATTGTACATGTGCGCTCTCGCGTACCTGCGTGGCTAACCCACTTCGCTTTAAGAAAAATACCAGCGAATAAACGCCCTCACCTCATTAGCACGGTACATGGTTTCTATTCAGTTAATCGTTATAGTGCGATCATGACTCAGGCAGAAAAAGTGATCGCTGTTTCTGACAGCGTAGTTAAATACATCACAGACCATTATAAAAACTGTCCACCACAAGATATTGTCCGTATTTATCGAGGCATTGACCCTGCTGCTTTTCCGCATAACTACCAACCTTCAGCACAGTGGTTTAACCAAGTTTTTAACGACTTTCCCGAACTCGAGAATAAATTTTTACTTTGCCTACCTGGCCGTATTACTCGTTTAAAAGGACATGAAAGTTTAATTGAACTGATGCAAAAACTAGGTGAACAATATCCTCAACTGCATGCTGTTGTTGTGGGTGGGGCTGATGTAAAAAAACAAGCCTATTTAAGTGAGTTGCAAAACACCATTCAAAGCAAAGGACTTGCAGATAAAATTACCTTTGTAGGACATCGCTCAGATATACGCGAATGGCTCGCTTTTAGCGATATAGTGCTCTCTCTATCCAATCAAGCAGAAACATTCGGTAGAACAGCATTAGAAGCCCTTTCGGTAGGCACGCCGGTCATTGGCTGGAACCGTGGCGGTGTTGCCGAGATTTTATCTCATGTATACCCACAAGGTCTTGTTGAAGCAGAAAATGAAAAAGCTTTAGTAGAAACAGTAAAGAATCATATTGAACAACCGCAAACAGTCGCTCCTGTGACAATGTTTAG
684	gb|AF205943|+|7511-8312|ARO:3001405|OXA-10	ATGAAAACATTTGCCGCATATGTAATTATCGCGTGTCTTTCGAGTACGGCATTA...TAA	801.0	659	1405	746	801	ATGAAAACATTTGCCGCATATGTAATTATCGCGTGTCTTTCGAGTACGGCATTAGCTGGTTCAATTACAGAAAATACGTCTTGGAACAAAGAGTTCTCTGCCGAAGCCGTCAATGGTGTCTTCGTGCTTTGTAAAAGTAGCAGTAAATCCTGCGCTACCAATGACTTAGCTCGTGCATCAAAGGAATATCTTCCAGCATCAACATTTAAGATCCCCAACGCAATTATCGGCCTAGAAACTGGTGTCATAAAGAATGAGCATCAGGTTTTCAAATGGGACGGAAAGCCAAGAGCCATGAAGCAATGGGAAAGAGACTTGACCTTAAGAGGGGCAATACAAGTTTCAGCTGTTCCCGTATTTCAACAAATCGCCAGAGAAGTTGGCGAAGTAAGAATGCAGAAATACCTTAAAAAATTTTCCTATGGCAACCAGAATATCAGTGGTGGCATTGACAAATTCTGGTTGGAAGGCCAGCTTAGAATTTCCGCAGTTAATCAAGTGGAGTTTCTAGAGTCTCTATATTTAAATAAATTGTCAGCATCTAAAGAAAACCAGCTAATAGTAAAAGAGGCTTTGGTAACGGAGGCGGCACCTGAATATCTAGTGCATTCAAAAACTGGTTTTTCTGGTGTGGGAACTGAGTCAAATCCTGGTGTCGCATGGTGGGTTGGGTGGGTTGAGAAGGAGACAGAGGTTTACTTTTTCGCCTTTAACATGGATATAGACAACGAAAGTAAGTTGCCGCT
685	gb|AM231720|+|0-825|ARO:3001438|OXA-100	ATGAACATTAAAGCACTCTTACTTATAACAAGCACTATTTTTATTTCAGCCTGC...TAG	825.0	54149	54919	770	825	ATGAACATTAAAGCACTCTTACTTATAACAAGCGCTATTTTTATTTCAGCCTGCTCACCTTATATAGTGACTGCTAATCCAAATCACAGCGCTTCAAAATCTGATGTAAAAGCAGAGAAAATTAAAAATTTATTTAACGAAGCACACACTACGGGTGTTTTAGTTATCCAACAAGGCCAAACTCAACAAAGCTATGGTAATGATCTTGCTCGTGCTTCGACCGAGTATGTACCTGCTTCGACCTTCAAAATGCTTAATGCTTTGATCGGCCTTGAGCACCATAAGGCAACCACCACAGAAGTATTTAAGTGGGATGGTAAAAAAAGGTTATTCCCAGAATGGGAAAAGGACATGACCCTAGGCGATGCCATGAAAGCTTCCGCTATTCCAGTTTATCAAGATTTAGCTCGTCGTATTGGACTTGAGCTCATGTCTAAGGAAGTGAAGCGTGTTGGTTATGGCAATGCAGATATCGGTACCCAAGTCGATAATTTTTGGCTGGTGGGTCCTTTAAAAATTACTCCTCAGCAAGAGGCACAGTTTGCTTACAAGCTAGCTAATAAAACGCTTCCATTTAGCCAAAAAGTCCAAGATGAAGTGCAATCCATGCTATTCATAGAAGAAAAGAATGGAAACAAAATATACGCAAAAAGTGGTTGGGGATGGGATGTAAACCCACAAGTAGGCTGGTTAACTGGATGGGTTGTTCAGCCTCAAGGGAATATTGTAGCGTTCTCCCTTAACTTAGAAATGAAAAAAGGAATACCTAG
686	gb|AM412777|+|117-918|ARO:3001439|OXA-101	ATGAAAACATTTGCCGCATATGTAATTACTGCGTGTCTTTCAAGTACGGCATTA...TAA	801.0	659	1405	746	801	ATGAAAACATTTGCCGCATATGTAATTATCGCGTGTCTTTCGAGTACGGCATTAGCTGGTTCAATTACAGAAAATACGTCTTGGAACAAAGAGTTCTCTGCCGAAGCCGTCAATGGTGTCTTCGTGCTTTGTAAAAGTAGCAGTAAATCCTGCGCTACCAATGACTTAGCTCGTGCATCAAAGGAATATCTTCCAGCATCAACATTTAAGATCCCCAACGCAATTATCGGCCTAGAAACTGGTGTCATAAAGAATGAGCATCAGGTTTTCAAATGGGACGGAAAGCCAAGAGCCATGAAGCAATGGGAAAGAGACTTGACCTTAAGAGGGGCAATACAAGTTTCAGCTGTTCCCGTATTTCAACAAATCGCCAGAGAAGTTGGCGAAGTAAGAATGCAGAAATACCTTAAAAAATTTTCCTATGGCAACCAGAATATCAGTGGTGGCATTGACAAATTCTGGTTGGAAGGCCAGCTTAGAATTTCCGCAGTTAATCAAGTGGAGTTTCTAGAGTCTCTATATTTAAATAAATTGTCAGCATCTAAAGAAAACCAGCTAATAGTAAAAGAGGCTTTGGTAACGGAGGCGGCACCTGAATATCTAGTGCATTCAAAAACTGGTTTTTCTGGTGTGGGAACTGAGTCAAATCCTGGTGTCGCATGGTGGGTTGGGTGGGTTGAGAAGGAGACAGAGGTTTACTTTTTCGCCTTTAACATGGATATAGACAACGAAAGTAAGTTGCCGCT
687	gb|APQF01000011.1|+|291557-292379|ARO:3001707|OXA-103	ATGAATAAATATTTTACTTGCTATGTGGTTGCTTCTCTTTTTCTTTCTGGTTGT...TAA	822.0	80	847	767	822	ATGAATAAATATTTTACTTGCTATGTGGTTGCTTCTCTTTTTCTTTCTGGTTGTACGGTTCAGCATAATTTAATAAATGAAACCCCGAGTCAGATTGTTCAAGGACATAATCAGGTGATTCATCAATACTTTGATGAAAAAAACACCTCAGGTGTGCTGGTTATTCAAACAGATAAAAAAATTAATCTATATGGTAATGCTCTAAGCCGCGCAAATACAGAATATGTGCCAGCCTCTACATTTAAAATGTTGAATGCCCTGATCGGATTGGAGAACCAGAAAACGGATATTAATGAAATATTTAAATGGAAGGGCGAGAAAAGGTCATTTACCGCTTGGGAAAAAGACATGACACTAGGAGAAGCCATGAAGCTTTCTGCAGTCCCAGTCTATCAGGAACTTGCGCGACGTATCGGTCTTGATCTCATGCAAAAAGAAGTAAAACGTATTGGTTTCGGTAATGCTGAAATTGGACAGCAGGTTGATAATTTCTGGTTGGTAGGACCATTAAAGGTTACGCCTATTCAAGAGGTAGAGTTTGTTTCCCAATTAGCACATACACAGCTTCCATTTAGTGAAAAAGTGCAGGCTAATGTAAAAAATATGCTTCTTTTAGAAGAGAGTAATGGCTACAAAATTTTTGGAAAGACTGGTTGGGCAATGGATATAAAACCACAAGTGGGCTGGTTGACCGGCTGGGTTGAGCAGCCAGATGGAAAAATTGTCGCTTTTGCATTAAATATGGAAATGCGGTCAGAAATGCCGGC
688	gb|EF650032|+|0-825|ARO:3001637|OXA-106	ATGAACATTAAAGCACTCTTACTTATAACAAGCGCTATTTTTATTTCAGCCTGC...TAG	825.0	54149	54919	770	825	ATGAACATTAAAGCACTCTTACTTATAACAAGCGCTATTTTTATTTCAGCCTGCTCACCTTATATAGTGACTGCTAATCCAAATCACAGCGCTTCAAAATCTGATGTAAAAGCAGAGAAAATTAAAAATTTATTTAACGAAGCACACACTACGGGTGTTTTAGTTATCCAACAAGGCCAAACTCAACAAAGCTATGGTAATGATCTTGCTCGTGCTTCGACCGAGTATGTACCTGCTTCGACCTTCAAAATGCTTAATGCTTTGATCGGCCTTGAGCACCATAAGGCAACCACCACAGAAGTATTTAAGTGGGATGGTAAAAAAAGGTTATTCCCAGAATGGGAAAAGGACATGACCCTAGGCGATGCCATGAAAGCTTCCGCTATTCCAGTTTATCAAGATTTAGCTCGTCGTATTGGACTTGAGCTCATGTCTAAGGAAGTGAAGCGTGTTGGTTATGGCAATGCAGATATCGGTACCCAAGTCGATAATTTTTGGCTGGTGGGTCCTTTAAAAATTACTCCTCAGCAAGAGGCACAGTTTGCTTACAAGCTAGCTAATAAAACGCTTCCATTTAGCCAAAAAGTCCAAGATGAAGTGCAATCCATGCTATTCATAGAAGAAAAGAATGGAAACAAAATATACGCAAAAAGTGGTTGGGGATGGGATGTAAACCCACAAGTAGGCTGGTTAACTGGATGGGTTGTTCAGCCTCAAGGGAATATTGTAGCGTTCTCCCTTAACTTAGAAATGAAAAAAGGAATACCTAG
689	gb|EF650033|+|0-825|ARO:3001638|OXA-107	ATGAACATTAAAGCACTCTTACTTATAACAAGCGCTATTTTTATTTCAGCCTGC...TAG	825.0	54149	54919	770	825	ATGAACATTAAAGCACTCTTACTTATAACAAGCGCTATTTTTATTTCAGCCTGCTCACCTTATATAGTGACTGCTAATCCAAATCACAGCGCTTCAAAATCTGATGTAAAAGCAGAGAAAATTAAAAATTTATTTAACGAAGCACACACTACGGGTGTTTTAGTTATCCAACAAGGCCAAACTCAACAAAGCTATGGTAATGATCTTGCTCGTGCTTCGACCGAGTATGTACCTGCTTCGACCTTCAAAATGCTTAATGCTTTGATCGGCCTTGAGCACCATAAGGCAACCACCACAGAAGTATTTAAGTGGGATGGTAAAAAAAGGTTATTCCCAGAATGGGAAAAGGACATGACCCTAGGCGATGCCATGAAAGCTTCCGCTATTCCAGTTTATCAAGATTTAGCTCGTCGTATTGGACTTGAGCTCATGTCTAAGGAAGTGAAGCGTGTTGGTTATGGCAATGCAGATATCGGTACCCAAGTCGATAATTTTTGGCTGGTGGGTCCTTTAAAAATTACTCCTCAGCAAGAGGCACAGTTTGCTTACAAGCTAGCTAATAAAACGCTTCCATTTAGCCAAAAAGTCCAAGATGAAGTGCAATCCATGCTATTCATAGAAGAAAAGAATGGAAACAAAATATACGCAAAAAGTGGTTGGGGATGGGATGTAAACCCACAAGTAGGCTGGTTAACTGGATGGGTTGTTCAGCCTCAAGGGAATATTGTAGCGTTCTCCCTTAACTTAGAAATGAAAAAAGGAATACCTAG
690	gb|EF650034|+|0-825|ARO:3001639|OXA-108	ATGAACATTAAAGCACTCTTACTTATAACAAGCGCTATTTTTATTTCAGCCTGC...TAG	825.0	54149	54919	770	825	ATGAACATTAAAGCACTCTTACTTATAACAAGCGCTATTTTTATTTCAGCCTGCTCACCTTATATAGTGACTGCTAATCCAAATCACAGCGCTTCAAAATCTGATGTAAAAGCAGAGAAAATTAAAAATTTATTTAACGAAGCACACACTACGGGTGTTTTAGTTATCCAACAAGGCCAAACTCAACAAAGCTATGGTAATGATCTTGCTCGTGCTTCGACCGAGTATGTACCTGCTTCGACCTTCAAAATGCTTAATGCTTTGATCGGCCTTGAGCACCATAAGGCAACCACCACAGAAGTATTTAAGTGGGATGGTAAAAAAAGGTTATTCCCAGAATGGGAAAAGGACATGACCCTAGGCGATGCCATGAAAGCTTCCGCTATTCCAGTTTATCAAGATTTAGCTCGTCGTATTGGACTTGAGCTCATGTCTAAGGAAGTGAAGCGTGTTGGTTATGGCAATGCAGATATCGGTACCCAAGTCGATAATTTTTGGCTGGTGGGTCCTTTAAAAATTACTCCTCAGCAAGAGGCACAGTTTGCTTACAAGCTAGCTAATAAAACGCTTCCATTTAGCCAAAAAGTCCAAGATGAAGTGCAATCCATGCTATTCATAGAAGAAAAGAATGGAAACAAAATATACGCAAAAAGTGGTTGGGGATGGGATGTAAACCCACAAGTAGGCTGGTTAACTGGATGGGTTGTTCAGCCTCAAGGGAATATTGTAGCGTTCTCCCTTAACTTAGAAATGAAAAAAGGAATACCTAG
691	gb|EF650035|+|0-825|ARO:3001640|OXA-109	ATGAACATTAAAGCACTCTTACTTATAACAAGCGCTATTTTTATTTCAGCCTGC...TAG	825.0	54149	54919	770	825	ATGAACATTAAAGCACTCTTACTTATAACAAGCGCTATTTTTATTTCAGCCTGCTCACCTTATATAGTGACTGCTAATCCAAATCACAGCGCTTCAAAATCTGATGTAAAAGCAGAGAAAATTAAAAATTTATTTAACGAAGCACACACTACGGGTGTTTTAGTTATCCAACAAGGCCAAACTCAACAAAGCTATGGTAATGATCTTGCTCGTGCTTCGACCGAGTATGTACCTGCTTCGACCTTCAAAATGCTTAATGCTTTGATCGGCCTTGAGCACCATAAGGCAACCACCACAGAAGTATTTAAGTGGGATGGTAAAAAAAGGTTATTCCCAGAATGGGAAAAGGACATGACCCTAGGCGATGCCATGAAAGCTTCCGCTATTCCAGTTTATCAAGATTTAGCTCGTCGTATTGGACTTGAGCTCATGTCTAAGGAAGTGAAGCGTGTTGGTTATGGCAATGCAGATATCGGTACCCAAGTCGATAATTTTTGGCTGGTGGGTCCTTTAAAAATTACTCCTCAGCAAGAGGCACAGTTTGCTTACAAGCTAGCTAATAAAACGCTTCCATTTAGCCAAAAAGTCCAAGATGAAGTGCAATCCATGCTATTCATAGAAGAAAAGAATGGAAACAAAATATACGCAAAAAGTGGTTGGGGATGGGATGTAAACCCACAAGTAGGCTGGTTAACTGGATGGGTTGTTCAGCCTCAAGGGAATATTGTAGCGTTCTCCCTTAACTTAGAAATGAAAAAAGGAATACCTAG
692	gb|Z22590|+|154-955|ARO:3001406|OXA-11	ATGAAAACATTTGCCGCATATGTAATTATCGCGTGTCTTTCGAGTACGGCATTA...TAA	801.0	659	1405	746	801	ATGAAAACATTTGCCGCATATGTAATTATCGCGTGTCTTTCGAGTACGGCATTAGCTGGTTCAATTACAGAAAATACGTCTTGGAACAAAGAGTTCTCTGCCGAAGCCGTCAATGGTGTCTTCGTGCTTTGTAAAAGTAGCAGTAAATCCTGCGCTACCAATGACTTAGCTCGTGCATCAAAGGAATATCTTCCAGCATCAACATTTAAGATCCCCAACGCAATTATCGGCCTAGAAACTGGTGTCATAAAGAATGAGCATCAGGTTTTCAAATGGGACGGAAAGCCAAGAGCCATGAAGCAATGGGAAAGAGACTTGACCTTAAGAGGGGCAATACAAGTTTCAGCTGTTCCCGTATTTCAACAAATCGCCAGAGAAGTTGGCGAAGTAAGAATGCAGAAATACCTTAAAAAATTTTCCTATGGCAACCAGAATATCAGTGGTGGCATTGACAAATTCTGGTTGGAAGGCCAGCTTAGAATTTCCGCAGTTAATCAAGTGGAGTTTCTAGAGTCTCTATATTTAAATAAATTGTCAGCATCTAAAGAAAACCAGCTAATAGTAAAAGAGGCTTTGGTAACGGAGGCGGCACCTGAATATCTAGTGCATTCAAAAACTGGTTTTTCTGGTGTGGGAACTGAGTCAAATCCTGGTGTCGCATGGTGGGTTGGGTGGGTTGAGAAGGAGACAGAGGTTTACTTTTTCGCCTTTAACATGGATATAGACAACGAAAGTAAGTTGCCGCT
693	gb|EF650036|+|0-825|ARO:3001641|OXA-110	ATGAACATTAAAGCACTCTTACTTATAACAAGCGCTATTTTTATTTCAGCCTGC...TAG	825.0	54149	54919	770	825	ATGAACATTAAAGCACTCTTACTTATAACAAGCGCTATTTTTATTTCAGCCTGCTCACCTTATATAGTGACTGCTAATCCAAATCACAGCGCTTCAAAATCTGATGTAAAAGCAGAGAAAATTAAAAATTTATTTAACGAAGCACACACTACGGGTGTTTTAGTTATCCAACAAGGCCAAACTCAACAAAGCTATGGTAATGATCTTGCTCGTGCTTCGACCGAGTATGTACCTGCTTCGACCTTCAAAATGCTTAATGCTTTGATCGGCCTTGAGCACCATAAGGCAACCACCACAGAAGTATTTAAGTGGGATGGTAAAAAAAGGTTATTCCCAGAATGGGAAAAGGACATGACCCTAGGCGATGCCATGAAAGCTTCCGCTATTCCAGTTTATCAAGATTTAGCTCGTCGTATTGGACTTGAGCTCATGTCTAAGGAAGTGAAGCGTGTTGGTTATGGCAATGCAGATATCGGTACCCAAGTCGATAATTTTTGGCTGGTGGGTCCTTTAAAAATTACTCCTCAGCAAGAGGCACAGTTTGCTTACAAGCTAGCTAATAAAACGCTTCCATTTAGCCAAAAAGTCCAAGATGAAGTGCAATCCATGCTATTCATAGAAGAAAAGAATGGAAACAAAATATACGCAAAAAGTGGTTGGGGATGGGATGTAAACCCACAAGTAGGCTGGTTAACTGGATGGGTTGTTCAGCCTCAAGGGAATATTGTAGCGTTCTCCCTTAACTTAGAAATGAAAAAAGGAATACCTAG
694	gb|EF650037|+|0-825|ARO:3001642|OXA-111	ATGAACATTAAAACACTCTTACTTATAACAAGCGCTATTTTTATTTCAGCCTGC...TAG	825.0	54149	54919	770	825	ATGAACATTAAAGCACTCTTACTTATAACAAGCGCTATTTTTATTTCAGCCTGCTCACCTTATATAGTGACTGCTAATCCAAATCACAGCGCTTCAAAATCTGATGTAAAAGCAGAGAAAATTAAAAATTTATTTAACGAAGCACACACTACGGGTGTTTTAGTTATCCAACAAGGCCAAACTCAACAAAGCTATGGTAATGATCTTGCTCGTGCTTCGACCGAGTATGTACCTGCTTCGACCTTCAAAATGCTTAATGCTTTGATCGGCCTTGAGCACCATAAGGCAACCACCACAGAAGTATTTAAGTGGGATGGTAAAAAAAGGTTATTCCCAGAATGGGAAAAGGACATGACCCTAGGCGATGCCATGAAAGCTTCCGCTATTCCAGTTTATCAAGATTTAGCTCGTCGTATTGGACTTGAGCTCATGTCTAAGGAAGTGAAGCGTGTTGGTTATGGCAATGCAGATATCGGTACCCAAGTCGATAATTTTTGGCTGGTGGGTCCTTTAAAAATTACTCCTCAGCAAGAGGCACAGTTTGCTTACAAGCTAGCTAATAAAACGCTTCCATTTAGCCAAAAAGTCCAAGATGAAGTGCAATCCATGCTATTCATAGAAGAAAAGAATGGAAACAAAATATACGCAAAAAGTGGTTGGGGATGGGATGTAAACCCACAAGTAGGCTGGTTAACTGGATGGGTTGTTCAGCCTCAAGGGAATATTGTAGCGTTCTCCCTTAACTTAGAAATGAAAAAAGGAATACCTAG
695	gb|EF650038|+|0-825|ARO:3001643|OXA-112	ATGAACATTAAAGCACTCTTACTTATAACAAGCGCTATTTTTATTTCAGCCTGC...TAG	825.0	54149	54919	770	825	ATGAACATTAAAGCACTCTTACTTATAACAAGCGCTATTTTTATTTCAGCCTGCTCACCTTATATAGTGACTGCTAATCCAAATCACAGCGCTTCAAAATCTGATGTAAAAGCAGAGAAAATTAAAAATTTATTTAACGAAGCACACACTACGGGTGTTTTAGTTATCCAACAAGGCCAAACTCAACAAAGCTATGGTAATGATCTTGCTCGTGCTTCGACCGAGTATGTACCTGCTTCGACCTTCAAAATGCTTAATGCTTTGATCGGCCTTGAGCACCATAAGGCAACCACCACAGAAGTATTTAAGTGGGATGGTAAAAAAAGGTTATTCCCAGAATGGGAAAAGGACATGACCCTAGGCGATGCCATGAAAGCTTCCGCTATTCCAGTTTATCAAGATTTAGCTCGTCGTATTGGACTTGAGCTCATGTCTAAGGAAGTGAAGCGTGTTGGTTATGGCAATGCAGATATCGGTACCCAAGTCGATAATTTTTGGCTGGTGGGTCCTTTAAAAATTACTCCTCAGCAAGAGGCACAGTTTGCTTACAAGCTAGCTAATAAAACGCTTCCATTTAGCCAAAAAGTCCAAGATGAAGTGCAATCCATGCTATTCATAGAAGAAAAGAATGGAAACAAAATATACGCAAAAAGTGGTTGGGGATGGGATGTAAACCCACAAGTAGGCTGGTTAACTGGATGGGTTGTTCAGCCTCAAGGGAATATTGTAGCGTTCTCCCTTAACTTAGAAATGAAAAAAGGAATACCTAG
696	gb|EF653400|+|434-1259|ARO:3001644|OXA-113	ATGAACATTAAAGCCCTCTTACTTATAACAAGCGCTATTTTTATTTCAGCCTGC...TAG	825.0	54149	54919	770	825	ATGAACATTAAAGCACTCTTACTTATAACAAGCGCTATTTTTATTTCAGCCTGCTCACCTTATATAGTGACTGCTAATCCAAATCACAGCGCTTCAAAATCTGATGTAAAAGCAGAGAAAATTAAAAATTTATTTAACGAAGCACACACTACGGGTGTTTTAGTTATCCAACAAGGCCAAACTCAACAAAGCTATGGTAATGATCTTGCTCGTGCTTCGACCGAGTATGTACCTGCTTCGACCTTCAAAATGCTTAATGCTTTGATCGGCCTTGAGCACCATAAGGCAACCACCACAGAAGTATTTAAGTGGGATGGTAAAAAAAGGTTATTCCCAGAATGGGAAAAGGACATGACCCTAGGCGATGCCATGAAAGCTTCCGCTATTCCAGTTTATCAAGATTTAGCTCGTCGTATTGGACTTGAGCTCATGTCTAAGGAAGTGAAGCGTGTTGGTTATGGCAATGCAGATATCGGTACCCAAGTCGATAATTTTTGGCTGGTGGGTCCTTTAAAAATTACTCCTCAGCAAGAGGCACAGTTTGCTTACAAGCTAGCTAATAAAACGCTTCCATTTAGCCAAAAAGTCCAAGATGAAGTGCAATCCATGCTATTCATAGAAGAAAAGAATGGAAACAAAATATACGCAAAAAGTGGTTGGGGATGGGATGTAAACCCACAAGTAGGCTGGTTAACTGGATGGGTTGTTCAGCCTCAAGGGAATATTGTAGCGTTCTCCCTTAACTTAGAAATGAAAAAAGGAATACCTAG
697	gb|EU029998|+|575-1400|ARO:3001440|OXA-115	ATGAACATTAAAGCACTCTTACTTATAACAAGCGCTATTTTTATTTCAGCCTGC...TAG	825.0	54149	54919	770	825	ATGAACATTAAAGCACTCTTACTTATAACAAGCGCTATTTTTATTTCAGCCTGCTCACCTTATATAGTGACTGCTAATCCAAATCACAGCGCTTCAAAATCTGATGTAAAAGCAGAGAAAATTAAAAATTTATTTAACGAAGCACACACTACGGGTGTTTTAGTTATCCAACAAGGCCAAACTCAACAAAGCTATGGTAATGATCTTGCTCGTGCTTCGACCGAGTATGTACCTGCTTCGACCTTCAAAATGCTTAATGCTTTGATCGGCCTTGAGCACCATAAGGCAACCACCACAGAAGTATTTAAGTGGGATGGTAAAAAAAGGTTATTCCCAGAATGGGAAAAGGACATGACCCTAGGCGATGCCATGAAAGCTTCCGCTATTCCAGTTTATCAAGATTTAGCTCGTCGTATTGGACTTGAGCTCATGTCTAAGGAAGTGAAGCGTGTTGGTTATGGCAATGCAGATATCGGTACCCAAGTCGATAATTTTTGGCTGGTGGGTCCTTTAAAAATTACTCCTCAGCAAGAGGCACAGTTTGCTTACAAGCTAGCTAATAAAACGCTTCCATTTAGCCAAAAAGTCCAAGATGAAGTGCAATCCATGCTATTCATAGAAGAAAAGAATGGAAACAAAATATACGCAAAAAGTGGTTGGGGATGGGATGTAAACCCACAAGTAGGCTGGTTAACTGGATGGGTTGTTCAGCCTCAAGGGAATATTGTAGCGTTCTCCCTTAACTTAGAAATGAAAAAAGGAATACCTAG
